unitid,year,totcohortsize,w_cohortsize,m_cohortsize,tot4yrgrads,m_4yrgrads,w_4yrgrads,women_gradrate_4yr,womengradrate4yr,gradrate4yr,mengradrate4yr
100654,1991,1010,527,483,152,32,120,22.77,0.228,0.15,0.066
100663,1991,937,500,437,82,33,49,9.8,0.098,0.088,0.076
100751,1991,2511,1348,1163,630,213,417,30.93,0.309,0.251,0.183
100858,1991,3024,1496,1528,846,312,534,35.7,0.357,0.28,0.204
101435,1991,189,101,88,60,25,35,34.65,0.346,0.317,0.284
101480,1991,1100,567,533,109,42,67,11.82,0.118,0.099,0.079
101675,1991,365,144,221,73,41,32,22.22,0.222,0.2,0.186
101879,1991,755,387,368,66,23,43,11.11,0.111,0.087,0.062
102049,1991,569,337,232,217,89,128,37.98,0.38,0.381,0.384
102094,1991,1245,653,592,117,32,85,13.02,0.13,0.094,0.054
102234,1991,279,158,121,106,42,64,40.51,0.405,0.38,0.347
102368,1991,793,437,356,205,70,135,30.89,0.309,0.259,0.197
102377,1991,837,469,368,167,70,97,20.68,0.207,0.2,0.19
104151,1991,2447,1214,1233,442,174,268,22.08,0.221,0.181,0.141
104179,1991,3970,2063,1907,786,297,489,23.7,0.237,0.198,0.156
105330,1991,1881,1064,817,294,97,197,18.52,0.185,0.156,0.119
106245,1991,941,536,405,45,14,31,5.78,0.058,0.048,0.035
106342,1991,121,79,42,48,17,31,39.24,0.392,0.397,0.405
106397,1991,2327,1080,1247,381,170,211,19.54,0.195,0.164,0.136
106412,1991,650,393,257,55,15,40,10.18,0.102,0.085,0.058
106458,1991,1521,833,688,147,44,103,12.36,0.124,0.097,0.064
106467,1991,761,403,358,103,32,71,17.62,0.176,0.135,0.089
106485,1991,478,256,222,33,13,20,7.81,0.078,0.069,0.059
106704,1991,1961,1129,832,171,46,125,11.07,0.111,0.087,0.055
107044,1991,673,383,290,192,65,127,33.16,0.332,0.285,0.224
107080,1991,281,146,135,141,67,74,50.68,0.507,0.502,0.496
107141,1991,219,123,96,65,29,36,29.27,0.293,0.297,0.302
107512,1991,338,182,156,115,44,71,39.01,0.39,0.34,0.282
107558,1991,90,52,38,9,4,5,9.62,0.096,0.1,0.105
110097,1991,391,256,135,155,45,110,42.97,0.43,0.396,0.333
110404,1991,225,73,152,146,99,47,64.38,0.644,0.649,0.651
110422,1991,1526,717,809,121,36,85,11.85,0.118,0.079,0.044
110486,1991,363,200,163,26,16,10,5,0.05,0.072,0.098
110495,1991,273,164,109,39,8,31,18.9,0.189,0.143,0.073
110510,1991,815,505,310,58,17,41,8.12,0.081,0.071,0.055
110529,1991,1583,650,933,96,28,68,10.46,0.105,0.061,0.03
110538,1991,1284,731,553,171,35,136,18.6,0.186,0.133,0.063
110547,1991,337,227,110,9,2,7,3.08,0.031,0.027,0.018
110556,1991,1648,902,746,173,61,112,12.42,0.124,0.105,0.082
110565,1991,1847,1094,753,137,30,107,9.78,0.098,0.074,0.04
110574,1991,649,445,204,87,22,65,14.61,0.146,0.134,0.108
110583,1991,2142,1283,859,88,25,63,4.91,0.049,0.041,0.029
110592,1991,1491,938,553,41,9,32,3.41,0.034,0.027,0.016
110617,1991,1210,694,516,108,28,80,11.53,0.115,0.089,0.054
113698,1991,66,50,16,22,3,19,38,0.38,0.333,0.188
115755,1991,862,468,394,61,19,42,8.97,0.09,0.071,0.048
119173,1991,190,190,0,32,0,32,16.84,0.168,0.168,NA
120184,1991,71,51,20,25,6,19,37.25,0.372,0.352,0.3
121309,1991,317,194,123,103,34,69,35.57,0.356,0.325,0.276
121345,1991,359,164,195,294,155,139,84.76,0.848,0.819,0.795
122409,1991,2479,1440,1039,151,39,112,7.78,0.078,0.061,0.038
122436,1991,882,528,354,471,181,290,54.92,0.549,0.534,0.511
122597,1991,1219,774,445,72,28,44,5.68,0.057,0.059,0.063
122612,1991,459,299,160,205,72,133,44.48,0.445,0.447,0.45
122931,1991,928,457,471,675,335,340,74.4,0.744,0.727,0.711
123554,1991,437,241,196,247,101,146,60.58,0.606,0.565,0.515
123572,1991,680,429,251,95,18,77,17.95,0.18,0.14,0.072
126562,1991,262,152,110,25,7,18,11.84,0.118,0.095,0.064
126580,1991,319,183,136,36,12,24,13.11,0.131,0.113,0.088
126614,1991,3421,1631,1790,1268,550,718,44.02,0.44,0.371,0.307
126818,1991,2155,1144,1011,516,173,343,29.98,0.3,0.239,0.171
127060,1991,504,265,239,280,123,157,59.25,0.593,0.556,0.515
127185,1991,935,424,511,67,30,37,8.73,0.087,0.072,0.059
127565,1991,1357,669,688,35,12,23,3.44,0.034,0.026,0.017
127741,1991,1639,937,702,258,78,180,19.21,0.192,0.157,0.111
128106,1991,579,287,292,59,23,36,12.54,0.125,0.102,0.079
128744,1991,208,110,98,12,5,7,6.36,0.064,0.058,0.051
128771,1991,1088,627,461,115,34,81,12.92,0.129,0.106,0.074
129020,1991,2904,1464,1440,977,359,618,42.21,0.422,0.336,0.249
129242,1991,749,429,320,597,255,342,79.72,0.797,0.797,0.797
129941,1991,320,84,236,60,42,18,21.43,0.214,0.188,0.178
130253,1991,485,196,289,93,41,52,26.53,0.265,0.192,0.142
130314,1991,104,104,0,54,0,54,51.92,0.519,0.519,NA
130493,1991,1002,539,463,188,49,139,25.79,0.258,0.188,0.106
130590,1991,481,226,255,387,192,195,86.28,0.863,0.805,0.753
130697,1991,663,347,316,501,223,278,80.12,0.801,0.756,0.706
130776,1991,349,187,162,96,32,64,34.22,0.342,0.275,0.198
130794,1991,1290,592,698,1127,608,519,87.67,0.877,0.874,0.871
130934,1991,585,330,255,53,12,41,12.42,0.124,0.091,0.047
130943,1991,3170,1871,1299,1592,524,1068,57.08,0.571,0.502,0.403
131159,1991,1027,633,394,622,223,399,63.03,0.63,0.606,0.566
131283,1991,532,308,224,309,124,185,60.06,0.601,0.581,0.554
131450,1991,227,129,98,15,2,13,10.08,0.101,0.066,0.02
131469,1991,1151,622,529,686,282,404,64.95,0.65,0.596,0.533
131496,1991,1369,710,659,1133,547,586,82.54,0.825,0.828,0.83
131520,1991,1089,687,402,261,64,197,28.68,0.287,0.24,0.159
132471,1991,301,179,122,85,34,51,28.49,0.285,0.282,0.279
132602,1991,619,348,271,134,25,109,31.32,0.313,0.216,0.092
132903,1991,1577,813,764,332,89,243,29.89,0.299,0.211,0.116
133492,1991,336,187,149,186,80,106,56.68,0.567,0.554,0.537
133553,1991,875,134,741,190,158,32,23.88,0.239,0.217,0.213
133650,1991,1608,945,663,188,36,152,16.08,0.161,0.117,0.054
133669,1991,651,358,293,93,29,64,17.88,0.179,0.143,0.099
133711,1991,290,169,121,133,50,83,49.11,0.491,0.459,0.413
133881,1991,350,78,272,98,67,31,39.74,0.397,0.28,0.246
133951,1991,1021,600,421,198,62,136,22.67,0.227,0.194,0.147
134079,1991,378,210,168,147,53,94,44.76,0.448,0.389,0.315
134097,1991,2899,1702,1197,1131,410,721,42.36,0.424,0.39,0.343
134130,1991,4364,2116,2248,1284,490,794,37.52,0.375,0.294,0.218
134945,1991,388,147,241,102,56,46,31.29,0.313,0.263,0.232
135726,1991,1832,826,1006,775,383,392,47.46,0.475,0.423,0.381
136172,1991,406,240,166,71,24,47,19.58,0.196,0.175,0.145
136950,1991,401,227,174,233,92,141,62.11,0.621,0.581,0.529
137546,1991,460,256,204,237,89,148,57.81,0.578,0.515,0.436
138354,1991,380,215,165,40,16,24,11.16,0.112,0.105,0.097
138716,1991,541,292,249,39,7,32,10.96,0.11,0.072,0.028
138789,1991,567,340,227,50,14,36,10.59,0.106,0.088,0.062
139144,1991,429,253,176,220,85,135,53.36,0.534,0.513,0.483
139366,1991,509,312,197,30,9,21,6.73,0.067,0.059,0.046
139393,1991,136,73,63,56,21,35,47.95,0.48,0.412,0.333
139658,1991,1415,772,643,950,430,520,67.36,0.674,0.671,0.669
139719,1991,464,276,188,48,22,26,9.42,0.094,0.103,0.117
139755,1991,1750,415,1335,484,335,149,35.9,0.359,0.277,0.251
139764,1991,322,190,132,70,35,35,18.42,0.184,0.217,0.265
139861,1991,770,476,294,126,35,91,19.12,0.191,0.164,0.119
139931,1991,2737,1457,1280,508,172,336,23.06,0.231,0.186,0.134
139940,1991,1007,598,409,103,34,69,11.54,0.115,0.102,0.083
139959,1991,3408,1927,1481,1191,429,762,39.54,0.395,0.349,0.29
140447,1991,670,347,323,230,100,130,37.46,0.375,0.343,0.31
140960,1991,737,394,343,75,28,47,11.93,0.119,0.102,0.082
140988,1991,139,96,43,59,18,41,42.71,0.427,0.424,0.419
141185,1991,218,113,105,51,25,26,23.01,0.23,0.234,0.238
141264,1991,994,614,380,225,78,147,23.94,0.239,0.226,0.205
141334,1991,1178,664,514,157,43,114,17.17,0.172,0.133,0.084
141486,1991,122,73,49,23,9,14,19.18,0.192,0.189,0.184
141565,1991,198,100,98,10,2,8,8,0.08,0.051,0.02
141574,1991,1462,794,668,117,35,82,10.33,0.103,0.08,0.052
142276,1991,1091,569,522,47,14,33,5.8,0.058,0.043,0.027
142285,1991,1273,524,749,140,72,68,12.98,0.13,0.11,0.096
142461,1991,237,129,108,51,17,34,26.36,0.264,0.215,0.157
143084,1991,526,296,230,337,145,192,64.86,0.649,0.641,0.63
143288,1991,116,44,72,23,6,17,38.64,0.386,0.198,0.083
144005,1991,614,414,200,7,3,4,0.97,0.01,0.011,0.015
144281,1991,846,439,407,21,8,13,2.96,0.03,0.025,0.02
144740,1991,1047,593,454,388,147,241,40.64,0.406,0.371,0.324
144892,1991,1493,911,582,577,185,392,43.03,0.43,0.386,0.318
144962,1991,247,130,117,99,38,61,46.92,0.469,0.401,0.325
144971,1991,129,70,59,54,21,33,47.14,0.471,0.419,0.356
145600,1991,2356,1233,1123,197,83,114,9.25,0.092,0.084,0.074
145619,1991,246,117,129,87,37,50,42.74,0.427,0.354,0.287
145637,1991,5649,2615,3034,2770,1300,1470,56.21,0.562,0.49,0.428
145691,1991,241,117,124,85,39,46,39.32,0.393,0.353,0.315
145813,1991,3055,1757,1298,849,286,563,32.04,0.32,0.278,0.22
146481,1991,234,124,110,123,53,70,56.45,0.565,0.526,0.482
146612,1991,387,166,221,122,59,63,37.95,0.38,0.315,0.267
146719,1991,922,593,329,347,119,228,38.45,0.385,0.376,0.362
146825,1991,185,89,96,83,28,55,61.8,0.618,0.449,0.292
147013,1991,132,79,53,46,15,31,39.24,0.392,0.348,0.283
147244,1991,422,242,180,245,94,151,62.4,0.624,0.581,0.522
147341,1991,252,117,135,113,48,65,55.56,0.556,0.448,0.356
147703,1991,3161,1646,1515,651,251,400,24.3,0.243,0.206,0.166
147767,1991,1945,955,990,1601,782,819,85.76,0.858,0.823,0.79
147776,1991,724,447,277,17,5,12,2.68,0.027,0.023,0.018
147828,1991,376,209,167,140,42,98,46.89,0.469,0.372,0.251
148131,1991,296,153,143,105,44,61,39.87,0.399,0.355,0.308
148496,1991,152,124,28,58,11,47,37.9,0.379,0.382,0.393
148584,1991,171,81,90,58,22,36,44.44,0.444,0.339,0.244
148627,1991,160,109,51,50,11,39,35.78,0.358,0.312,0.216
149222,1991,2376,1018,1358,302,139,163,16.01,0.16,0.127,0.102
149231,1991,948,539,409,107,30,77,14.29,0.143,0.113,0.073
149772,1991,1685,877,808,354,155,199,22.69,0.227,0.21,0.192
149781,1991,544,277,267,373,164,209,75.45,0.755,0.686,0.614
150066,1991,460,245,215,123,47,76,31.02,0.31,0.267,0.219
150136,1991,3447,1976,1471,1555,602,953,48.23,0.482,0.451,0.409
150145,1991,116,61,55,29,17,12,19.67,0.197,0.25,0.309
150163,1991,622,363,259,252,94,158,43.53,0.435,0.405,0.363
150400,1991,475,258,217,367,157,210,81.4,0.814,0.773,0.724
150534,1991,694,403,291,281,101,180,44.67,0.447,0.405,0.347
150668,1991,194,106,88,83,30,53,50,0.5,0.428,0.341
150941,1991,154,76,78,55,30,25,32.89,0.329,0.357,0.385
151102,1991,1134,607,527,34,17,17,2.8,0.028,0.03,0.032
151111,1991,1536,862,674,54,24,30,3.48,0.035,0.035,0.036
151306,1991,1078,611,467,86,24,62,10.15,0.102,0.08,0.051
151324,1991,1919,969,950,276,114,162,16.72,0.167,0.144,0.12
151333,1991,315,199,116,8,1,7,3.52,0.035,0.025,0.009
151342,1991,554,352,202,40,15,25,7.1,0.071,0.072,0.074
151351,1991,5208,3013,2195,2205,881,1324,43.94,0.439,0.423,0.401
151360,1991,614,396,218,35,14,21,5.3,0.053,0.057,0.064
151379,1991,589,343,246,23,6,17,4.96,0.05,0.039,0.024
151388,1991,222,146,76,2,0,2,1.37,0.014,0.009,0
151777,1991,277,146,131,121,48,73,50,0.5,0.437,0.366
151786,1991,217,154,63,53,13,40,25.97,0.26,0.244,0.206
152080,1991,1880,717,1163,1635,988,647,90.24,0.902,0.87,0.85
152248,1991,921,466,455,17,6,11,2.36,0.024,0.018,0.013
152363,1991,252,94,158,95,51,44,46.81,0.468,0.377,0.323
152530,1991,466,248,218,247,94,153,61.69,0.617,0.53,0.431
152600,1991,615,340,275,327,114,213,62.65,0.626,0.532,0.415
153001,1991,273,110,163,107,57,50,45.45,0.454,0.392,0.35
153108,1991,414,239,175,224,95,129,53.97,0.54,0.541,0.543
153269,1991,744,424,320,398,154,244,57.55,0.576,0.535,0.481
153384,1991,324,184,140,248,104,144,78.26,0.783,0.765,0.743
153603,1991,3228,1368,1860,665,281,384,28.07,0.281,0.206,0.151
153834,1991,578,349,229,368,134,234,67.05,0.67,0.637,0.585
154095,1991,1949,1181,768,470,151,319,27.01,0.27,0.241,0.197
155089,1991,165,99,66,44,12,32,32.32,0.323,0.267,0.182
155317,1991,3287,1755,1532,749,291,458,26.1,0.261,0.228,0.19
155335,1991,82,61,21,15,3,12,19.67,0.197,0.183,0.143
155399,1991,2670,1322,1348,480,158,322,24.36,0.244,0.18,0.117
155520,1991,200,112,88,51,15,36,32.14,0.321,0.255,0.17
155627,1991,120,48,72,19,11,8,16.67,0.167,0.158,0.153
155937,1991,131,55,76,42,20,22,40,0.4,0.321,0.263
156213,1991,250,144,106,78,31,47,32.64,0.326,0.312,0.292
156286,1991,267,157,110,122,42,80,50.96,0.51,0.457,0.382
156295,1991,436,246,190,147,58,89,36.18,0.362,0.337,0.305
156365,1991,255,122,133,29,6,23,18.85,0.189,0.114,0.045
156541,1991,460,240,220,77,29,48,20,0.2,0.167,0.132
156745,1991,309,161,148,103,38,65,40.37,0.404,0.333,0.257
157058,1991,390,215,175,33,9,24,11.16,0.112,0.085,0.051
157076,1991,204,75,129,48,24,24,32,0.32,0.235,0.186
157085,1991,2817,1434,1383,389,138,251,17.5,0.175,0.138,0.1
157289,1991,2050,1007,1043,105,28,77,7.65,0.076,0.051,0.027
157386,1991,1261,674,587,99,32,67,9.94,0.099,0.079,0.055
157401,1991,1147,633,514,120,34,86,13.59,0.136,0.105,0.066
157447,1991,1282,698,584,42,14,28,4.01,0.04,0.033,0.024
157535,1991,181,134,47,25,6,19,14.18,0.142,0.138,0.128
157951,1991,2263,1267,996,259,77,182,14.36,0.144,0.114,0.077
158477,1991,207,124,83,87,29,58,46.77,0.468,0.42,0.349
159009,1991,1325,741,584,121,30,91,12.28,0.123,0.091,0.051
159391,1991,3342,1779,1563,579,201,378,21.25,0.212,0.173,0.129
159647,1991,1834,827,1007,278,108,170,20.56,0.206,0.152,0.107
159717,1991,1253,652,601,83,23,60,9.2,0.092,0.066,0.038
159966,1991,1204,698,506,57,13,44,6.3,0.063,0.047,0.026
160038,1991,1179,710,469,110,24,86,12.11,0.121,0.093,0.051
160612,1991,1898,1075,823,53,9,44,4.09,0.041,0.028,0.011
160621,1991,1907,985,922,59,10,49,4.97,0.05,0.031,0.011
160658,1991,2383,1300,1083,88,26,62,4.77,0.048,0.037,0.024
161004,1991,398,185,213,341,182,159,85.95,0.86,0.857,0.854
161226,1991,457,337,120,157,30,127,37.69,0.377,0.344,0.25
161235,1991,86,53,33,11,3,8,15.09,0.151,0.128,0.091
161244,1991,146,91,55,11,4,7,7.69,0.077,0.075,0.073
161253,1991,1589,710,879,324,140,184,25.92,0.259,0.204,0.159
161554,1991,763,419,344,68,23,45,10.74,0.107,0.089,0.067
162007,1991,310,189,121,37,7,30,15.87,0.159,0.119,0.058
162210,1991,78,45,33,19,6,13,28.89,0.289,0.244,0.182
162283,1991,311,195,116,29,6,23,11.79,0.118,0.093,0.052
162584,1991,762,381,381,187,67,120,31.5,0.315,0.245,0.176
162654,1991,203,142,61,121,31,90,63.38,0.634,0.596,0.508
162760,1991,145,143,2,70,1,69,48.25,0.482,0.483,0.5
162928,1991,846,304,542,707,444,263,86.51,0.865,0.836,0.819
163046,1991,700,400,300,475,171,304,76,0.76,0.679,0.57
163268,1991,910,467,443,185,71,114,24.41,0.244,0.203,0.16
163286,1991,3069,1406,1663,928,361,567,40.33,0.403,0.302,0.217
163453,1991,919,552,367,139,29,110,19.93,0.199,0.151,0.079
163462,1991,320,170,150,195,85,110,64.71,0.647,0.609,0.567
163851,1991,711,387,324,293,99,194,50.13,0.501,0.412,0.306
163912,1991,227,132,95,147,51,96,72.73,0.727,0.648,0.537
164076,1991,1237,735,502,335,78,257,34.97,0.35,0.271,0.155
164173,1991,269,233,36,44,6,38,16.31,0.163,0.164,0.167
164216,1991,182,99,83,105,40,65,65.66,0.657,0.577,0.482
164270,1991,278,132,146,160,71,89,67.42,0.674,0.576,0.486
164447,1991,250,110,140,84,43,41,37.27,0.373,0.336,0.307
164492,1991,116,87,29,54,9,45,51.72,0.517,0.466,0.31
164562,1991,447,286,161,298,110,188,65.73,0.657,0.667,0.683
165015,1991,745,392,353,546,247,299,76.28,0.763,0.733,0.7
165024,1991,982,568,414,265,67,198,34.86,0.349,0.27,0.162
165334,1991,561,307,254,344,137,207,67.43,0.674,0.613,0.539
165662,1991,399,269,130,217,89,128,47.58,0.476,0.544,0.685
165671,1991,138,138,0,51,0,51,36.96,0.37,0.37,NA
165820,1991,759,462,297,183,55,128,27.71,0.277,0.241,0.185
165866,1991,385,251,134,114,22,92,36.65,0.366,0.296,0.164
165936,1991,282,171,111,122,41,81,47.37,0.474,0.433,0.369
166027,1991,1601,669,932,1347,759,588,87.89,0.879,0.841,0.814
166124,1991,728,344,384,631,329,302,87.79,0.878,0.867,0.857
166513,1991,1075,386,689,276,146,130,33.68,0.337,0.257,0.212
166629,1991,3435,1665,1770,1271,511,760,45.65,0.456,0.37,0.289
166638,1991,529,270,259,68,27,41,15.19,0.152,0.129,0.104
166683,1991,1048,367,681,825,516,309,84.2,0.842,0.787,0.758
167288,1991,423,211,212,81,26,55,26.07,0.261,0.191,0.123
167987,1991,989,515,474,285,109,176,34.17,0.342,0.288,0.23
167996,1991,518,279,239,359,160,199,71.33,0.713,0.693,0.669
168005,1991,421,214,207,137,55,82,38.32,0.383,0.325,0.266
168148,1991,1155,640,515,870,378,492,76.88,0.769,0.753,0.734
168254,1991,428,166,262,165,81,84,50.6,0.506,0.386,0.309
168281,1991,319,210,109,222,62,160,76.19,0.762,0.696,0.569
168342,1991,517,246,271,467,238,229,93.09,0.931,0.903,0.878
168546,1991,548,266,282,349,179,170,63.91,0.639,0.637,0.635
168786,1991,231,134,97,65,26,39,29.1,0.291,0.281,0.268
169080,1991,858,489,369,412,168,244,49.9,0.499,0.48,0.455
169798,1991,2232,1255,977,176,65,111,8.84,0.088,0.079,0.067
169910,1991,2377,889,1488,90,47,43,4.84,0.048,0.038,0.032
170082,1991,1545,941,604,240,63,177,18.81,0.188,0.155,0.104
170301,1991,554,317,237,278,99,179,56.47,0.565,0.502,0.418
170532,1991,336,179,157,192,86,106,59.22,0.592,0.571,0.548
170639,1991,492,221,271,60,28,32,14.48,0.145,0.122,0.103
170976,1991,4908,2299,2609,2841,1363,1478,64.29,0.643,0.579,0.522
171100,1991,6314,3456,2858,1480,535,945,27.34,0.273,0.234,0.187
171128,1991,1283,319,964,234,145,89,27.9,0.279,0.182,0.15
171137,1991,597,308,289,50,22,28,9.09,0.091,0.084,0.076
171146,1991,485,286,199,32,7,25,8.74,0.087,0.066,0.035
171599,1991,162,55,107,30,18,12,21.82,0.218,0.185,0.168
172051,1991,564,296,268,26,6,20,6.76,0.068,0.046,0.022
172699,1991,2778,1543,1235,432,162,270,17.5,0.175,0.156,0.131
173160,1991,272,183,89,157,49,108,59.02,0.59,0.577,0.551
173258,1991,471,247,224,387,175,212,85.83,0.858,0.822,0.781
173328,1991,151,94,57,31,10,21,22.34,0.223,0.205,0.175
173647,1991,624,336,288,464,210,254,75.6,0.756,0.744,0.729
173902,1991,403,206,197,284,126,158,76.7,0.767,0.705,0.64
174066,1991,1979,917,1062,318,134,184,20.07,0.201,0.161,0.126
174233,1991,1091,567,524,196,69,127,22.4,0.224,0.18,0.132
174251,1991,462,272,190,155,55,100,36.76,0.368,0.335,0.289
174491,1991,267,165,102,84,24,60,36.36,0.364,0.315,0.235
174792,1991,415,0,415,247,247,0,NA,NA,0.595,0.595
174844,1991,733,391,342,534,246,288,73.66,0.737,0.729,0.719
174899,1991,276,206,70,114,28,86,41.75,0.418,0.413,0.4
174914,1991,854,457,397,393,174,219,47.92,0.479,0.46,0.438
175342,1991,899,520,379,108,25,83,15.96,0.16,0.12,0.066
175421,1991,43,27,16,5,2,3,11.11,0.111,0.116,0.125
175616,1991,445,283,162,111,33,78,27.56,0.276,0.249,0.204
175856,1991,1081,615,466,113,34,79,12.85,0.128,0.105,0.073
175980,1991,273,140,133,170,73,97,69.29,0.693,0.623,0.549
176017,1991,1690,892,798,484,169,315,35.31,0.353,0.286,0.212
176035,1991,339,282,57,99,10,89,31.56,0.316,0.292,0.175
176044,1991,386,223,163,34,7,27,12.11,0.121,0.088,0.043
176080,1991,1569,715,854,320,134,186,26.01,0.26,0.204,0.157
176406,1991,317,205,112,61,16,45,21.95,0.22,0.192,0.143
176628,1991,88,53,35,27,8,19,35.85,0.359,0.307,0.229
176947,1991,240,109,131,52,22,30,27.52,0.275,0.217,0.168
176965,1991,1952,1038,914,273,107,166,15.99,0.16,0.14,0.117
177418,1991,114,87,27,38,9,29,33.33,0.333,0.333,0.333
178059,1991,102,61,41,63,22,41,67.21,0.672,0.618,0.537
178341,1991,758,397,361,71,24,47,11.84,0.118,0.094,0.066
178387,1991,806,435,371,71,27,44,10.11,0.101,0.088,0.073
178396,1991,3368,1820,1548,959,356,603,33.13,0.331,0.285,0.23
178402,1991,494,270,224,55,26,29,10.74,0.107,0.111,0.116
178411,1991,711,135,576,58,43,15,11.11,0.111,0.082,0.075
178420,1991,637,341,296,72,28,44,12.9,0.129,0.113,0.095
178615,1991,1375,784,591,459,153,306,39.03,0.39,0.334,0.259
179043,1991,228,142,86,121,44,77,54.23,0.542,0.531,0.512
179159,1991,914,479,435,355,121,234,48.85,0.489,0.388,0.278
179557,1991,1487,815,672,222,70,152,18.65,0.186,0.149,0.104
179566,1991,2895,1571,1324,676,241,435,27.69,0.277,0.234,0.182
179867,1991,1131,544,587,863,417,446,81.99,0.82,0.763,0.71
179894,1991,187,110,77,65,24,41,37.27,0.373,0.348,0.312
179946,1991,194,83,111,99,56,43,51.81,0.518,0.51,0.505
180179,1991,248,168,80,17,4,13,7.74,0.077,0.069,0.05
180461,1991,1445,652,793,156,60,96,14.72,0.147,0.108,0.076
180522,1991,188,86,102,27,18,9,10.47,0.105,0.144,0.176
180984,1991,204,117,87,58,17,41,35.04,0.35,0.284,0.195
181002,1991,750,445,305,430,170,260,58.43,0.584,0.573,0.557
181020,1991,230,116,114,117,42,75,64.66,0.647,0.509,0.368
181127,1991,255,111,144,102,55,47,42.34,0.423,0.4,0.382
181215,1991,1230,665,565,141,54,87,13.08,0.131,0.115,0.096
181394,1991,1275,635,640,70,31,39,6.14,0.061,0.055,0.048
181446,1991,343,192,151,170,72,98,51.04,0.51,0.496,0.477
181464,1991,3386,1641,1745,379,121,258,15.72,0.157,0.112,0.069
181534,1991,235,129,106,24,7,17,13.18,0.132,0.102,0.066
181783,1991,681,357,324,103,38,65,18.21,0.182,0.151,0.117
182281,1991,1172,604,568,125,47,78,12.91,0.129,0.107,0.083
182290,1991,966,482,484,101,43,58,12.03,0.12,0.105,0.089
182634,1991,215,137,78,99,29,70,51.09,0.511,0.46,0.372
182795,1991,429,192,237,124,57,67,34.9,0.349,0.289,0.241
183062,1991,731,444,287,159,41,118,26.58,0.266,0.218,0.143
183080,1991,729,377,352,219,83,136,36.07,0.361,0.3,0.236
183239,1991,545,303,242,365,155,210,69.31,0.693,0.67,0.64
183822,1991,267,179,88,18,6,12,6.7,0.067,0.067,0.068
183974,1991,89,66,23,22,3,19,28.79,0.288,0.247,0.13
184348,1991,269,166,103,188,70,118,71.08,0.711,0.699,0.68
184603,1991,908,436,472,78,32,46,10.55,0.106,0.086,0.068
184612,1991,93,79,14,9,3,6,7.59,0.076,0.097,0.214
184782,1991,892,511,381,212,77,135,26.42,0.264,0.238,0.202
185129,1991,618,322,296,34,17,17,5.28,0.053,0.055,0.057
185572,1991,387,216,171,74,23,51,23.61,0.236,0.191,0.135
185590,1991,913,564,349,101,31,70,12.41,0.124,0.111,0.089
185828,1991,541,96,445,30,18,12,12.5,0.125,0.055,0.04
186131,1991,1122,474,648,1002,582,420,88.61,0.886,0.893,0.898
186201,1991,423,205,218,55,17,38,18.54,0.185,0.13,0.078
186283,1991,653,351,302,259,98,161,45.87,0.459,0.397,0.325
186584,1991,984,474,510,429,184,245,51.69,0.517,0.436,0.361
186876,1991,683,364,319,194,64,130,35.71,0.357,0.284,0.201
187134,1991,860,560,300,445,108,337,60.18,0.602,0.517,0.36
187444,1991,967,551,416,100,19,81,14.7,0.147,0.103,0.046
187985,1991,1716,915,801,147,61,86,9.4,0.094,0.086,0.076
188030,1991,1656,846,810,127,45,82,9.69,0.097,0.077,0.056
188429,1991,658,417,241,259,74,185,44.36,0.444,0.394,0.307
188641,1991,256,110,146,132,67,65,59.09,0.591,0.516,0.459
190044,1991,634,134,500,338,266,72,53.73,0.537,0.533,0.532
190099,1991,694,330,364,554,265,289,87.58,0.876,0.798,0.728
190150,1991,1085,464,621,851,481,370,79.74,0.797,0.784,0.775
190248,1991,85,43,42,29,10,19,44.19,0.442,0.341,0.238
190415,1991,2949,1345,1604,2336,1218,1118,83.12,0.831,0.792,0.759
190512,1991,1170,746,424,56,19,37,4.96,0.05,0.048,0.045
190549,1991,1475,843,632,135,42,93,11.03,0.11,0.092,0.066
190558,1991,1153,599,554,16,4,12,2,0.02,0.014,0.007
190567,1991,1126,505,621,19,11,8,1.58,0.016,0.017,0.018
190594,1991,808,617,191,30,3,27,4.38,0.044,0.037,0.016
190637,1991,711,470,241,15,8,7,1.49,0.015,0.021,0.033
190664,1991,1603,889,714,165,49,116,13.05,0.13,0.103,0.069
190691,1991,431,276,155,22,10,12,4.35,0.044,0.051,0.065
190725,1991,244,164,80,40,14,26,15.85,0.158,0.164,0.175
191241,1991,952,507,445,641,292,349,68.84,0.688,0.673,0.656
191515,1991,462,207,255,384,204,180,86.96,0.87,0.831,0.8
191533,1991,370,217,153,201,74,127,58.53,0.585,0.543,0.484
191630,1991,503,211,292,334,174,160,75.83,0.758,0.664,0.596
191649,1991,1338,747,591,567,190,377,50.47,0.505,0.424,0.321
191676,1991,244,152,92,119,46,73,48.03,0.48,0.488,0.5
191931,1991,1046,526,520,290,122,168,31.94,0.319,0.277,0.235
191968,1991,1638,831,807,1036,477,559,67.27,0.673,0.632,0.591
192192,1991,139,112,27,65,15,50,44.64,0.446,0.468,0.556
192323,1991,404,212,192,261,118,143,67.45,0.674,0.646,0.615
192439,1991,665,436,229,30,12,18,4.13,0.041,0.045,0.052
192703,1991,548,258,290,298,137,161,62.4,0.624,0.544,0.472
192749,1991,192,143,49,96,22,74,51.75,0.517,0.5,0.449
192819,1991,881,489,392,441,166,275,56.24,0.562,0.501,0.423
192925,1991,143,79,64,23,6,17,21.52,0.215,0.161,0.094
193016,1991,619,329,290,19,5,14,4.26,0.043,0.031,0.017
193292,1991,123,100,23,55,6,49,49,0.49,0.447,0.261
193353,1991,248,188,60,96,16,80,42.55,0.426,0.387,0.267
193399,1991,188,147,41,91,20,71,48.3,0.483,0.484,0.488
193584,1991,246,177,69,124,27,97,54.8,0.548,0.504,0.391
193645,1991,645,563,82,93,2,91,16.16,0.162,0.144,0.024
193654,1991,265,182,83,81,25,56,30.77,0.308,0.306,0.301
193900,1991,2338,1279,1059,1173,508,665,51.99,0.52,0.502,0.48
193973,1991,447,272,175,176,53,123,45.22,0.452,0.394,0.303
194161,1991,108,77,31,26,4,22,28.57,0.286,0.241,0.129
194310,1991,510,290,220,178,56,122,42.07,0.421,0.349,0.255
194824,1991,971,193,778,428,334,94,48.7,0.487,0.441,0.429
195003,1991,1265,370,895,287,162,125,33.78,0.338,0.227,0.181
195030,1991,1215,537,678,805,440,365,67.97,0.68,0.663,0.649
195164,1991,479,236,243,267,117,150,63.56,0.636,0.557,0.481
195173,1991,353,207,146,68,26,42,20.29,0.203,0.193,0.178
195216,1991,421,213,208,322,142,180,84.51,0.845,0.765,0.683
195234,1991,207,152,55,106,24,82,53.95,0.54,0.512,0.436
195243,1991,198,113,85,95,28,67,59.29,0.593,0.48,0.329
195304,1991,228,168,60,125,34,91,54.17,0.542,0.548,0.567
195474,1991,584,307,277,455,220,235,76.55,0.765,0.779,0.794
195526,1991,652,392,260,401,139,262,66.84,0.668,0.615,0.535
195544,1991,65,47,18,41,9,32,68.09,0.681,0.631,0.5
195809,1991,2483,1282,1201,612,253,359,28,0.28,0.246,0.211
196413,1991,2513,1294,1219,1388,596,792,61.21,0.612,0.552,0.489
196592,1991,503,330,173,37,15,22,6.67,0.067,0.074,0.087
197045,1991,328,169,159,96,42,54,31.95,0.32,0.293,0.264
197133,1991,592,364,228,460,167,293,80.49,0.805,0.777,0.732
197869,1991,1916,1025,891,562,185,377,36.78,0.368,0.293,0.208
197984,1991,174,92,82,56,21,35,38.04,0.38,0.322,0.256
198385,1991,397,179,218,339,178,161,89.94,0.899,0.854,0.817
198464,1991,2338,1288,1050,386,124,262,20.34,0.203,0.165,0.118
198507,1991,402,217,185,135,48,87,40.09,0.401,0.336,0.259
198516,1991,780,461,319,381,121,260,56.4,0.564,0.488,0.379
198835,1991,279,153,126,113,33,80,52.29,0.523,0.405,0.262
198969,1991,254,86,168,59,35,24,27.91,0.279,0.232,0.208
199102,1991,1469,803,666,275,63,212,26.4,0.264,0.187,0.095
199111,1991,336,199,137,77,18,59,29.65,0.296,0.229,0.131
199120,1991,3133,1941,1192,1966,672,1294,66.67,0.667,0.628,0.564
199139,1991,1552,876,676,347,86,261,29.79,0.298,0.224,0.127
199148,1991,1345,890,455,358,82,276,31.01,0.31,0.266,0.18
199157,1991,531,336,195,93,21,72,21.43,0.214,0.175,0.108
199193,1991,3296,1290,2006,773,370,403,31.24,0.312,0.235,0.184
199218,1991,1545,923,622,385,111,274,29.69,0.297,0.249,0.178
199281,1991,379,195,184,58,21,37,18.97,0.19,0.153,0.114
199306,1991,166,82,84,45,17,28,34.15,0.341,0.271,0.202
199412,1991,144,102,42,47,9,38,37.25,0.372,0.326,0.214
199582,1991,418,237,181,44,10,34,14.35,0.144,0.105,0.055
199643,1991,579,330,249,190,82,108,32.73,0.327,0.328,0.329
199847,1991,857,425,432,659,299,360,84.71,0.847,0.769,0.692
199962,1991,371,181,190,93,28,65,35.91,0.359,0.251,0.147
199999,1991,431,287,144,59,7,52,18.12,0.181,0.137,0.049
200004,1991,1011,522,489,210,84,126,24.14,0.241,0.208,0.172
200059,1991,315,165,150,30,12,18,10.91,0.109,0.095,0.08
200156,1991,288,134,154,68,21,47,35.07,0.351,0.236,0.136
200217,1991,317,179,138,96,33,63,35.2,0.352,0.303,0.239
200226,1991,162,83,79,21,3,18,21.69,0.217,0.13,0.038
200253,1991,546,363,183,52,14,38,10.47,0.105,0.095,0.077
200280,1991,1288,588,700,161,78,83,14.12,0.141,0.125,0.111
200332,1991,1192,491,701,134,58,76,15.48,0.155,0.112,0.083
200572,1991,186,100,86,21,2,19,19,0.19,0.113,0.023
201104,1991,542,238,304,145,52,93,39.08,0.391,0.268,0.171
201371,1991,193,93,100,85,30,55,59.14,0.591,0.44,0.3
201548,1991,370,218,152,232,87,145,66.51,0.665,0.627,0.572
201645,1991,647,245,402,327,173,154,62.86,0.629,0.505,0.43
201690,1991,661,327,334,92,34,58,17.74,0.177,0.139,0.102
202134,1991,959,435,524,70,34,36,8.28,0.083,0.073,0.065
202480,1991,1499,744,755,758,322,436,58.6,0.586,0.506,0.426
202523,1991,501,271,230,351,150,201,74.17,0.742,0.701,0.652
202763,1991,342,152,190,95,46,49,32.24,0.322,0.278,0.242
203085,1991,252,100,152,100,56,44,44,0.44,0.397,0.368
203128,1991,287,148,139,159,69,90,60.81,0.608,0.554,0.496
203368,1991,765,386,379,465,212,253,65.54,0.655,0.608,0.559
203517,1991,2692,1609,1083,579,168,411,25.54,0.255,0.215,0.155
203535,1991,420,218,202,347,167,180,82.57,0.826,0.826,0.827
203580,1991,61,49,12,18,3,15,30.61,0.306,0.295,0.25
203775,1991,312,206,106,89,21,68,33.01,0.33,0.285,0.198
203845,1991,215,108,107,102,41,61,56.48,0.565,0.474,0.383
204024,1991,3241,1858,1383,2040,736,1304,70.18,0.702,0.629,0.532
204185,1991,417,194,223,189,80,109,56.19,0.562,0.453,0.359
204194,1991,231,145,86,82,31,51,35.17,0.352,0.355,0.36
204617,1991,205,108,97,54,24,30,27.78,0.278,0.263,0.247
204796,1991,5502,2705,2797,1061,375,686,25.36,0.254,0.193,0.134
204857,1991,3187,1819,1368,1308,448,860,47.28,0.473,0.41,0.327
206330,1991,188,66,122,16,9,7,10.61,0.106,0.085,0.074
206589,1991,466,219,247,290,135,155,70.78,0.708,0.622,0.547
206604,1991,2111,1061,1050,199,66,133,12.54,0.125,0.094,0.063
206622,1991,719,380,339,383,193,190,50,0.5,0.533,0.569
206695,1991,1904,981,923,88,31,57,5.81,0.058,0.046,0.034
206914,1991,466,220,246,23,9,14,6.36,0.064,0.049,0.037
207209,1991,525,295,230,19,2,17,5.76,0.058,0.036,0.009
207306,1991,356,176,180,43,18,25,14.2,0.142,0.121,0.1
207324,1991,304,160,144,76,37,39,24.38,0.244,0.25,0.257
207388,1991,2092,1038,1054,399,144,255,24.57,0.246,0.191,0.137
207500,1991,2249,1082,1167,277,101,176,16.27,0.163,0.123,0.087
207722,1991,203,143,60,16,2,14,9.79,0.098,0.079,0.033
207847,1991,537,291,246,55,21,34,11.68,0.117,0.102,0.085
207865,1991,867,502,365,70,24,46,9.16,0.092,0.081,0.066
208822,1991,258,154,104,91,33,58,37.66,0.377,0.353,0.317
209056,1991,357,213,144,191,72,119,55.87,0.559,0.535,0.5
209065,1991,429,242,187,234,89,145,59.92,0.599,0.545,0.476
209542,1991,1543,696,847,403,184,219,31.47,0.315,0.261,0.217
209551,1991,1919,1068,851,683,238,445,41.67,0.417,0.356,0.28
209612,1991,261,154,107,93,38,55,35.71,0.357,0.356,0.355
209807,1991,670,330,340,86,34,52,15.76,0.158,0.128,0.1
209922,1991,292,146,146,139,71,68,46.58,0.466,0.476,0.486
210146,1991,553,303,250,66,26,40,13.2,0.132,0.119,0.104
210401,1991,390,221,169,253,99,154,69.68,0.697,0.649,0.586
210429,1991,576,367,209,98,22,76,20.71,0.207,0.17,0.105
210571,1991,236,120,116,143,58,85,70.83,0.708,0.606,0.5
210669,1991,606,289,317,354,173,181,62.63,0.626,0.584,0.546
210775,1991,194,128,66,56,16,40,31.25,0.312,0.289,0.242
211088,1991,140,110,30,92,13,79,71.82,0.718,0.657,0.433
211158,1991,1080,664,416,443,132,311,46.84,0.468,0.41,0.317
211291,1991,907,410,497,776,408,368,89.76,0.898,0.856,0.821
211352,1991,137,93,44,73,19,54,58.06,0.581,0.533,0.432
211361,1991,1107,565,542,141,48,93,16.46,0.165,0.127,0.089
211431,1991,144,138,6,59,2,57,41.3,0.413,0.41,0.333
211440,1991,1170,335,835,657,464,193,57.61,0.576,0.562,0.556
211468,1991,120,120,0,62,0,62,51.67,0.517,0.517,NA
211556,1991,100,100,0,52,0,52,52,0.52,0.52,NA
211583,1991,111,111,0,54,0,54,48.65,0.486,0.486,NA
211608,1991,324,139,185,33,14,19,13.67,0.137,0.102,0.076
211644,1991,973,584,389,232,64,168,28.77,0.288,0.238,0.165
211981,1991,332,140,192,98,43,55,39.29,0.393,0.295,0.224
212009,1991,557,317,240,433,184,249,78.55,0.785,0.777,0.767
212054,1991,1207,364,843,115,31,84,23.08,0.231,0.095,0.037
212106,1991,870,475,395,381,166,215,45.26,0.453,0.438,0.42
212115,1991,699,382,317,129,31,98,25.65,0.256,0.185,0.098
212133,1991,134,87,47,55,16,39,44.83,0.448,0.41,0.34
212160,1991,1456,853,603,243,65,178,20.87,0.209,0.167,0.108
212197,1991,455,309,146,265,78,187,60.52,0.605,0.582,0.534
212577,1991,504,228,276,355,173,182,79.82,0.798,0.704,0.627
212601,1991,465,264,201,186,79,107,40.53,0.405,0.4,0.393
212832,1991,89,79,10,25,1,24,30.38,0.304,0.281,0.1
212911,1991,295,147,148,256,124,132,89.8,0.898,0.868,0.838
213020,1991,2516,1452,1064,604,180,424,29.2,0.292,0.24,0.169
213251,1991,261,129,132,164,78,86,66.67,0.667,0.628,0.591
213321,1991,359,164,195,232,115,117,71.34,0.713,0.646,0.59
213349,1991,1427,813,614,295,59,236,29.03,0.29,0.207,0.096
213358,1991,120,76,44,34,10,24,31.58,0.316,0.283,0.227
213367,1991,594,293,301,331,152,179,61.09,0.611,0.557,0.505
213385,1991,519,243,276,426,212,214,88.07,0.881,0.821,0.768
213507,1991,180,77,103,98,50,48,62.34,0.623,0.544,0.485
213543,1991,1117,411,706,749,435,314,76.4,0.764,0.671,0.616
213613,1991,737,447,290,187,52,135,30.2,0.302,0.254,0.179
213668,1991,374,190,184,153,67,86,45.26,0.453,0.409,0.364
213783,1991,461,283,178,168,50,118,41.7,0.417,0.364,0.281
213826,1991,281,237,44,95,12,83,35.02,0.35,0.338,0.273
213996,1991,560,343,217,361,136,225,65.6,0.656,0.645,0.627
214041,1991,1089,672,417,429,127,302,44.94,0.449,0.394,0.305
214069,1991,246,187,59,86,23,63,33.69,0.337,0.35,0.39
214157,1991,288,143,145,192,92,100,69.93,0.699,0.667,0.634
214175,1991,463,258,205,336,140,196,75.97,0.76,0.726,0.683
214272,1991,84,58,26,30,5,25,43.1,0.431,0.357,0.192
214777,1991,3615,1712,1903,2808,1417,1391,81.25,0.812,0.777,0.745
215062,1991,2286,986,1300,1791,981,810,82.15,0.822,0.783,0.755
215743,1991,279,144,135,97,38,59,40.97,0.41,0.348,0.281
215798,1991,228,118,110,129,51,78,66.1,0.661,0.566,0.464
215929,1991,897,457,440,646,294,352,77.02,0.77,0.72,0.668
216010,1991,1163,631,532,474,153,321,50.87,0.509,0.408,0.288
216038,1991,1191,690,501,232,76,156,22.61,0.226,0.195,0.152
216287,1991,319,148,171,266,138,128,86.49,0.865,0.834,0.807
216339,1991,2084,1071,1013,287,115,172,16.06,0.161,0.138,0.114
216524,1991,234,124,110,155,69,86,69.35,0.694,0.662,0.627
216694,1991,317,185,132,112,33,79,42.7,0.427,0.353,0.25
216764,1991,1467,960,507,337,79,258,26.88,0.269,0.23,0.156
216807,1991,319,175,144,223,99,124,70.86,0.709,0.699,0.688
216852,1991,464,206,258,172,81,91,44.17,0.442,0.371,0.314
216931,1991,395,170,225,154,71,83,48.82,0.488,0.39,0.316
217059,1991,697,396,301,265,88,177,44.7,0.447,0.38,0.292
217156,1991,1358,658,700,1048,543,505,76.75,0.768,0.772,0.776
217402,1991,963,529,434,764,330,434,82.04,0.82,0.793,0.76
217536,1991,400,281,119,196,49,147,52.31,0.523,0.49,0.412
217776,1991,78,41,37,16,6,10,24.39,0.244,0.205,0.162
217819,1991,1434,943,491,483,104,379,40.19,0.402,0.337,0.212
217882,1991,2474,1120,1354,871,321,550,49.11,0.491,0.352,0.237
217998,1991,101,64,37,66,21,45,70.31,0.703,0.653,0.568
218061,1991,735,388,347,79,23,56,14.43,0.144,0.107,0.066
218229,1991,421,286,135,83,18,65,22.73,0.227,0.197,0.133
218238,1991,232,126,106,17,5,12,9.52,0.095,0.073,0.047
218399,1991,196,135,61,38,6,32,23.7,0.237,0.194,0.098
218414,1991,189,77,112,45,21,24,31.17,0.312,0.238,0.188
218663,1991,2591,1398,1193,643,242,401,28.68,0.287,0.248,0.203
218724,1991,584,328,256,84,26,58,17.68,0.177,0.144,0.102
218733,1991,888,486,402,85,17,68,13.99,0.14,0.096,0.042
218742,1991,485,277,208,58,13,45,16.25,0.162,0.12,0.062
218973,1991,295,117,178,217,124,93,79.49,0.795,0.736,0.697
219000,1991,323,221,102,151,41,110,49.77,0.498,0.467,0.402
219046,1991,492,285,207,23,5,18,6.32,0.063,0.047,0.024
219082,1991,209,110,99,9,2,7,6.36,0.064,0.043,0.02
219198,1991,126,95,31,38,8,30,31.58,0.316,0.302,0.258
219259,1991,511,258,253,45,15,30,11.63,0.116,0.088,0.059
219356,1991,1306,657,649,189,77,112,17.05,0.17,0.145,0.119
219471,1991,1150,661,489,223,78,145,21.94,0.219,0.194,0.16
219602,1991,771,492,279,70,14,56,11.38,0.114,0.091,0.05
219709,1991,238,146,92,68,21,47,32.19,0.322,0.286,0.228
219718,1991,107,68,39,12,6,6,8.82,0.088,0.112,0.154
219949,1991,165,88,77,26,13,13,14.77,0.148,0.158,0.169
220075,1991,1599,950,649,149,47,102,10.74,0.107,0.093,0.072
220215,1991,295,147,148,80,38,42,28.57,0.286,0.271,0.257
220613,1991,368,185,183,62,24,38,20.54,0.205,0.168,0.131
220631,1991,311,209,102,126,40,86,41.15,0.412,0.405,0.392
220710,1991,154,80,74,50,16,34,42.5,0.425,0.325,0.216
221351,1991,379,208,171,258,108,150,72.12,0.721,0.681,0.632
221519,1991,327,159,168,236,118,118,74.21,0.742,0.722,0.702
221731,1991,90,38,52,18,6,12,31.58,0.316,0.2,0.115
221847,1991,1362,637,725,185,57,128,20.09,0.201,0.136,0.079
221892,1991,193,113,80,46,23,23,20.35,0.204,0.238,0.288
222178,1991,656,338,318,176,75,101,29.88,0.299,0.268,0.236
222983,1991,307,173,134,187,77,110,63.58,0.636,0.609,0.575
223232,1991,2150,1240,910,947,347,600,48.39,0.484,0.44,0.381
224004,1991,116,72,44,26,7,19,26.39,0.264,0.224,0.159
224323,1991,280,163,117,138,50,88,53.99,0.54,0.493,0.427
225432,1991,570,299,271,10,6,4,1.34,0.013,0.018,0.022
225548,1991,266,125,141,42,14,28,22.4,0.224,0.158,0.099
225627,1991,330,246,84,35,4,31,12.6,0.126,0.106,0.048
226231,1991,207,26,181,51,44,7,26.92,0.269,0.246,0.243
226833,1991,708,332,376,14,8,6,1.81,0.018,0.02,0.021
227216,1991,2085,1169,916,210,62,148,12.66,0.127,0.101,0.068
227331,1991,361,278,83,38,6,32,11.51,0.115,0.105,0.072
227526,1991,1116,534,582,91,24,67,12.55,0.126,0.082,0.041
227757,1991,625,257,368,437,239,198,77.04,0.77,0.699,0.649
227845,1991,347,198,149,67,22,45,22.73,0.227,0.193,0.148
227863,1991,170,114,56,64,22,42,36.84,0.368,0.376,0.393
228042,1991,156,79,77,27,15,12,15.19,0.152,0.173,0.195
228149,1991,429,260,169,131,43,88,33.85,0.338,0.305,0.254
228246,1991,1229,652,577,671,289,382,58.59,0.586,0.546,0.501
228343,1991,324,173,151,191,89,102,58.96,0.59,0.59,0.589
228431,1991,2047,1234,813,353,74,279,22.61,0.226,0.172,0.091
228459,1991,2916,1634,1282,201,61,140,8.57,0.086,0.069,0.048
228501,1991,335,123,212,19,9,10,8.13,0.081,0.057,0.042
228529,1991,924,421,503,88,35,53,12.59,0.126,0.095,0.07
228705,1991,979,465,514,49,16,33,7.1,0.071,0.05,0.031
228723,1991,6034,2816,3218,1454,510,944,33.52,0.335,0.241,0.158
228769,1991,1608,759,849,116,45,71,9.35,0.094,0.072,0.053
228778,1991,5850,2743,3107,1722,723,999,36.42,0.364,0.294,0.233
228787,1991,99,50,49,21,10,11,22,0.22,0.212,0.204
228796,1991,1897,1005,892,45,16,29,2.89,0.029,0.024,0.018
228875,1991,1212,745,467,417,128,289,38.79,0.388,0.344,0.274
228981,1991,241,156,85,63,20,43,27.56,0.276,0.261,0.235
229018,1991,46,26,20,5,4,1,3.85,0.038,0.109,0.2
229027,1991,1479,799,680,69,27,42,5.26,0.053,0.047,0.04
229115,1991,2838,1439,1399,468,167,301,20.92,0.209,0.165,0.119
229780,1991,133,79,54,28,9,19,24.05,0.241,0.211,0.167
229814,1991,767,434,333,76,16,60,13.82,0.138,0.099,0.048
230603,1991,550,370,180,59,11,48,12.97,0.13,0.107,0.061
230728,1991,1359,857,502,1,1,0,0,0,0.001,0.002
230764,1991,1924,914,1010,268,107,161,17.61,0.176,0.139,0.106
230782,1991,1403,810,593,100,32,68,8.4,0.084,0.071,0.054
231059,1991,485,253,232,329,145,184,72.73,0.727,0.678,0.625
231174,1991,1821,929,892,884,385,499,53.71,0.537,0.485,0.432
231420,1991,106,67,39,7,2,5,7.46,0.075,0.066,0.051
231554,1991,126,61,65,35,15,20,32.79,0.328,0.278,0.231
231624,1991,1222,609,613,920,413,507,83.25,0.833,0.753,0.674
231712,1991,443,287,156,44,14,30,10.45,0.104,0.099,0.09
232025,1991,143,78,65,82,36,46,58.97,0.59,0.573,0.554
232043,1991,201,129,72,95,29,66,51.16,0.512,0.473,0.403
232089,1991,339,122,217,58,29,29,23.77,0.238,0.171,0.134
232186,1991,1678,927,751,348,106,242,26.11,0.261,0.207,0.141
232265,1991,1188,718,470,445,112,333,46.38,0.464,0.375,0.238
232423,1991,2121,1223,898,1105,381,724,59.2,0.592,0.521,0.424
232557,1991,849,451,398,146,53,93,20.62,0.206,0.172,0.133
232566,1991,634,465,169,223,43,180,38.71,0.387,0.352,0.254
232609,1991,327,200,127,142,47,95,47.5,0.475,0.434,0.37
232681,1991,712,496,216,458,123,335,67.54,0.675,0.643,0.569
232706,1991,211,159,52,81,21,60,37.74,0.377,0.384,0.404
232937,1991,1543,920,623,95,24,71,7.72,0.077,0.062,0.039
232982,1991,1363,685,678,161,48,113,16.5,0.165,0.118,0.071
233277,1991,1857,1122,735,365,88,277,24.69,0.247,0.197,0.12
233374,1991,805,409,396,623,294,329,80.44,0.804,0.774,0.742
233426,1991,421,267,154,188,58,130,48.69,0.487,0.447,0.377
233541,1991,180,104,76,35,10,25,24.04,0.24,0.194,0.132
233897,1991,326,155,171,52,16,36,23.23,0.232,0.16,0.094
233921,1991,4407,1878,2529,1566,697,869,46.27,0.463,0.355,0.276
234030,1991,1318,799,519,216,65,151,18.9,0.189,0.164,0.125
234085,1991,351,0,351,127,127,0,NA,NA,0.362,0.362
234155,1991,1161,692,469,107,12,95,13.73,0.137,0.092,0.026
234164,1991,382,196,186,53,9,44,22.45,0.224,0.139,0.048
235097,1991,730,421,309,114,40,74,17.58,0.176,0.156,0.129
235167,1991,445,263,182,173,59,114,43.35,0.434,0.389,0.324
236230,1991,489,291,198,215,63,152,52.23,0.522,0.44,0.318
236328,1991,696,395,301,401,162,239,60.51,0.605,0.576,0.538
236577,1991,370,253,117,95,27,68,26.88,0.269,0.257,0.231
236595,1991,390,229,161,133,51,82,35.81,0.358,0.341,0.317
236896,1991,282,132,150,55,26,29,21.97,0.22,0.195,0.173
236939,1991,1852,982,870,470,171,299,30.45,0.304,0.254,0.197
236948,1991,3484,1788,1696,1287,482,805,45.02,0.45,0.369,0.284
237011,1991,1547,921,626,288,86,202,21.93,0.219,0.186,0.137
237057,1991,319,167,152,201,82,119,71.26,0.713,0.63,0.539
237066,1991,240,141,99,94,29,65,46.1,0.461,0.392,0.293
237215,1991,305,163,142,9,2,7,4.29,0.043,0.03,0.014
237330,1991,401,229,172,87,32,55,24.02,0.24,0.217,0.186
237358,1991,141,80,61,13,4,9,11.25,0.112,0.092,0.066
237367,1991,1034,567,467,83,35,48,8.47,0.085,0.08,0.075
237792,1991,395,208,187,46,16,30,14.42,0.144,0.116,0.086
237899,1991,475,227,248,15,7,8,3.52,0.035,0.032,0.028
237932,1991,437,227,210,75,25,50,22.03,0.22,0.172,0.119
237969,1991,363,195,168,155,44,111,56.92,0.569,0.427,0.262
238032,1991,3307,1550,1757,796,325,471,30.39,0.304,0.241,0.185
238333,1991,261,147,114,135,50,85,57.82,0.578,0.517,0.439
238430,1991,125,89,36,24,7,17,19.1,0.191,0.192,0.194
238458,1991,275,168,107,132,35,97,57.74,0.577,0.48,0.327
238476,1991,401,227,174,183,65,118,51.98,0.52,0.456,0.374
238616,1991,205,104,101,64,27,37,35.58,0.356,0.312,0.267
238661,1991,126,96,30,17,1,16,16.67,0.167,0.135,0.033
239080,1991,146,105,41,52,10,42,40,0.4,0.356,0.244
239105,1991,1598,852,746,870,349,521,61.15,0.612,0.544,0.468
239628,1991,164,84,80,86,35,51,60.71,0.607,0.524,0.438
239716,1991,442,262,180,288,95,193,73.66,0.737,0.652,0.528
240107,1991,201,145,56,63,14,49,33.79,0.338,0.313,0.25
240189,1991,1765,990,775,200,60,140,14.14,0.141,0.113,0.077
240277,1991,775,506,269,75,21,54,10.67,0.107,0.097,0.078
240329,1991,1648,959,689,159,57,102,10.64,0.106,0.096,0.083
240338,1991,71,45,26,20,8,12,26.67,0.267,0.282,0.308
240365,1991,1411,787,624,136,31,105,13.34,0.133,0.096,0.05
240374,1991,627,333,294,29,11,18,5.41,0.054,0.046,0.037
240417,1991,1158,606,552,77,19,58,9.57,0.096,0.066,0.034
240426,1991,443,220,223,24,10,14,6.36,0.064,0.054,0.045
240444,1991,4582,2387,2195,1516,589,927,38.84,0.388,0.331,0.268
240453,1991,1392,730,662,145,53,92,12.6,0.126,0.104,0.08
240462,1991,986,339,647,110,56,54,15.93,0.159,0.112,0.087
240471,1991,1022,557,465,122,48,74,13.29,0.133,0.119,0.103
240480,1991,1494,763,731,183,62,121,15.86,0.159,0.122,0.085
240727,1991,1257,534,723,174,73,101,18.91,0.189,0.138,0.101
243443,1991,518,370,148,1,0,1,0.27,0.003,0.002,0
243780,1991,5754,2516,3238,1682,790,892,35.45,0.355,0.292,0.244
100654,1992,876,444,432,157,46,111,25,0.25,0.179,0.106
100663,1992,898,479,419,54,19,35,7.31,0.073,0.06,0.045
100751,1992,2436,1310,1126,684,240,444,33.89,0.339,0.281,0.213
100858,1992,3141,1621,1520,927,295,632,38.99,0.39,0.295,0.194
101435,1992,166,91,75,53,14,39,42.86,0.429,0.319,0.187
101480,1992,1106,615,491,116,34,82,13.33,0.133,0.105,0.069
101675,1992,226,108,118,107,52,55,50.93,0.509,0.473,0.441
101879,1992,554,321,233,74,24,50,15.58,0.156,0.134,0.103
102049,1992,662,405,257,295,108,187,46.17,0.462,0.446,0.42
102094,1992,1170,668,502,123,38,85,12.72,0.127,0.105,0.076
102234,1992,295,167,128,144,58,86,51.5,0.515,0.488,0.453
102368,1992,935,460,475,217,73,144,31.3,0.313,0.232,0.154
102377,1992,612,311,301,123,36,87,27.97,0.28,0.201,0.12
104151,1992,2901,1503,1398,452,162,290,19.29,0.193,0.156,0.116
104179,1992,3803,1926,1877,814,302,512,26.58,0.266,0.214,0.161
105330,1992,2095,1203,892,315,104,211,17.54,0.175,0.15,0.117
106245,1992,1092,600,492,61,23,38,6.33,0.063,0.056,0.047
106342,1992,138,80,58,51,21,30,37.5,0.375,0.37,0.362
106397,1992,2327,1066,1261,394,165,229,21.48,0.215,0.169,0.131
106412,1992,592,341,251,27,9,18,5.28,0.053,0.046,0.036
106458,1992,1607,855,752,164,48,116,13.57,0.136,0.102,0.064
106467,1992,812,438,374,112,33,79,18.04,0.18,0.138,0.088
106485,1992,581,302,279,53,15,38,12.58,0.126,0.091,0.054
106704,1992,1948,1150,798,352,116,236,20.52,0.205,0.181,0.145
107044,1992,818,434,384,238,91,147,33.87,0.339,0.291,0.237
107080,1992,335,183,152,174,76,98,53.55,0.535,0.519,0.5
107141,1992,196,109,87,70,31,39,35.78,0.358,0.357,0.356
107512,1992,296,148,148,121,36,85,57.43,0.574,0.409,0.243
107558,1992,120,53,67,11,7,4,7.55,0.076,0.092,0.104
110097,1992,464,290,174,176,64,112,38.62,0.386,0.379,0.368
110404,1992,233,60,173,165,119,46,76.67,0.767,0.708,0.688
110422,1992,1295,566,729,136,37,99,17.49,0.175,0.105,0.051
110486,1992,323,181,142,32,11,21,11.6,0.116,0.099,0.077
110495,1992,307,191,116,33,11,22,11.52,0.115,0.107,0.095
110510,1992,737,449,288,59,23,36,8.02,0.08,0.08,0.08
110529,1992,1358,551,807,84,34,50,9.07,0.091,0.062,0.042
110538,1992,1325,758,567,148,34,114,15.04,0.15,0.112,0.06
110547,1992,485,336,149,16,6,10,2.98,0.03,0.033,0.04
110556,1992,1559,860,699,165,52,113,13.14,0.131,0.106,0.074
110565,1992,1589,926,663,108,27,81,8.75,0.088,0.068,0.041
110574,1992,572,394,178,76,17,59,14.97,0.15,0.133,0.096
110583,1992,1565,961,604,79,27,52,5.41,0.054,0.05,0.045
110592,1992,1206,738,468,45,16,29,3.93,0.039,0.037,0.034
110617,1992,922,513,409,71,20,51,9.94,0.099,0.077,0.049
113698,1992,65,45,20,24,8,16,35.56,0.356,0.369,0.4
115755,1992,779,421,358,45,16,29,6.89,0.069,0.058,0.045
119173,1992,217,217,0,64,0,64,29.49,0.295,0.295,NA
120184,1992,85,54,31,34,14,20,37.04,0.37,0.4,0.452
121309,1992,374,248,126,94,27,67,27.02,0.27,0.251,0.214
121345,1992,382,192,190,316,148,168,87.5,0.875,0.827,0.779
122409,1992,1974,1129,845,154,45,109,9.65,0.096,0.078,0.053
122436,1992,929,524,405,462,175,287,54.77,0.548,0.497,0.432
122597,1992,1125,693,432,73,19,54,7.79,0.078,0.065,0.044
122612,1992,492,319,173,233,75,158,49.53,0.495,0.474,0.434
122931,1992,900,458,442,661,303,358,78.17,0.782,0.734,0.686
123554,1992,472,257,215,289,126,163,63.42,0.634,0.612,0.586
123572,1992,591,380,211,97,20,77,20.26,0.203,0.164,0.095
126562,1992,272,175,97,29,6,23,13.14,0.131,0.107,0.062
126580,1992,313,174,139,29,9,20,11.49,0.115,0.093,0.065
126614,1992,3559,1700,1859,1198,514,684,40.24,0.402,0.337,0.276
126818,1992,2202,1150,1052,575,205,370,32.17,0.322,0.261,0.195
127060,1992,555,284,271,303,130,173,60.92,0.609,0.546,0.48
127185,1992,1004,439,565,118,49,69,15.72,0.157,0.118,0.087
127565,1992,1227,614,613,49,17,32,5.21,0.052,0.04,0.028
127741,1992,1464,921,543,232,63,169,18.35,0.184,0.158,0.116
128106,1992,656,342,314,58,21,37,10.82,0.108,0.088,0.067
128744,1992,18,12,6,1,0,1,8.33,0.083,0.056,0
128771,1992,964,552,412,98,31,67,12.14,0.121,0.102,0.075
129020,1992,2831,1454,1377,968,354,614,42.23,0.422,0.342,0.257
129242,1992,861,506,355,672,277,395,78.06,0.781,0.78,0.78
129941,1992,302,74,228,42,30,12,16.22,0.162,0.139,0.132
130253,1992,491,240,251,114,52,62,25.83,0.258,0.232,0.207
130314,1992,105,105,0,42,0,42,40,0.4,0.4,NA
130493,1992,933,493,440,134,35,99,20.08,0.201,0.144,0.08
130590,1992,472,240,232,352,161,191,79.58,0.796,0.746,0.694
130697,1992,704,361,343,553,263,290,80.33,0.803,0.786,0.767
130776,1992,372,161,211,88,47,41,25.47,0.255,0.237,0.223
130794,1992,1326,640,686,1139,561,578,90.31,0.903,0.859,0.818
130934,1992,579,305,274,47,22,25,8.2,0.082,0.081,0.08
130943,1992,2944,1729,1215,1593,590,1003,58.01,0.58,0.541,0.486
131159,1992,1025,629,396,629,235,394,62.64,0.626,0.614,0.593
131283,1992,471,252,219,272,121,151,59.92,0.599,0.577,0.553
131450,1992,339,177,162,15,6,9,5.08,0.051,0.044,0.037
131469,1992,1193,642,551,695,291,404,62.93,0.629,0.583,0.528
131496,1992,1383,733,650,1179,550,629,85.81,0.858,0.852,0.846
131520,1992,1264,797,467,264,70,194,24.34,0.243,0.209,0.15
132471,1992,265,146,119,80,28,52,35.62,0.356,0.302,0.235
132602,1992,597,326,271,99,29,70,21.47,0.215,0.166,0.107
132903,1992,1405,745,660,330,92,238,31.95,0.32,0.235,0.139
133492,1992,348,182,166,187,92,95,52.2,0.522,0.537,0.554
133553,1992,801,132,669,190,149,41,31.06,0.311,0.237,0.223
133650,1992,1383,815,568,206,60,146,17.91,0.179,0.149,0.106
133669,1992,795,417,378,115,43,72,17.27,0.173,0.145,0.114
133711,1992,299,169,130,125,43,82,48.52,0.485,0.418,0.331
133881,1992,457,121,336,147,99,48,39.67,0.397,0.322,0.295
133951,1992,1124,625,499,197,64,133,21.28,0.213,0.175,0.128
134079,1992,343,200,143,147,45,102,51,0.51,0.429,0.315
134097,1992,3313,1949,1364,1259,378,881,45.2,0.452,0.38,0.277
134130,1992,4471,2097,2374,1377,568,809,38.58,0.386,0.308,0.239
134945,1992,304,128,176,81,33,48,37.5,0.375,0.266,0.188
135726,1992,1770,841,929,798,395,403,47.92,0.479,0.451,0.425
136172,1992,487,277,210,68,27,41,14.8,0.148,0.14,0.129
136950,1992,394,215,179,194,71,123,57.21,0.572,0.492,0.397
137546,1992,501,282,219,232,87,145,51.42,0.514,0.463,0.397
138354,1992,396,208,188,70,28,42,20.19,0.202,0.177,0.149
138716,1992,645,364,281,50,14,36,9.89,0.099,0.078,0.05
138789,1992,496,292,204,25,10,15,5.14,0.051,0.05,0.049
139144,1992,425,286,139,191,64,127,44.41,0.444,0.449,0.46
139366,1992,589,365,224,42,14,28,7.67,0.077,0.071,0.062
139393,1992,155,98,57,56,18,38,38.78,0.388,0.361,0.316
139658,1992,1478,872,606,1010,406,604,69.27,0.693,0.683,0.67
139719,1992,497,264,233,52,18,34,12.88,0.129,0.105,0.077
139755,1992,1691,467,1224,472,298,174,37.26,0.373,0.279,0.243
139764,1992,375,243,132,75,28,47,19.34,0.193,0.2,0.212
139861,1992,754,451,303,112,23,89,19.73,0.197,0.149,0.076
139931,1992,2828,1530,1298,506,174,332,21.7,0.217,0.179,0.134
139940,1992,998,574,424,96,36,60,10.45,0.104,0.096,0.085
139959,1992,3147,1823,1324,1456,521,935,51.29,0.513,0.463,0.394
140447,1992,579,349,230,158,45,113,32.38,0.324,0.273,0.196
140960,1992,636,346,290,50,15,35,10.12,0.101,0.079,0.052
140988,1992,175,118,57,65,20,45,38.14,0.381,0.371,0.351
141185,1992,201,114,87,53,19,34,29.82,0.298,0.264,0.218
141264,1992,1057,608,449,146,43,103,16.94,0.169,0.138,0.096
141334,1992,1182,657,525,141,39,102,15.53,0.155,0.119,0.074
141486,1992,127,73,54,23,8,15,20.55,0.206,0.181,0.148
141565,1992,286,173,113,23,10,13,7.51,0.075,0.08,0.088
141574,1992,1485,823,662,158,46,112,13.61,0.136,0.106,0.069
142276,1992,1091,556,535,66,22,44,7.91,0.079,0.06,0.041
142285,1992,1290,574,716,173,77,96,16.72,0.167,0.134,0.108
142461,1992,284,162,122,82,31,51,31.48,0.315,0.289,0.254
143084,1992,538,309,229,318,119,199,64.4,0.644,0.591,0.52
143288,1992,148,74,74,52,17,35,47.3,0.473,0.351,0.23
144005,1992,576,351,225,3,2,1,0.28,0.003,0.005,0.009
144281,1992,760,373,387,90,42,48,12.87,0.129,0.118,0.109
144740,1992,927,520,407,350,119,231,44.42,0.444,0.378,0.292
144892,1992,1463,893,570,464,132,332,37.18,0.372,0.317,0.232
144962,1992,229,128,101,92,29,63,49.22,0.492,0.402,0.287
144971,1992,119,60,59,53,22,31,51.67,0.517,0.445,0.373
145600,1992,2475,1273,1202,240,95,145,11.39,0.114,0.097,0.079
145619,1992,230,110,120,102,43,59,53.64,0.536,0.443,0.358
145637,1992,5491,2566,2925,2656,1267,1389,54.13,0.541,0.484,0.433
145691,1992,260,136,124,114,35,79,58.09,0.581,0.438,0.282
145813,1992,2898,1706,1192,772,229,543,31.83,0.318,0.266,0.192
146481,1992,235,123,112,145,66,79,64.23,0.642,0.617,0.589
146612,1992,345,161,184,84,34,50,31.06,0.311,0.243,0.185
146719,1992,985,587,398,377,143,234,39.86,0.399,0.383,0.359
146825,1992,171,84,87,67,23,44,52.38,0.524,0.392,0.264
147013,1992,134,82,52,53,19,34,41.46,0.415,0.396,0.365
147244,1992,516,302,214,289,102,187,61.92,0.619,0.56,0.477
147341,1992,125,67,58,61,23,38,56.72,0.567,0.488,0.397
147703,1992,2742,1537,1205,607,211,396,25.76,0.258,0.221,0.175
147767,1992,1889,948,941,1533,719,814,85.86,0.859,0.812,0.764
147776,1992,688,408,280,21,6,15,3.68,0.037,0.031,0.021
147828,1992,388,202,186,129,48,81,40.1,0.401,0.332,0.258
148131,1992,313,148,165,80,24,56,37.84,0.378,0.256,0.145
148496,1992,142,117,25,67,9,58,49.57,0.496,0.472,0.36
148584,1992,144,67,77,52,23,29,43.28,0.433,0.361,0.299
148627,1992,192,134,58,55,11,44,32.84,0.328,0.286,0.19
149222,1992,2756,1203,1553,442,195,247,20.53,0.205,0.16,0.126
149231,1992,965,558,407,100,32,68,12.19,0.122,0.104,0.079
149772,1992,1566,763,803,315,137,178,23.33,0.233,0.201,0.171
149781,1992,548,294,254,392,172,220,74.83,0.748,0.715,0.677
150066,1992,507,297,210,162,53,109,36.7,0.367,0.32,0.252
150136,1992,3265,1841,1424,699,236,463,25.15,0.252,0.214,0.166
150145,1992,152,88,64,48,16,32,36.36,0.364,0.316,0.25
150163,1992,666,383,283,257,98,159,41.51,0.415,0.386,0.346
150400,1992,566,326,240,410,169,241,73.93,0.739,0.724,0.704
150534,1992,754,435,319,322,117,205,47.13,0.471,0.427,0.367
150668,1992,201,104,97,73,37,36,34.62,0.346,0.363,0.381
150941,1992,150,92,58,75,24,51,55.43,0.554,0.5,0.414
151102,1992,1126,612,514,39,14,25,4.08,0.041,0.035,0.027
151111,1992,1507,837,670,42,18,24,2.87,0.029,0.028,0.027
151306,1992,1080,624,456,90,27,63,10.1,0.101,0.083,0.059
151324,1992,2187,1161,1026,339,124,215,18.52,0.185,0.155,0.121
151333,1992,304,200,104,15,4,11,5.5,0.055,0.049,0.038
151342,1992,564,337,227,34,11,23,6.82,0.068,0.06,0.048
151351,1992,5529,3233,2296,2231,840,1391,43.03,0.43,0.404,0.366
151360,1992,597,386,211,26,9,17,4.4,0.044,0.044,0.043
151379,1992,638,381,257,27,6,21,5.51,0.055,0.042,0.023
151388,1992,263,197,66,8,2,6,3.05,0.03,0.03,0.03
151777,1992,245,120,125,109,51,58,48.33,0.483,0.445,0.408
151786,1992,244,149,95,75,32,43,28.86,0.289,0.307,0.337
152080,1992,1879,822,1057,1631,900,731,88.93,0.889,0.868,0.851
152248,1992,985,535,450,22,8,14,2.62,0.026,0.022,0.018
152363,1992,258,129,129,94,40,54,41.86,0.419,0.364,0.31
152530,1992,491,256,235,324,153,171,66.8,0.668,0.66,0.651
152600,1992,601,334,267,305,117,188,56.29,0.563,0.507,0.438
153001,1992,290,132,158,129,56,73,55.3,0.553,0.445,0.354
153108,1992,428,235,193,242,98,144,61.28,0.613,0.565,0.508
153269,1992,838,476,362,407,150,257,53.99,0.54,0.486,0.414
153384,1992,295,168,127,234,101,133,79.17,0.792,0.793,0.795
153603,1992,3333,1432,1901,723,309,414,28.91,0.289,0.217,0.163
153834,1992,579,357,222,389,144,245,68.63,0.686,0.672,0.649
154095,1992,1659,984,675,435,143,292,29.67,0.297,0.262,0.212
155089,1992,150,101,49,31,6,25,24.75,0.248,0.207,0.122
155317,1992,3495,1778,1717,814,304,510,28.68,0.287,0.233,0.177
155335,1992,83,57,26,28,8,20,35.09,0.351,0.337,0.308
155399,1992,2778,1357,1421,484,189,295,21.74,0.217,0.174,0.133
155520,1992,217,107,110,42,16,26,24.3,0.243,0.194,0.145
155627,1992,119,43,76,24,9,15,34.88,0.349,0.202,0.118
155937,1992,118,52,66,33,9,24,46.15,0.462,0.28,0.136
156213,1992,268,165,103,95,38,57,34.55,0.346,0.354,0.369
156286,1992,283,155,128,98,40,58,37.42,0.374,0.346,0.312
156295,1992,397,206,191,148,66,82,39.81,0.398,0.373,0.346
156365,1992,208,85,123,27,9,18,21.18,0.212,0.13,0.073
156541,1992,332,185,147,97,36,61,32.97,0.33,0.292,0.245
156745,1992,325,174,151,109,37,72,41.38,0.414,0.335,0.245
157058,1992,393,226,167,16,4,12,5.31,0.053,0.041,0.024
157076,1992,147,71,76,41,13,28,39.44,0.394,0.279,0.171
157085,1992,2562,1374,1188,528,195,333,24.24,0.242,0.206,0.164
157289,1992,1745,843,902,133,45,88,10.44,0.104,0.076,0.05
157386,1992,1349,769,580,133,39,94,12.22,0.122,0.099,0.067
157401,1992,982,538,444,223,76,147,27.32,0.273,0.227,0.171
157447,1992,1359,714,645,49,12,37,5.18,0.052,0.036,0.019
157535,1992,198,139,59,17,8,9,6.47,0.065,0.086,0.136
157951,1992,2192,1261,931,271,80,191,15.15,0.152,0.124,0.086
158477,1992,249,146,103,84,38,46,31.51,0.315,0.337,0.369
159009,1992,1385,775,610,109,30,79,10.19,0.102,0.079,0.049
159391,1992,3503,1884,1619,651,219,432,22.93,0.229,0.186,0.135
159647,1992,1473,703,770,264,86,178,25.32,0.253,0.179,0.112
159717,1992,1272,705,567,64,16,48,6.81,0.068,0.05,0.028
159966,1992,1059,613,446,53,10,43,7.01,0.07,0.05,0.022
160038,1992,1227,737,490,108,30,78,10.58,0.106,0.088,0.061
160612,1992,2199,1285,914,86,21,65,5.06,0.051,0.039,0.023
160621,1992,2033,1066,967,91,20,71,6.66,0.067,0.045,0.021
160658,1992,2563,1396,1167,77,25,52,3.72,0.037,0.03,0.021
161004,1992,409,224,185,347,154,193,86.16,0.862,0.848,0.832
161226,1992,441,302,139,126,31,95,31.46,0.315,0.286,0.223
161235,1992,97,43,54,8,3,5,11.63,0.116,0.082,0.056
161244,1992,139,98,41,12,3,9,9.18,0.092,0.086,0.073
161253,1992,1413,630,783,293,128,165,26.19,0.262,0.207,0.163
161554,1992,682,365,317,51,17,34,9.32,0.093,0.075,0.054
162007,1992,329,199,130,35,6,29,14.57,0.146,0.106,0.046
162210,1992,69,46,23,12,1,11,23.91,0.239,0.174,0.043
162283,1992,350,183,167,14,1,13,7.1,0.071,0.04,0.006
162584,1992,839,454,385,236,68,168,37,0.37,0.281,0.177
162654,1992,223,155,68,131,27,104,67.1,0.671,0.587,0.397
162760,1992,150,143,7,91,4,87,60.84,0.608,0.607,0.571
162928,1992,847,325,522,685,402,283,87.08,0.871,0.809,0.77
163046,1992,792,452,340,565,229,336,74.34,0.743,0.713,0.674
163268,1992,884,437,447,200,79,121,27.69,0.277,0.226,0.177
163286,1992,3032,1470,1562,966,379,587,39.93,0.399,0.319,0.243
163453,1992,967,572,395,168,37,131,22.9,0.229,0.174,0.094
163462,1992,346,190,156,209,89,120,63.16,0.632,0.604,0.571
163851,1992,634,372,262,264,78,186,50,0.5,0.416,0.298
163912,1992,234,133,101,129,53,76,57.14,0.571,0.551,0.525
164076,1992,1336,824,512,365,99,266,32.28,0.323,0.273,0.193
164173,1992,200,154,46,44,7,37,24.03,0.24,0.22,0.152
164216,1992,276,145,131,160,70,90,62.07,0.621,0.58,0.534
164270,1992,300,160,140,164,62,102,63.75,0.638,0.547,0.443
164447,1992,225,95,130,71,38,33,34.74,0.347,0.316,0.292
164492,1992,80,48,32,35,16,19,39.58,0.396,0.438,0.5
164562,1992,446,287,159,304,102,202,70.38,0.704,0.682,0.642
165015,1992,757,413,344,556,250,306,74.09,0.741,0.734,0.727
165024,1992,963,567,396,213,54,159,28.04,0.28,0.221,0.136
165334,1992,527,317,210,280,106,174,54.89,0.549,0.531,0.505
165662,1992,408,276,132,198,70,128,46.38,0.464,0.485,0.53
165671,1992,149,149,0,52,0,52,34.9,0.349,0.349,NA
165820,1992,538,297,241,128,32,96,32.32,0.323,0.238,0.133
165866,1992,577,382,195,154,35,119,31.15,0.312,0.267,0.179
165936,1992,292,193,99,140,39,101,52.33,0.523,0.479,0.394
166027,1992,1603,686,917,1380,782,598,87.17,0.872,0.861,0.853
166124,1992,765,428,337,698,308,390,91.12,0.911,0.912,0.914
166513,1992,964,340,624,239,134,105,30.88,0.309,0.248,0.215
166629,1992,3993,1940,2053,1329,538,791,40.77,0.408,0.333,0.262
166638,1992,534,256,278,48,18,30,11.72,0.117,0.09,0.065
166683,1992,1137,398,739,919,583,336,84.42,0.844,0.808,0.789
167288,1992,203,105,98,49,18,31,29.52,0.295,0.241,0.184
167987,1992,869,453,416,223,75,148,32.67,0.327,0.257,0.18
167996,1992,514,314,200,387,135,252,80.25,0.802,0.753,0.675
168005,1992,382,190,192,113,43,70,36.84,0.368,0.296,0.224
168148,1992,1211,638,573,921,426,495,77.59,0.776,0.761,0.743
168254,1992,431,182,249,145,82,63,34.62,0.346,0.336,0.329
168281,1992,412,274,138,265,87,178,64.96,0.65,0.643,0.63
168342,1992,518,258,260,454,225,229,88.76,0.888,0.876,0.865
168546,1992,508,242,266,330,173,157,64.88,0.649,0.65,0.65
168786,1992,233,162,71,50,14,36,22.22,0.222,0.215,0.197
169080,1992,803,474,329,369,145,224,47.26,0.473,0.46,0.441
169798,1992,2149,1200,949,174,50,124,10.33,0.103,0.081,0.053
169910,1992,2051,835,1216,57,28,29,3.47,0.035,0.028,0.023
170082,1992,1557,982,575,289,91,198,20.16,0.202,0.186,0.158
170301,1992,687,408,279,371,134,237,58.09,0.581,0.54,0.48
170532,1992,349,201,148,193,77,116,57.71,0.577,0.553,0.52
170639,1992,482,226,256,84,35,49,21.68,0.217,0.174,0.137
170976,1992,5006,2342,2664,3058,1490,1568,66.95,0.67,0.611,0.559
171100,1992,6086,3320,2766,1897,669,1228,36.99,0.37,0.312,0.242
171128,1992,1260,321,939,253,169,84,26.17,0.262,0.201,0.18
171137,1992,625,323,302,46,18,28,8.67,0.087,0.074,0.06
171146,1992,523,317,206,45,8,37,11.67,0.117,0.086,0.039
171599,1992,139,39,100,14,5,9,23.08,0.231,0.101,0.05
172051,1992,655,360,295,42,8,34,9.44,0.094,0.064,0.027
172699,1992,2863,1614,1249,484,165,319,19.76,0.198,0.169,0.132
173160,1992,236,143,93,153,54,99,69.23,0.692,0.648,0.581
173258,1992,494,249,245,402,204,198,79.52,0.795,0.814,0.833
173328,1992,149,90,59,39,12,27,30,0.3,0.262,0.203
173647,1992,620,327,293,455,224,231,70.64,0.706,0.734,0.765
173902,1992,475,258,217,332,139,193,74.81,0.748,0.699,0.641
174066,1992,1980,905,1075,329,137,192,21.22,0.212,0.166,0.127
174233,1992,1163,566,597,221,95,126,22.26,0.223,0.19,0.159
174251,1992,497,291,206,187,67,120,41.24,0.412,0.376,0.325
174491,1992,308,183,125,106,40,66,36.07,0.361,0.344,0.32
174792,1992,435,0,435,236,236,0,NA,NA,0.543,0.543
174844,1992,701,409,292,501,192,309,75.55,0.755,0.715,0.658
174899,1992,325,240,85,126,36,90,37.5,0.375,0.388,0.424
174914,1992,798,444,354,362,141,221,49.77,0.498,0.454,0.398
175342,1992,531,310,221,73,16,57,18.39,0.184,0.137,0.072
175421,1992,89,52,37,22,10,12,23.08,0.231,0.247,0.27
175616,1992,443,247,196,98,35,63,25.51,0.255,0.221,0.179
175856,1992,906,477,429,89,21,68,14.26,0.143,0.098,0.049
175980,1992,274,143,131,167,75,92,64.34,0.643,0.609,0.573
176017,1992,1610,810,800,460,175,285,35.19,0.352,0.286,0.219
176035,1992,259,210,49,52,6,46,21.9,0.219,0.201,0.122
176044,1992,563,290,273,64,26,38,13.1,0.131,0.114,0.095
176080,1992,1672,760,912,316,130,186,24.47,0.245,0.189,0.143
176406,1992,325,215,110,69,15,54,25.12,0.251,0.212,0.136
176628,1992,91,50,41,21,10,11,22,0.22,0.231,0.244
176947,1992,209,79,130,42,20,22,27.85,0.278,0.201,0.154
176965,1992,1763,921,842,240,105,135,14.66,0.147,0.136,0.125
177418,1992,144,110,34,56,5,51,46.36,0.464,0.389,0.147
178059,1992,129,93,36,70,19,51,54.84,0.548,0.543,0.528
178341,1992,702,381,321,63,24,39,10.24,0.102,0.09,0.075
178387,1992,794,445,349,85,22,63,14.16,0.142,0.107,0.063
178396,1992,2904,1600,1304,828,305,523,32.69,0.327,0.285,0.234
178402,1992,480,257,223,42,13,29,11.28,0.113,0.088,0.058
178411,1992,809,174,635,64,40,24,13.79,0.138,0.079,0.063
178420,1992,474,224,250,49,18,31,13.84,0.138,0.103,0.072
178615,1992,1384,786,598,539,167,372,47.33,0.473,0.389,0.279
179043,1992,198,121,77,92,30,62,51.24,0.512,0.465,0.39
179159,1992,1051,546,505,473,187,286,52.38,0.524,0.45,0.37
179557,1992,1405,806,599,236,67,169,20.97,0.21,0.168,0.112
179566,1992,2925,1621,1304,420,110,310,19.12,0.191,0.144,0.084
179867,1992,1070,513,557,831,421,410,79.92,0.799,0.777,0.756
179894,1992,201,114,87,68,22,46,40.35,0.404,0.338,0.253
179946,1992,203,89,114,75,39,36,40.45,0.404,0.369,0.342
180179,1992,285,200,85,27,9,18,9,0.09,0.095,0.106
180461,1992,1530,646,884,155,65,90,13.93,0.139,0.101,0.074
180522,1992,188,98,90,20,13,7,7.14,0.071,0.106,0.144
180984,1992,202,114,88,73,24,49,42.98,0.43,0.361,0.273
181002,1992,843,517,326,509,190,319,61.7,0.617,0.604,0.583
181020,1992,241,125,116,136,55,81,64.8,0.648,0.564,0.474
181127,1992,254,124,130,112,43,69,55.65,0.556,0.441,0.331
181215,1992,1322,723,599,137,38,99,13.69,0.137,0.104,0.063
181394,1992,1256,630,626,54,19,35,5.56,0.056,0.043,0.03
181446,1992,366,212,154,174,72,102,48.11,0.481,0.475,0.468
181464,1992,3392,1651,1741,330,124,206,12.48,0.125,0.097,0.071
181534,1992,264,135,129,27,9,18,13.33,0.133,0.102,0.07
181783,1992,630,348,282,117,39,78,22.41,0.224,0.186,0.138
182281,1992,1213,641,572,128,44,84,13.1,0.131,0.106,0.077
182290,1992,1058,523,535,119,41,78,14.91,0.149,0.112,0.077
182634,1992,160,106,54,73,23,50,47.17,0.472,0.456,0.426
182795,1992,469,236,233,178,82,96,40.68,0.407,0.38,0.352
183062,1992,754,447,307,179,50,129,28.86,0.289,0.237,0.163
183080,1992,775,403,372,206,79,127,31.51,0.315,0.266,0.212
183239,1992,493,274,219,325,141,184,67.15,0.672,0.659,0.644
183822,1992,266,170,96,15,6,9,5.29,0.053,0.056,0.062
183974,1992,113,86,27,19,4,15,17.44,0.174,0.168,0.148
184348,1992,332,203,129,246,92,154,75.86,0.759,0.741,0.713
184603,1992,938,466,472,114,53,61,13.09,0.131,0.122,0.112
184612,1992,116,103,13,16,1,15,14.56,0.146,0.138,0.077
184782,1992,771,453,318,154,46,108,23.84,0.238,0.2,0.145
185129,1992,663,324,339,28,16,12,3.7,0.037,0.042,0.047
185572,1992,436,230,206,94,39,55,23.91,0.239,0.216,0.189
185590,1992,913,530,383,106,32,74,13.96,0.14,0.116,0.084
185828,1992,501,75,426,34,25,9,12,0.12,0.068,0.059
186131,1992,1135,516,619,1023,544,479,92.83,0.928,0.901,0.879
186201,1992,419,216,203,77,25,52,24.07,0.241,0.184,0.123
186283,1992,731,402,329,305,113,192,47.76,0.478,0.417,0.343
186584,1992,985,484,501,384,161,223,46.07,0.461,0.39,0.321
186876,1992,720,401,319,174,70,104,25.94,0.259,0.242,0.219
187134,1992,1068,712,356,628,174,454,63.76,0.638,0.588,0.489
187444,1992,962,536,426,94,24,70,13.06,0.131,0.098,0.056
187985,1992,1700,946,754,148,53,95,10.04,0.1,0.087,0.07
188030,1992,1598,830,768,152,58,94,11.33,0.113,0.095,0.076
188429,1992,591,356,235,153,40,113,31.74,0.317,0.259,0.17
188641,1992,300,136,164,151,73,78,57.35,0.574,0.503,0.445
190044,1992,549,138,411,294,210,84,60.87,0.609,0.536,0.511
190099,1992,690,368,322,589,257,332,90.22,0.902,0.854,0.798
190150,1992,1113,458,655,880,511,369,80.57,0.806,0.791,0.78
190248,1992,106,62,44,28,8,20,32.26,0.323,0.264,0.182
190415,1992,2893,1382,1511,2354,1179,1175,85.02,0.85,0.814,0.78
190512,1992,1359,830,529,52,20,32,3.86,0.039,0.038,0.038
190549,1992,1341,765,576,122,40,82,10.72,0.107,0.091,0.069
190558,1992,1126,593,533,17,3,14,2.36,0.024,0.015,0.006
190567,1992,1071,454,617,18,12,6,1.32,0.013,0.017,0.019
190594,1992,936,710,226,35,10,25,3.52,0.035,0.037,0.044
190637,1992,692,468,224,21,6,15,3.21,0.032,0.03,0.027
190664,1992,1448,819,629,146,35,111,13.55,0.136,0.101,0.056
190691,1992,640,392,248,22,12,10,2.55,0.025,0.034,0.048
190725,1992,302,205,97,45,9,36,17.56,0.176,0.149,0.093
191241,1992,1039,546,493,623,294,329,60.26,0.603,0.6,0.596
191515,1992,461,223,238,373,178,195,87.44,0.874,0.809,0.748
191533,1992,446,228,218,248,108,140,61.4,0.614,0.556,0.495
191630,1992,564,261,303,349,167,182,69.73,0.697,0.619,0.551
191649,1992,1403,769,634,571,196,375,48.76,0.488,0.407,0.309
191676,1992,296,195,101,141,44,97,49.74,0.497,0.476,0.436
191931,1992,1012,522,490,322,136,186,35.63,0.356,0.318,0.278
191968,1992,1566,832,734,978,425,553,66.47,0.665,0.625,0.579
192192,1992,160,121,39,53,12,41,33.88,0.339,0.331,0.308
192323,1992,371,215,156,254,105,149,69.3,0.693,0.685,0.673
192439,1992,837,552,285,34,15,19,3.44,0.034,0.041,0.053
192703,1992,577,250,327,244,120,124,49.6,0.496,0.423,0.367
192749,1992,183,139,44,106,23,83,59.71,0.597,0.579,0.523
192819,1992,820,451,369,514,201,313,69.4,0.694,0.627,0.545
192925,1992,185,86,99,21,4,17,19.77,0.198,0.114,0.04
193016,1992,867,534,333,19,7,12,2.25,0.022,0.022,0.021
193292,1992,1417,1055,362,65,7,58,5.5,0.055,0.046,0.019
193353,1992,254,180,74,97,25,72,40,0.4,0.382,0.338
193399,1992,185,153,32,88,12,76,49.67,0.497,0.476,0.375
193584,1992,211,159,52,129,24,105,66.04,0.66,0.611,0.462
193645,1992,935,777,158,85,7,78,10.04,0.1,0.091,0.044
193654,1992,423,275,148,155,41,114,41.45,0.415,0.366,0.277
193900,1992,2669,1511,1158,1355,571,784,51.89,0.519,0.508,0.493
193973,1992,517,334,183,184,60,124,37.13,0.371,0.356,0.328
194161,1992,104,60,44,37,14,23,38.33,0.383,0.356,0.318
194310,1992,543,357,186,151,42,109,30.53,0.305,0.278,0.226
194824,1992,1083,216,867,483,368,115,53.24,0.532,0.446,0.424
195003,1992,1482,432,1050,323,172,151,34.95,0.35,0.218,0.164
195030,1992,1266,585,681,824,425,399,68.21,0.682,0.651,0.624
195164,1992,441,216,225,226,93,133,61.57,0.616,0.512,0.413
195173,1992,372,200,172,63,26,37,18.5,0.185,0.169,0.151
195216,1992,601,294,307,413,207,206,70.07,0.701,0.687,0.674
195234,1992,233,177,56,122,21,101,57.06,0.571,0.524,0.375
195243,1992,214,125,89,53,9,44,35.2,0.352,0.248,0.101
195304,1992,220,168,52,127,30,97,57.74,0.577,0.577,0.577
195474,1992,544,315,229,399,153,246,78.1,0.781,0.733,0.668
195526,1992,615,369,246,425,144,281,76.15,0.762,0.691,0.585
195544,1992,55,42,13,32,7,25,59.52,0.595,0.582,0.538
195809,1992,2326,1211,1115,526,223,303,25.02,0.25,0.226,0.2
196413,1992,2581,1329,1252,1465,628,837,62.98,0.63,0.568,0.502
196592,1992,1037,676,361,63,14,49,7.25,0.072,0.061,0.039
197045,1992,323,183,140,90,37,53,28.96,0.29,0.279,0.264
197133,1992,597,370,227,478,175,303,81.89,0.819,0.801,0.771
197869,1992,2060,1146,914,621,215,406,35.43,0.354,0.301,0.235
197984,1992,145,67,78,42,22,20,29.85,0.299,0.29,0.282
198385,1992,414,221,193,367,170,197,89.14,0.891,0.886,0.881
198464,1992,2880,1673,1207,561,166,395,23.61,0.236,0.195,0.138
198507,1992,541,317,224,181,47,134,42.27,0.423,0.335,0.21
198516,1992,817,470,347,455,175,280,59.57,0.596,0.557,0.504
198835,1992,255,162,93,104,30,74,45.68,0.457,0.408,0.323
198969,1992,290,98,192,54,36,18,18.37,0.184,0.186,0.188
199102,1992,1484,780,704,290,86,204,26.15,0.262,0.195,0.122
199111,1992,364,195,169,101,33,68,34.87,0.349,0.277,0.195
199120,1992,3200,1957,1243,2009,733,1276,65.2,0.652,0.628,0.59
199139,1992,1575,813,762,291,111,180,22.14,0.221,0.185,0.146
199148,1992,1509,1000,509,363,80,283,28.3,0.283,0.241,0.157
199157,1992,759,452,307,134,30,104,23.01,0.23,0.177,0.098
199193,1992,3176,1219,1957,759,338,421,34.54,0.345,0.239,0.173
199218,1992,1225,771,454,320,95,225,29.18,0.292,0.261,0.209
199281,1992,417,199,218,68,26,42,21.11,0.211,0.163,0.119
199306,1992,147,66,81,45,18,27,40.91,0.409,0.306,0.222
199412,1992,127,95,32,45,8,37,38.95,0.39,0.354,0.25
199582,1992,401,232,169,61,14,47,20.26,0.203,0.152,0.083
199643,1992,740,428,312,124,33,91,21.26,0.213,0.168,0.106
199847,1992,909,445,464,639,300,339,76.18,0.762,0.703,0.647
199962,1992,365,179,186,84,36,48,26.82,0.268,0.23,0.194
199999,1992,391,267,124,83,20,63,23.6,0.236,0.212,0.161
200004,1992,1065,543,522,208,76,132,24.31,0.243,0.195,0.146
200059,1992,336,191,145,32,9,23,12.04,0.12,0.095,0.062
200156,1992,292,140,152,86,27,59,42.14,0.421,0.295,0.178
200217,1992,343,205,138,104,30,74,36.1,0.361,0.303,0.217
200226,1992,165,86,79,15,5,10,11.63,0.116,0.091,0.063
200253,1992,624,398,226,30,6,24,6.03,0.06,0.048,0.027
200280,1992,1579,724,855,189,87,102,14.09,0.141,0.12,0.102
200332,1992,1550,674,876,155,68,87,12.91,0.129,0.1,0.078
200572,1992,193,90,103,28,12,16,17.78,0.178,0.145,0.117
201104,1992,650,307,343,172,69,103,33.55,0.335,0.265,0.201
201371,1992,181,104,77,92,39,53,50.96,0.51,0.508,0.506
201548,1992,330,213,117,163,56,107,50.23,0.502,0.494,0.479
201645,1992,762,321,441,350,152,198,61.68,0.617,0.459,0.345
201690,1992,665,319,346,42,12,30,9.4,0.094,0.063,0.035
202134,1992,868,409,459,55,21,34,8.31,0.083,0.063,0.046
202480,1992,1622,778,844,832,343,489,62.85,0.629,0.513,0.406
202523,1992,570,301,269,392,174,218,72.43,0.724,0.688,0.647
202763,1992,412,197,215,153,62,91,46.19,0.462,0.371,0.288
203085,1992,229,88,141,86,46,40,45.45,0.454,0.376,0.326
203128,1992,277,134,143,116,116,0,0,0,0.419,0.811
203368,1992,748,395,353,452,184,268,67.85,0.678,0.604,0.521
203517,1992,2581,1580,1001,508,135,373,23.61,0.236,0.197,0.135
203535,1992,413,218,195,319,147,172,78.9,0.789,0.772,0.754
203580,1992,36,29,7,14,1,13,44.83,0.448,0.389,0.143
203775,1992,363,236,127,114,33,81,34.32,0.343,0.314,0.26
203845,1992,370,150,220,165,82,83,55.33,0.553,0.446,0.373
204024,1992,2985,1653,1332,1815,700,1115,67.45,0.674,0.608,0.526
204185,1992,380,178,202,170,73,97,54.49,0.545,0.447,0.361
204194,1992,283,168,115,86,36,50,29.76,0.298,0.304,0.313
204617,1992,208,121,87,56,19,37,30.58,0.306,0.269,0.218
204796,1992,5389,2625,2764,1024,351,673,25.64,0.256,0.19,0.127
204857,1992,3235,1952,1283,1396,427,969,49.64,0.496,0.432,0.333
206330,1992,148,48,100,15,7,8,16.67,0.167,0.101,0.07
206589,1992,459,240,219,273,118,155,64.58,0.646,0.595,0.539
206604,1992,1941,1028,913,159,42,117,11.38,0.114,0.082,0.046
206622,1992,672,331,341,345,166,179,54.08,0.541,0.513,0.487
206695,1992,1908,962,946,129,59,70,7.28,0.073,0.068,0.062
206914,1992,577,323,254,27,6,21,6.5,0.065,0.047,0.024
207209,1992,411,215,196,23,4,19,8.84,0.088,0.056,0.02
207306,1992,317,164,153,36,13,23,14.02,0.14,0.114,0.085
207324,1992,355,183,172,97,41,56,30.6,0.306,0.273,0.238
207388,1992,2148,1116,1032,400,130,270,24.19,0.242,0.186,0.126
207500,1992,2376,1164,1212,264,110,154,13.23,0.132,0.111,0.091
207722,1992,219,151,68,33,10,23,15.23,0.152,0.151,0.147
207847,1992,503,287,216,60,19,41,14.29,0.143,0.119,0.088
207865,1992,945,534,411,79,21,58,10.86,0.109,0.084,0.051
208822,1992,282,176,106,134,52,82,46.59,0.466,0.475,0.491
209056,1992,395,235,160,221,78,143,60.85,0.609,0.559,0.488
209065,1992,428,265,163,234,68,166,62.64,0.626,0.547,0.417
209542,1992,1703,771,932,442,179,263,34.11,0.341,0.26,0.192
209551,1992,2279,1179,1100,808,315,493,41.82,0.418,0.355,0.286
209612,1992,226,142,84,103,39,64,45.07,0.451,0.456,0.464
209807,1992,651,343,308,94,42,52,15.16,0.152,0.144,0.136
209922,1992,310,173,137,148,58,90,52.02,0.52,0.477,0.423
210146,1992,588,301,287,63,24,39,12.96,0.13,0.107,0.084
210401,1992,385,231,154,256,103,153,66.23,0.662,0.665,0.669
210429,1992,626,394,232,112,36,76,19.29,0.193,0.179,0.155
210571,1992,310,135,175,160,81,79,58.52,0.585,0.516,0.463
210669,1992,471,251,220,295,114,181,72.11,0.721,0.626,0.518
210775,1992,182,103,79,26,7,19,18.45,0.184,0.143,0.089
211088,1992,163,120,43,81,15,66,55,0.55,0.497,0.349
211158,1992,1047,696,351,423,87,336,48.28,0.483,0.404,0.248
211291,1992,890,426,464,739,376,363,85.21,0.852,0.83,0.81
211352,1992,161,115,46,91,24,67,58.26,0.583,0.565,0.522
211361,1992,962,436,526,139,45,94,21.56,0.216,0.144,0.086
211431,1992,159,148,11,50,2,48,32.43,0.324,0.314,0.182
211440,1992,1141,354,787,666,440,226,63.84,0.638,0.584,0.559
211468,1992,187,186,1,74,0,74,39.78,0.398,0.396,0
211556,1992,89,89,0,42,0,42,47.19,0.472,0.472,NA
211583,1992,145,145,0,76,0,76,52.41,0.524,0.524,NA
211608,1992,375,184,191,19,2,17,9.24,0.092,0.051,0.01
211644,1992,1093,679,414,246,60,186,27.39,0.274,0.225,0.145
211981,1992,347,146,201,132,61,71,48.63,0.486,0.38,0.303
212009,1992,569,342,227,428,178,250,73.1,0.731,0.752,0.784
212054,1992,1054,340,714,94,30,64,18.82,0.188,0.089,0.042
212106,1992,1026,588,438,441,165,276,46.94,0.469,0.43,0.377
212115,1992,628,368,260,143,39,104,28.26,0.283,0.228,0.15
212133,1992,183,130,53,82,20,62,47.69,0.477,0.448,0.377
212160,1992,1500,857,643,257,75,182,21.24,0.212,0.171,0.117
212197,1992,442,318,124,256,52,204,64.15,0.642,0.579,0.419
212577,1992,486,222,264,351,182,169,76.13,0.761,0.722,0.689
212601,1992,406,244,162,152,54,98,40.16,0.402,0.374,0.333
212832,1992,89,72,17,34,2,32,44.44,0.444,0.382,0.118
212911,1992,301,145,156,253,132,121,83.45,0.835,0.841,0.846
213020,1992,2423,1423,1000,665,197,468,32.89,0.329,0.274,0.197
213251,1992,258,132,126,161,68,93,70.45,0.705,0.624,0.54
213321,1992,467,213,254,310,159,151,70.89,0.709,0.664,0.626
213349,1992,1131,632,499,188,40,148,23.42,0.234,0.166,0.08
213358,1992,118,84,34,33,6,27,32.14,0.321,0.28,0.176
213367,1992,564,293,271,358,159,199,67.92,0.679,0.635,0.587
213385,1992,575,263,312,455,231,224,85.17,0.852,0.791,0.74
213507,1992,280,123,157,161,84,77,62.6,0.626,0.575,0.535
213543,1992,1089,385,704,720,430,290,75.32,0.753,0.661,0.611
213613,1992,906,514,392,210,61,149,28.99,0.29,0.232,0.156
213668,1992,359,179,180,174,72,102,56.98,0.57,0.485,0.4
213783,1992,485,294,191,148,44,104,35.37,0.354,0.305,0.23
213826,1992,239,193,46,81,5,76,39.38,0.394,0.339,0.109
213996,1992,568,357,211,376,142,234,65.55,0.655,0.662,0.673
214041,1992,1002,635,367,375,93,282,44.41,0.444,0.374,0.253
214069,1992,292,228,64,88,20,68,29.82,0.298,0.301,0.312
214157,1992,296,142,154,187,86,101,71.13,0.711,0.632,0.558
214175,1992,466,244,222,334,141,193,79.1,0.791,0.717,0.635
214272,1992,63,47,16,29,8,21,44.68,0.447,0.46,0.5
214777,1992,4227,1995,2232,2529,1163,1366,68.47,0.685,0.598,0.521
215062,1992,2259,977,1282,1789,972,817,83.62,0.836,0.792,0.758
215743,1992,297,145,152,121,58,63,43.45,0.435,0.407,0.382
215798,1992,267,152,115,148,50,98,64.47,0.645,0.554,0.435
215929,1992,898,495,403,605,262,343,69.29,0.693,0.674,0.65
216010,1992,1238,675,563,441,156,285,42.22,0.422,0.356,0.277
216038,1992,1164,658,506,242,95,147,22.34,0.223,0.208,0.188
216287,1992,353,172,181,285,143,142,82.56,0.826,0.807,0.79
216339,1992,2029,1068,961,337,124,213,19.94,0.199,0.166,0.129
216524,1992,403,199,204,285,131,154,77.39,0.774,0.707,0.642
216694,1992,346,178,168,158,65,93,52.25,0.522,0.457,0.387
216764,1992,1378,883,495,357,90,267,30.24,0.302,0.259,0.182
216807,1992,362,213,149,227,89,138,64.79,0.648,0.627,0.597
216852,1992,436,169,267,140,66,74,43.79,0.438,0.321,0.247
216931,1992,404,164,240,153,73,80,48.78,0.488,0.379,0.304
217059,1992,691,414,277,263,87,176,42.51,0.425,0.381,0.314
217156,1992,1406,711,695,1121,553,568,79.89,0.799,0.797,0.796
217402,1992,931,523,408,734,322,412,78.78,0.788,0.788,0.789
217536,1992,381,264,117,208,58,150,56.82,0.568,0.546,0.496
217776,1992,88,54,34,26,6,20,37.04,0.37,0.295,0.176
217819,1992,1296,853,443,426,100,326,38.22,0.382,0.329,0.226
217882,1992,2484,1179,1305,910,330,580,49.19,0.492,0.366,0.253
217998,1992,185,98,87,110,52,58,59.18,0.592,0.595,0.598
218061,1992,875,487,388,110,42,68,13.96,0.14,0.126,0.108
218229,1992,402,273,129,65,16,49,17.95,0.18,0.162,0.124
218238,1992,115,48,67,9,4,5,10.42,0.104,0.078,0.06
218399,1992,293,177,116,40,16,24,13.56,0.136,0.137,0.138
218414,1992,177,82,95,36,16,20,24.39,0.244,0.203,0.168
218663,1992,2460,1312,1148,643,257,386,29.42,0.294,0.261,0.224
218724,1992,591,305,286,71,17,54,17.7,0.177,0.12,0.059
218733,1992,701,366,335,89,25,64,17.49,0.175,0.127,0.075
218742,1992,399,240,159,56,16,40,16.67,0.167,0.14,0.101
218973,1992,287,132,155,206,113,93,70.45,0.705,0.718,0.729
219000,1992,347,228,119,162,48,114,50,0.5,0.467,0.403
219046,1992,1056,597,459,226,79,147,24.62,0.246,0.214,0.172
219082,1992,234,123,111,26,12,14,11.38,0.114,0.111,0.108
219198,1992,107,72,35,31,9,22,30.56,0.306,0.29,0.257
219259,1992,587,313,274,60,20,40,12.78,0.128,0.102,0.073
219356,1992,1495,701,794,293,112,181,25.82,0.258,0.196,0.141
219471,1992,1228,686,542,239,79,160,23.32,0.233,0.195,0.146
219602,1992,752,471,281,164,46,118,25.05,0.25,0.218,0.164
219709,1992,285,158,127,93,41,52,32.91,0.329,0.326,0.323
219718,1992,104,65,39,12,6,6,9.23,0.092,0.115,0.154
219949,1992,173,80,93,40,18,22,27.5,0.275,0.231,0.194
220075,1992,1610,971,639,150,37,113,11.64,0.116,0.093,0.058
220215,1992,286,156,130,92,32,60,38.46,0.385,0.322,0.246
220613,1992,359,207,152,63,20,43,20.77,0.208,0.175,0.132
220631,1992,328,207,121,127,47,80,38.65,0.386,0.387,0.388
220710,1992,194,94,100,67,23,44,46.81,0.468,0.345,0.23
221351,1992,360,202,158,256,113,143,70.79,0.708,0.711,0.715
221519,1992,338,171,167,230,111,119,69.59,0.696,0.68,0.665
221731,1992,74,20,54,13,3,10,50,0.5,0.176,0.056
221847,1992,1381,584,797,267,113,154,26.37,0.264,0.193,0.142
221892,1992,180,96,84,27,10,17,17.71,0.177,0.15,0.119
222178,1992,672,323,349,168,66,102,31.58,0.316,0.25,0.189
222983,1992,289,144,145,165,76,89,61.81,0.618,0.571,0.524
223232,1992,2363,1400,963,930,336,594,42.43,0.424,0.394,0.349
224004,1992,115,65,50,16,2,14,21.54,0.215,0.139,0.04
224323,1992,251,137,114,114,42,72,52.55,0.525,0.454,0.368
225432,1992,540,275,265,3,1,2,0.73,0.007,0.006,0.004
225548,1992,265,123,142,60,31,29,23.58,0.236,0.226,0.218
225627,1992,310,224,86,33,4,29,12.95,0.13,0.106,0.047
226231,1992,182,26,156,37,30,7,26.92,0.269,0.203,0.192
226833,1992,641,313,328,43,16,27,8.63,0.086,0.067,0.049
227216,1992,1794,1014,780,191,41,150,14.79,0.148,0.106,0.053
227331,1992,315,241,74,40,8,32,13.28,0.133,0.127,0.108
227526,1992,1194,579,615,261,97,164,28.32,0.283,0.219,0.158
227757,1992,598,266,332,437,221,216,81.2,0.812,0.731,0.666
227845,1992,337,196,141,57,27,30,15.31,0.153,0.169,0.191
227863,1992,173,123,50,2,0,2,1.63,0.016,0.012,0
228042,1992,140,75,65,12,3,9,12,0.12,0.086,0.046
228149,1992,491,285,206,139,43,96,33.68,0.337,0.283,0.209
228246,1992,1221,634,587,663,274,389,61.36,0.614,0.543,0.467
228343,1992,317,176,141,175,62,113,64.2,0.642,0.552,0.44
228431,1992,2183,1255,928,332,95,237,18.88,0.189,0.152,0.102
228459,1992,2310,1372,938,229,59,170,12.39,0.124,0.099,0.063
228501,1992,278,124,154,17,6,11,8.87,0.089,0.061,0.039
228529,1992,942,428,514,69,28,41,9.58,0.096,0.073,0.054
228705,1992,987,484,503,72,20,52,10.74,0.107,0.073,0.04
228723,1992,5968,2872,3096,2475,953,1522,52.99,0.53,0.415,0.308
228769,1992,1523,724,799,105,39,66,9.12,0.091,0.069,0.049
228778,1992,5633,2670,2963,1696,691,1005,37.64,0.376,0.301,0.233
228787,1992,93,34,59,21,9,12,35.29,0.353,0.226,0.153
228796,1992,1846,989,857,38,18,20,2.02,0.02,0.021,0.021
228875,1992,1261,746,515,506,161,345,46.25,0.462,0.401,0.313
228981,1992,251,148,103,65,22,43,29.05,0.291,0.259,0.214
229018,1992,71,46,25,6,3,3,6.52,0.065,0.085,0.12
229027,1992,1558,834,724,120,38,82,9.83,0.098,0.077,0.052
229115,1992,2823,1418,1405,528,195,333,23.48,0.235,0.187,0.139
229780,1992,133,84,49,20,7,13,15.48,0.155,0.15,0.143
229814,1992,848,421,427,98,27,71,16.86,0.169,0.116,0.063
230603,1992,649,421,228,84,18,66,15.68,0.157,0.129,0.079
230728,1992,1237,847,390,186,31,155,18.3,0.183,0.15,0.079
230764,1992,2026,996,1030,304,119,185,18.57,0.186,0.15,0.116
230782,1992,1211,729,482,52,15,37,5.08,0.051,0.043,0.031
231059,1992,414,211,203,277,121,156,73.93,0.739,0.669,0.596
231174,1992,1796,978,818,944,378,566,57.87,0.579,0.526,0.462
231420,1992,104,62,42,25,6,19,30.65,0.306,0.24,0.143
231554,1992,150,72,78,49,29,20,27.78,0.278,0.327,0.372
231624,1992,1202,680,522,954,386,568,83.53,0.835,0.794,0.739
231712,1992,478,300,178,44,10,34,11.33,0.113,0.092,0.056
232025,1992,188,79,109,61,25,36,45.57,0.456,0.324,0.229
232043,1992,205,117,88,87,31,56,47.86,0.479,0.424,0.352
232089,1992,337,130,207,78,46,32,24.62,0.246,0.231,0.222
232186,1992,1732,981,751,467,146,321,32.72,0.327,0.27,0.194
232265,1992,1139,675,464,364,80,284,42.07,0.421,0.32,0.172
232423,1992,2038,1171,867,1075,361,714,60.97,0.61,0.527,0.416
232557,1992,766,369,397,156,81,75,20.33,0.203,0.204,0.204
232566,1992,687,473,214,268,50,218,46.09,0.461,0.39,0.234
232609,1992,416,248,168,177,52,125,50.4,0.504,0.425,0.31
232681,1992,698,474,224,448,132,316,66.67,0.667,0.642,0.589
232706,1992,212,165,47,77,19,58,35.15,0.352,0.363,0.404
232937,1992,1492,893,599,76,24,52,5.82,0.058,0.051,0.04
232982,1992,1491,764,727,158,50,108,14.14,0.141,0.106,0.069
233277,1992,1807,1128,679,445,99,346,30.67,0.307,0.246,0.146
233374,1992,749,361,388,576,294,282,78.12,0.781,0.769,0.758
233426,1992,422,259,163,222,65,157,60.62,0.606,0.526,0.399
233541,1992,221,141,80,46,16,30,21.28,0.213,0.208,0.2
233897,1992,232,110,122,41,14,27,24.55,0.246,0.177,0.115
233921,1992,3851,1639,2212,1386,603,783,47.77,0.478,0.36,0.273
234030,1992,1460,877,583,270,92,178,20.3,0.203,0.185,0.158
234085,1992,349,0,349,174,174,0,NA,NA,0.499,0.499
234155,1992,911,496,415,46,11,35,7.06,0.071,0.05,0.027
234164,1992,449,238,211,45,12,33,13.87,0.139,0.1,0.057
235097,1992,753,480,273,124,38,86,17.92,0.179,0.165,0.139
235167,1992,399,239,160,116,39,77,32.22,0.322,0.291,0.244
236230,1992,500,295,205,214,69,145,49.15,0.492,0.428,0.337
236328,1992,725,446,279,433,166,267,59.87,0.599,0.597,0.595
236577,1992,380,253,127,103,24,79,31.23,0.312,0.271,0.189
236595,1992,439,236,203,161,74,87,36.86,0.369,0.367,0.365
236896,1992,267,126,141,58,27,31,24.6,0.246,0.217,0.191
236939,1992,2027,1019,1008,527,212,315,30.91,0.309,0.26,0.21
236948,1992,3509,1769,1740,1315,517,798,45.11,0.451,0.375,0.297
237011,1992,1455,883,572,341,98,243,27.52,0.275,0.234,0.171
237057,1992,336,167,169,218,104,114,68.26,0.683,0.649,0.615
237066,1992,266,151,115,113,44,69,45.7,0.457,0.425,0.383
237215,1992,371,192,179,9,4,5,2.6,0.026,0.024,0.022
237330,1992,393,233,160,50,9,41,17.6,0.176,0.127,0.056
237358,1992,201,108,93,49,22,27,25,0.25,0.244,0.237
237367,1992,1107,578,529,66,18,48,8.3,0.083,0.06,0.034
237792,1992,490,270,220,3,0,3,1.11,0.011,0.006,0
237899,1992,400,188,212,17,7,10,5.32,0.053,0.043,0.033
237932,1992,488,263,225,104,29,75,28.52,0.285,0.213,0.129
237969,1992,467,223,244,173,72,101,45.29,0.453,0.37,0.295
238032,1992,2978,1444,1534,766,296,470,32.55,0.325,0.257,0.193
238333,1992,306,159,147,171,68,103,64.78,0.648,0.559,0.463
238430,1992,199,133,66,20,10,10,7.52,0.075,0.101,0.152
238458,1992,298,193,105,93,27,66,34.2,0.342,0.312,0.257
238476,1992,406,233,173,196,80,116,49.79,0.498,0.483,0.462
238616,1992,183,103,80,69,31,38,36.89,0.369,0.377,0.388
238661,1992,131,90,41,25,7,18,20,0.2,0.191,0.171
239080,1992,190,125,65,52,14,38,30.4,0.304,0.274,0.215
239105,1992,1651,846,805,804,322,482,56.97,0.57,0.487,0.4
239628,1992,180,92,88,88,32,56,60.87,0.609,0.489,0.364
239716,1992,496,275,221,328,142,186,67.64,0.676,0.661,0.643
240107,1992,218,151,67,61,12,49,32.45,0.324,0.28,0.179
240189,1992,1746,933,813,204,68,136,14.58,0.146,0.117,0.084
240277,1992,780,487,293,85,22,63,12.94,0.129,0.109,0.075
240329,1992,1486,921,565,161,42,119,12.92,0.129,0.108,0.074
240338,1992,77,45,32,22,7,15,33.33,0.333,0.286,0.219
240365,1992,1461,834,627,172,32,140,16.79,0.168,0.118,0.051
240374,1992,633,321,312,32,14,18,5.61,0.056,0.051,0.045
240417,1992,988,530,458,114,25,89,16.79,0.168,0.115,0.055
240426,1992,350,189,161,35,14,21,11.11,0.111,0.1,0.087
240444,1992,4390,2244,2146,1514,599,915,40.78,0.408,0.345,0.279
240453,1992,1187,566,621,113,40,73,12.9,0.129,0.095,0.064
240462,1992,878,304,574,98,48,50,16.45,0.164,0.112,0.084
240471,1992,1009,543,466,151,68,83,15.29,0.153,0.15,0.146
240480,1992,1388,772,616,229,61,168,21.76,0.218,0.165,0.099
240727,1992,1281,640,641,221,73,148,23.12,0.231,0.173,0.114
243443,1992,584,396,188,47,7,40,10.1,0.101,0.08,0.037
243780,1992,5583,2396,3187,1589,761,828,34.56,0.346,0.285,0.239
100654,1993,1019,543,476,189,55,134,24.68,0.247,0.185,0.116
100663,1993,938,518,420,99,31,68,13.13,0.131,0.106,0.074
100751,1993,2516,1318,1198,638,231,407,30.88,0.309,0.254,0.193
100858,1993,2997,1552,1445,878,286,592,38.14,0.381,0.293,0.198
101435,1993,125,80,45,40,7,33,41.25,0.413,0.32,0.156
101480,1993,845,436,409,89,24,65,14.91,0.149,0.105,0.059
101675,1993,331,164,167,162,67,95,57.93,0.579,0.489,0.401
101879,1993,651,371,280,83,16,67,18.06,0.181,0.127,0.057
102049,1993,680,438,242,318,117,201,45.89,0.459,0.468,0.483
102094,1993,1086,621,465,125,38,87,14.01,0.14,0.115,0.082
102234,1993,229,129,100,106,43,63,48.84,0.488,0.463,0.43
102368,1993,926,526,400,303,108,195,37.07,0.371,0.327,0.27
102377,1993,595,302,293,104,39,65,21.52,0.215,0.175,0.133
104151,1993,3298,1637,1661,561,203,358,21.87,0.219,0.17,0.122
104179,1993,4287,2254,2033,968,317,651,28.88,0.289,0.226,0.156
105330,1993,1930,1090,840,306,103,203,18.62,0.186,0.159,0.123
106245,1993,966,565,401,59,12,47,8.32,0.083,0.061,0.03
106342,1993,166,84,82,65,29,36,42.86,0.429,0.392,0.354
106397,1993,2015,964,1051,401,158,243,25.21,0.252,0.199,0.15
106412,1993,735,379,356,52,15,37,9.76,0.098,0.071,0.042
106458,1993,1487,812,675,190,66,124,15.27,0.153,0.128,0.098
106467,1993,847,404,443,117,43,74,18.32,0.183,0.138,0.097
106485,1993,508,249,259,31,12,19,7.63,0.076,0.061,0.046
106704,1993,1792,1098,694,283,94,189,17.21,0.172,0.158,0.135
107044,1993,793,437,356,244,101,143,32.72,0.327,0.308,0.284
107080,1993,273,165,108,152,58,94,56.97,0.57,0.557,0.537
107141,1993,245,139,106,76,29,47,33.81,0.338,0.31,0.274
107512,1993,443,217,226,174,86,88,40.55,0.405,0.393,0.381
107558,1993,162,96,66,37,15,22,22.92,0.229,0.228,0.227
110097,1993,444,286,158,157,48,109,38.11,0.381,0.354,0.304
110404,1993,209,63,146,151,109,42,66.67,0.667,0.722,0.747
110422,1993,1600,722,878,155,36,119,16.48,0.165,0.097,0.041
110486,1993,317,200,117,38,12,26,13,0.13,0.12,0.103
110495,1993,387,232,155,60,22,38,16.38,0.164,0.155,0.142
110510,1993,692,433,259,37,9,28,6.47,0.065,0.053,0.035
110529,1993,1309,536,773,105,42,63,11.75,0.118,0.08,0.054
110538,1993,1244,754,490,169,27,142,18.83,0.188,0.136,0.055
110547,1993,389,252,137,15,5,10,3.97,0.04,0.039,0.036
110556,1993,1436,792,644,152,32,120,15.15,0.152,0.106,0.05
110565,1993,1309,748,561,112,40,72,9.63,0.096,0.086,0.071
110574,1993,553,371,182,59,11,48,12.94,0.129,0.107,0.06
110583,1993,1835,1125,710,80,21,59,5.24,0.052,0.044,0.03
110592,1993,1133,697,436,34,11,23,3.3,0.033,0.03,0.025
110617,1993,1086,635,451,51,8,43,6.77,0.068,0.047,0.018
113698,1993,75,46,29,17,4,13,28.26,0.283,0.227,0.138
115755,1993,553,324,229,60,9,51,15.74,0.157,0.108,0.039
119173,1993,276,273,3,56,0,56,20.51,0.205,0.203,0
120184,1993,96,76,20,36,5,31,40.79,0.408,0.375,0.25
121309,1993,425,255,170,127,34,93,36.47,0.365,0.299,0.2
121345,1993,390,183,207,317,167,150,81.97,0.82,0.813,0.807
122409,1993,1973,1081,892,126,25,101,9.34,0.093,0.064,0.028
122436,1993,890,516,374,468,171,297,57.56,0.576,0.526,0.457
122597,1993,1141,668,473,60,16,44,6.59,0.066,0.053,0.034
122612,1993,530,359,171,225,61,164,45.68,0.457,0.425,0.357
122931,1993,888,489,399,657,287,370,75.66,0.757,0.74,0.719
123554,1993,464,249,215,294,128,166,66.67,0.667,0.634,0.595
123572,1993,539,362,177,82,18,64,17.68,0.177,0.152,0.102
126562,1993,243,141,102,38,9,29,20.57,0.206,0.156,0.088
126580,1993,306,164,142,46,18,28,17.07,0.171,0.15,0.127
126614,1993,3440,1693,1747,1215,509,706,41.7,0.417,0.353,0.291
126818,1993,2168,1160,1008,611,210,401,34.57,0.346,0.282,0.208
127060,1993,576,306,270,332,144,188,61.44,0.614,0.576,0.533
127185,1993,1078,438,640,95,39,56,12.79,0.128,0.088,0.061
127565,1993,1380,682,698,43,22,21,3.08,0.031,0.031,0.032
127741,1993,1704,1019,685,309,81,228,22.37,0.224,0.181,0.118
128106,1993,678,321,357,78,34,44,13.71,0.137,0.115,0.095
128744,1993,137,66,71,58,20,38,57.58,0.576,0.423,0.282
128771,1993,902,483,419,80,18,62,12.84,0.128,0.089,0.043
129020,1993,2052,1068,984,775,297,478,44.76,0.448,0.378,0.302
129242,1993,773,392,381,595,283,312,79.59,0.796,0.77,0.743
129941,1993,289,103,186,47,27,20,19.42,0.194,0.163,0.145
130253,1993,515,274,241,197,72,125,45.62,0.456,0.383,0.299
130314,1993,93,93,0,47,0,47,50.54,0.505,0.505,NA
130493,1993,1044,572,472,139,38,101,17.66,0.177,0.133,0.081
130590,1993,476,242,234,362,173,189,78.1,0.781,0.761,0.739
130697,1993,703,365,338,547,257,290,79.45,0.795,0.778,0.76
130776,1993,526,247,279,115,50,65,26.32,0.263,0.219,0.179
130794,1993,1317,627,690,1135,582,553,88.2,0.882,0.862,0.843
130934,1993,686,386,300,68,11,57,14.77,0.148,0.099,0.037
130943,1993,3181,1847,1334,1623,573,1050,56.85,0.569,0.51,0.43
131159,1993,1039,660,379,641,219,422,63.94,0.639,0.617,0.578
131283,1993,505,276,229,306,130,176,63.77,0.638,0.606,0.568
131450,1993,306,164,142,18,6,12,7.32,0.073,0.059,0.042
131469,1993,1492,801,691,887,373,514,64.17,0.642,0.595,0.54
131496,1993,1377,720,657,1155,551,604,83.89,0.839,0.839,0.839
131520,1993,1492,951,541,352,88,264,27.76,0.278,0.236,0.163
132471,1993,232,143,89,77,19,58,40.56,0.406,0.332,0.213
132602,1993,543,291,252,100,28,72,24.74,0.247,0.184,0.111
132903,1993,1882,955,927,432,144,288,30.16,0.302,0.23,0.155
133492,1993,364,185,179,201,103,98,52.97,0.53,0.552,0.575
133553,1993,799,128,671,154,122,32,25,0.25,0.193,0.182
133650,1993,1507,908,599,210,46,164,18.06,0.181,0.139,0.077
133669,1993,743,412,331,104,34,70,16.99,0.17,0.14,0.103
133711,1993,338,193,145,147,59,88,45.6,0.456,0.435,0.407
133881,1993,358,109,249,93,65,28,25.69,0.257,0.26,0.261
133951,1993,1306,751,555,216,65,151,20.11,0.201,0.165,0.117
134079,1993,375,207,168,138,58,80,38.65,0.386,0.368,0.345
134097,1993,3603,2132,1471,1424,480,944,44.28,0.443,0.395,0.326
134130,1993,5074,2520,2554,1728,701,1027,40.75,0.408,0.341,0.274
134945,1993,310,139,171,92,47,45,32.37,0.324,0.297,0.275
135726,1993,1612,791,821,741,338,403,50.95,0.51,0.46,0.412
136172,1993,545,289,256,94,25,69,23.88,0.239,0.172,0.098
136950,1993,377,210,167,195,82,113,53.81,0.538,0.517,0.491
137546,1993,481,292,189,238,87,151,51.71,0.517,0.495,0.46
138354,1993,438,252,186,68,17,51,20.24,0.202,0.155,0.091
138716,1993,649,367,282,47,8,39,10.63,0.106,0.072,0.028
138789,1993,577,353,224,39,7,32,9.07,0.091,0.068,0.031
139144,1993,484,306,178,183,57,126,41.18,0.412,0.378,0.32
139366,1993,650,401,249,59,20,39,9.73,0.097,0.091,0.08
139393,1993,168,93,75,75,31,44,47.31,0.473,0.446,0.413
139658,1993,1406,762,644,999,458,541,71,0.71,0.711,0.711
139719,1993,539,290,249,27,3,24,8.28,0.083,0.05,0.012
139755,1993,1963,484,1479,398,252,146,30.17,0.302,0.203,0.17
139764,1993,349,226,123,38,6,32,14.16,0.142,0.109,0.049
139861,1993,809,520,289,122,18,104,20,0.2,0.151,0.062
139931,1993,2955,1602,1353,540,158,382,23.85,0.239,0.183,0.117
139940,1993,1072,613,459,119,33,86,14.03,0.14,0.111,0.072
139959,1993,3808,2115,1693,1617,630,987,46.67,0.467,0.425,0.372
140447,1993,639,378,261,243,85,158,41.8,0.418,0.38,0.326
140960,1993,760,391,369,48,15,33,8.44,0.084,0.063,0.041
140988,1993,165,112,53,60,15,45,40.18,0.402,0.364,0.283
141185,1993,165,105,60,47,15,32,30.48,0.305,0.285,0.25
141264,1993,1357,807,550,211,50,161,19.95,0.2,0.155,0.091
141334,1993,1263,738,525,97,19,78,10.57,0.106,0.077,0.036
141486,1993,84,50,34,17,5,12,24,0.24,0.202,0.147
141565,1993,310,190,120,20,4,16,8.42,0.084,0.065,0.033
141574,1993,1551,899,652,141,44,97,10.79,0.108,0.091,0.067
142276,1993,1165,626,539,44,12,32,5.11,0.051,0.038,0.022
142285,1993,1323,613,710,214,71,143,23.33,0.233,0.162,0.1
142461,1993,319,180,139,110,42,68,37.78,0.378,0.345,0.302
143084,1993,498,290,208,309,121,188,64.83,0.648,0.62,0.582
143288,1993,156,76,80,42,15,27,35.53,0.355,0.269,0.188
144005,1993,641,432,209,7,1,6,1.39,0.014,0.011,0.005
144281,1993,817,398,419,95,34,61,15.33,0.153,0.116,0.081
144740,1993,1182,701,481,416,159,257,36.66,0.367,0.352,0.331
144892,1993,1612,969,643,471,112,359,37.05,0.37,0.292,0.174
144962,1993,252,140,112,99,41,58,41.43,0.414,0.393,0.366
144971,1993,109,45,64,50,26,24,53.33,0.533,0.459,0.406
145600,1993,2589,1360,1229,229,85,144,10.59,0.106,0.088,0.069
145619,1993,270,125,145,104,43,61,48.8,0.488,0.385,0.297
145637,1993,5705,2588,3117,2665,1307,1358,52.47,0.525,0.467,0.419
145691,1993,261,150,111,113,34,79,52.67,0.527,0.433,0.306
145813,1993,2387,1440,947,648,183,465,32.29,0.323,0.271,0.193
146481,1993,271,140,131,148,65,83,59.29,0.593,0.546,0.496
146612,1993,344,155,189,109,49,60,38.71,0.387,0.317,0.259
146719,1993,856,511,345,366,141,225,44.03,0.44,0.428,0.409
146825,1993,151,72,79,64,21,43,59.72,0.597,0.424,0.266
147013,1993,119,72,47,34,12,22,30.56,0.306,0.286,0.255
147244,1993,452,235,217,256,111,145,61.7,0.617,0.566,0.512
147341,1993,204,93,111,77,31,46,49.46,0.495,0.377,0.279
147703,1993,2380,1320,1060,491,163,328,24.85,0.249,0.206,0.154
147767,1993,1903,950,953,1566,749,817,86,0.86,0.823,0.786
147776,1993,641,374,267,14,3,11,2.94,0.029,0.022,0.011
147828,1993,421,234,187,169,61,108,46.15,0.462,0.401,0.326
148131,1993,297,134,163,71,33,38,28.36,0.284,0.239,0.202
148496,1993,140,101,39,66,17,49,48.51,0.485,0.471,0.436
148584,1993,149,79,70,61,25,36,45.57,0.456,0.409,0.357
148627,1993,272,163,109,75,20,55,33.74,0.337,0.276,0.183
149222,1993,2271,969,1302,318,152,166,17.13,0.171,0.14,0.117
149231,1993,912,523,389,113,38,75,14.34,0.143,0.124,0.098
149772,1993,1531,793,738,347,146,201,25.35,0.254,0.227,0.198
149781,1993,546,282,264,371,159,212,75.18,0.752,0.679,0.602
150066,1993,423,251,172,131,43,88,35.06,0.351,0.31,0.25
150136,1993,3872,2104,1768,701,230,471,22.39,0.224,0.181,0.13
150145,1993,168,95,73,62,23,39,41.05,0.41,0.369,0.315
150163,1993,700,437,263,288,94,194,44.39,0.444,0.411,0.357
150400,1993,495,250,245,361,179,182,72.8,0.728,0.729,0.731
150534,1993,746,424,322,296,113,183,43.16,0.432,0.397,0.351
150668,1993,229,140,89,88,34,54,38.57,0.386,0.384,0.382
150941,1993,124,69,55,64,26,38,55.07,0.551,0.516,0.473
151102,1993,1189,650,539,47,17,30,4.62,0.046,0.04,0.032
151111,1993,1509,830,679,70,29,41,4.94,0.049,0.046,0.043
151306,1993,1162,681,481,79,21,58,8.52,0.085,0.068,0.044
151324,1993,2221,1165,1056,334,128,206,17.68,0.177,0.15,0.121
151333,1993,330,208,122,14,7,7,3.37,0.034,0.042,0.057
151342,1993,554,360,194,32,16,16,4.44,0.044,0.058,0.082
151351,1993,5833,3340,2493,2427,906,1521,45.54,0.455,0.416,0.363
151360,1993,665,415,250,26,13,13,3.13,0.031,0.039,0.052
151379,1993,700,392,308,37,12,25,6.38,0.064,0.053,0.039
151388,1993,264,168,96,8,2,6,3.57,0.036,0.03,0.021
151777,1993,238,118,120,94,43,51,43.22,0.432,0.395,0.358
151786,1993,239,150,89,74,23,51,34,0.34,0.31,0.258
152080,1993,1901,851,1050,1685,910,775,91.07,0.911,0.886,0.867
152248,1993,847,475,372,64,32,32,6.74,0.067,0.076,0.086
152363,1993,292,140,152,110,59,51,36.43,0.364,0.377,0.388
152530,1993,435,233,202,270,107,163,69.96,0.7,0.621,0.53
152600,1993,487,251,236,278,109,169,67.33,0.673,0.571,0.462
153001,1993,284,143,141,130,47,83,58.04,0.58,0.458,0.333
153108,1993,397,210,187,211,87,124,59.05,0.591,0.531,0.465
153269,1993,832,492,340,422,158,264,53.66,0.537,0.507,0.465
153384,1993,434,224,210,321,151,170,75.89,0.759,0.74,0.719
153603,1993,3416,1435,1981,763,327,436,30.38,0.304,0.223,0.165
153834,1993,586,341,245,411,176,235,68.91,0.689,0.701,0.718
154095,1993,1808,1112,696,491,152,339,30.49,0.305,0.272,0.218
155089,1993,230,125,105,55,22,33,26.4,0.264,0.239,0.21
155317,1993,3603,1849,1754,843,335,508,27.47,0.275,0.234,0.191
155335,1993,98,72,26,20,5,15,20.83,0.208,0.204,0.192
155399,1993,2739,1356,1383,550,203,347,25.59,0.256,0.201,0.147
155520,1993,212,97,115,36,16,20,20.62,0.206,0.17,0.139
155627,1993,130,51,79,39,16,23,45.1,0.451,0.3,0.203
155937,1993,156,76,80,42,18,24,31.58,0.316,0.269,0.225
156213,1993,268,177,91,109,36,73,41.24,0.412,0.407,0.396
156286,1993,309,172,137,135,65,70,40.7,0.407,0.437,0.474
156295,1993,453,230,223,150,78,72,31.3,0.313,0.331,0.35
156365,1993,286,122,164,48,19,29,23.77,0.238,0.168,0.116
156541,1993,397,205,192,80,24,56,27.32,0.273,0.202,0.125
156745,1993,285,153,132,79,20,59,38.56,0.386,0.277,0.152
157058,1993,335,163,172,18,7,11,6.75,0.068,0.054,0.041
157076,1993,173,79,94,41,17,24,30.38,0.304,0.237,0.181
157085,1993,2662,1391,1271,599,210,389,27.97,0.28,0.225,0.165
157289,1993,1743,858,885,157,57,100,11.66,0.117,0.09,0.064
157386,1993,1266,706,560,143,41,102,14.45,0.144,0.113,0.073
157401,1993,946,510,436,228,77,151,29.61,0.296,0.241,0.177
157447,1993,1517,890,627,55,11,44,4.94,0.049,0.036,0.018
157535,1993,167,117,50,20,7,13,11.11,0.111,0.12,0.14
157951,1993,2201,1222,979,238,80,158,12.93,0.129,0.108,0.082
158477,1993,211,121,90,80,33,47,38.84,0.388,0.379,0.367
159009,1993,1620,859,761,160,34,126,14.67,0.147,0.099,0.045
159391,1993,3178,1697,1481,586,182,404,23.81,0.238,0.184,0.123
159647,1993,1411,672,739,258,96,162,24.11,0.241,0.183,0.13
159717,1993,1307,702,605,66,13,53,7.55,0.076,0.05,0.021
159966,1993,969,586,383,33,12,21,3.58,0.036,0.034,0.031
160038,1993,1380,824,556,112,28,84,10.19,0.102,0.081,0.05
160612,1993,2192,1222,970,77,19,58,4.75,0.048,0.035,0.02
160621,1993,1658,862,796,80,16,64,7.42,0.074,0.048,0.02
160658,1993,2524,1378,1146,110,32,78,5.66,0.057,0.044,0.028
161004,1993,418,218,200,356,163,193,88.53,0.885,0.852,0.815
161226,1993,419,317,102,169,24,145,45.74,0.457,0.403,0.235
161235,1993,81,46,35,6,0,6,13.04,0.13,0.074,0
161244,1993,133,84,49,10,6,4,4.76,0.048,0.075,0.122
161253,1993,1211,522,689,320,131,189,36.21,0.362,0.264,0.19
161554,1993,732,390,342,48,18,30,7.69,0.077,0.066,0.053
162007,1993,257,152,105,30,9,21,13.82,0.138,0.117,0.086
162210,1993,94,52,42,17,7,10,19.23,0.192,0.181,0.167
162283,1993,500,264,236,26,6,20,7.58,0.076,0.052,0.025
162584,1993,910,433,477,210,87,123,28.41,0.284,0.231,0.182
162654,1993,242,168,74,138,34,104,61.9,0.619,0.57,0.459
162760,1993,163,161,2,102,0,102,63.35,0.634,0.626,0
162928,1993,64,32,32,37,16,21,65.62,0.656,0.578,0.5
163046,1993,739,436,303,515,181,334,76.61,0.766,0.697,0.597
163268,1993,929,419,510,215,97,118,28.16,0.282,0.231,0.19
163286,1993,3153,1461,1692,1051,447,604,41.34,0.413,0.333,0.264
163453,1993,944,567,377,138,26,112,19.75,0.198,0.146,0.069
163462,1993,325,166,159,218,99,119,71.69,0.717,0.671,0.623
163851,1993,726,405,321,297,92,205,50.62,0.506,0.409,0.287
163912,1993,284,153,131,166,68,98,64.05,0.64,0.585,0.519
164076,1993,1215,721,494,348,90,258,35.78,0.358,0.286,0.182
164173,1993,218,171,47,53,10,43,25.15,0.252,0.243,0.213
164216,1993,213,123,90,132,46,86,69.92,0.699,0.62,0.511
164270,1993,258,132,126,145,62,83,62.88,0.629,0.562,0.492
164447,1993,240,110,130,68,32,36,32.73,0.327,0.283,0.246
164492,1993,94,62,32,50,17,33,53.23,0.532,0.532,0.531
164562,1993,491,302,189,299,108,191,63.25,0.633,0.609,0.571
165015,1993,704,379,325,531,238,293,77.31,0.773,0.754,0.732
165024,1993,1045,590,455,196,68,128,21.69,0.217,0.188,0.149
165334,1993,443,257,186,251,102,149,57.98,0.58,0.567,0.548
165662,1993,427,263,164,256,100,156,59.32,0.593,0.6,0.61
165671,1993,133,133,0,59,0,59,44.36,0.444,0.444,NA
165820,1993,550,304,246,97,18,79,25.99,0.26,0.176,0.073
165866,1993,517,339,178,117,21,96,28.32,0.283,0.226,0.118
165936,1993,298,186,112,98,27,71,38.17,0.382,0.329,0.241
166027,1993,1601,715,886,1358,743,615,86.01,0.86,0.848,0.839
166124,1993,658,350,308,598,277,321,91.71,0.917,0.909,0.899
166513,1993,1033,392,641,217,108,109,27.81,0.278,0.21,0.168
166629,1993,3926,1908,2018,1436,577,859,45.02,0.45,0.366,0.286
166638,1993,546,253,293,44,15,29,11.46,0.115,0.081,0.051
166683,1993,1074,366,708,874,546,328,89.62,0.896,0.814,0.771
167288,1993,228,107,121,39,11,28,26.17,0.262,0.171,0.091
167987,1993,985,489,496,234,87,147,30.06,0.301,0.238,0.175
167996,1993,585,331,254,411,159,252,76.13,0.761,0.703,0.626
168005,1993,357,185,172,114,43,71,38.38,0.384,0.319,0.25
168148,1993,1193,632,561,923,422,501,79.27,0.793,0.774,0.752
168254,1993,392,149,243,120,64,56,37.58,0.376,0.306,0.263
168281,1993,417,300,117,263,71,192,64,0.64,0.631,0.607
168342,1993,527,269,258,467,222,245,91.08,0.911,0.886,0.86
168546,1993,488,251,237,270,145,125,49.8,0.498,0.553,0.612
168786,1993,219,152,67,67,14,53,34.87,0.349,0.306,0.209
169080,1993,908,524,384,471,194,277,52.86,0.529,0.519,0.505
169798,1993,2242,1217,1025,180,67,113,9.29,0.093,0.08,0.065
169910,1993,2114,810,1304,51,26,25,3.09,0.031,0.024,0.02
170082,1993,1511,916,595,262,79,183,19.98,0.2,0.173,0.133
170301,1993,657,360,297,360,157,203,56.39,0.564,0.548,0.529
170532,1993,338,198,140,217,86,131,66.16,0.662,0.642,0.614
170639,1993,593,290,303,95,35,60,20.69,0.207,0.16,0.116
170976,1993,5016,2428,2588,3078,1451,1627,67.01,0.67,0.614,0.561
171100,1993,6164,3372,2792,1851,641,1210,35.88,0.359,0.3,0.23
171128,1993,1026,262,764,215,133,82,31.3,0.313,0.21,0.174
171137,1993,631,311,320,50,21,29,9.32,0.093,0.079,0.066
171146,1993,504,322,182,41,12,29,9.01,0.09,0.081,0.066
171599,1993,234,78,156,53,30,23,29.49,0.295,0.226,0.192
172051,1993,633,337,296,112,36,76,22.55,0.226,0.177,0.122
172699,1993,2810,1587,1223,538,161,377,23.76,0.238,0.191,0.132
173160,1993,275,168,107,175,64,111,66.07,0.661,0.636,0.598
173258,1993,488,252,236,391,185,206,81.75,0.818,0.801,0.784
173328,1993,138,77,61,39,16,23,29.87,0.299,0.283,0.262
173647,1993,630,369,261,485,191,294,79.67,0.797,0.77,0.732
173902,1993,452,252,200,318,128,190,75.4,0.754,0.704,0.64
174066,1993,2272,1080,1192,413,171,242,22.41,0.224,0.182,0.143
174233,1993,1248,631,617,226,88,138,21.87,0.219,0.181,0.143
174251,1993,519,284,235,209,88,121,42.61,0.426,0.403,0.374
174491,1993,329,209,120,107,38,69,33.01,0.33,0.325,0.317
174792,1993,444,0,444,265,265,0,NA,NA,0.597,0.597
174844,1993,737,413,324,515,215,300,72.64,0.726,0.699,0.664
174899,1993,254,193,61,120,25,95,49.22,0.492,0.472,0.41
174914,1993,827,439,388,382,155,227,51.71,0.517,0.462,0.399
175342,1993,506,299,207,100,24,76,25.42,0.254,0.198,0.116
175421,1993,113,59,54,37,16,21,35.59,0.356,0.327,0.296
175616,1993,450,255,195,81,28,53,20.78,0.208,0.18,0.144
175856,1993,1105,596,509,124,35,89,14.93,0.149,0.112,0.069
175980,1993,319,161,158,189,95,94,58.39,0.584,0.592,0.601
176017,1993,1538,796,742,461,156,305,38.32,0.383,0.3,0.21
176035,1993,272,229,43,68,5,63,27.51,0.275,0.25,0.116
176044,1993,478,256,222,57,19,38,14.84,0.148,0.119,0.086
176080,1993,1633,777,856,330,118,212,27.28,0.273,0.202,0.138
176406,1993,311,223,88,79,17,62,27.8,0.278,0.254,0.193
176628,1993,84,57,27,25,3,22,38.6,0.386,0.298,0.111
176947,1993,238,108,130,62,21,41,37.96,0.38,0.261,0.162
176965,1993,1433,757,676,213,72,141,18.63,0.186,0.149,0.107
177418,1993,126,95,31,50,7,43,45.26,0.453,0.397,0.226
178059,1993,165,109,56,73,20,53,48.62,0.486,0.442,0.357
178341,1993,701,362,339,51,16,35,9.67,0.097,0.073,0.047
178387,1993,928,514,414,86,30,56,10.89,0.109,0.093,0.072
178396,1993,2898,1511,1387,828,320,508,33.62,0.336,0.286,0.231
178402,1993,515,266,249,53,18,35,13.16,0.132,0.103,0.072
178411,1993,786,190,596,78,58,20,10.53,0.105,0.099,0.097
178420,1993,458,231,227,52,17,35,15.15,0.152,0.114,0.075
178615,1993,1614,962,652,597,178,419,43.56,0.436,0.37,0.273
179043,1993,345,194,151,169,74,95,48.97,0.49,0.49,0.49
179159,1993,1066,578,488,500,188,312,53.98,0.54,0.469,0.385
179557,1993,1229,733,496,226,58,168,22.92,0.229,0.184,0.117
179566,1993,2800,1493,1307,376,109,267,17.88,0.179,0.134,0.083
179867,1993,1229,569,660,930,460,470,82.6,0.826,0.757,0.697
179894,1993,227,132,95,81,28,53,40.15,0.401,0.357,0.295
179946,1993,180,71,109,73,39,34,47.89,0.479,0.406,0.358
180179,1993,386,261,125,25,3,22,8.43,0.084,0.065,0.024
180461,1993,1716,756,960,195,89,106,14.02,0.14,0.114,0.093
180522,1993,223,106,117,20,9,11,10.38,0.104,0.09,0.077
180984,1993,230,114,116,87,31,56,49.12,0.491,0.378,0.267
181002,1993,833,492,341,438,164,274,55.69,0.557,0.526,0.481
181020,1993,246,135,111,127,52,75,55.56,0.556,0.516,0.468
181127,1993,266,147,119,119,48,71,48.3,0.483,0.447,0.403
181215,1993,936,501,435,124,37,87,17.37,0.174,0.132,0.085
181394,1993,1220,664,556,52,14,38,5.72,0.057,0.043,0.025
181446,1993,382,218,164,153,62,91,41.74,0.417,0.401,0.378
181464,1993,3325,1571,1754,449,170,279,17.76,0.178,0.135,0.097
181534,1993,211,112,99,22,4,18,16.07,0.161,0.104,0.04
181783,1993,718,398,320,105,25,80,20.1,0.201,0.146,0.078
182281,1993,1281,669,612,127,47,80,11.96,0.12,0.099,0.077
182290,1993,1140,563,577,155,49,106,18.83,0.188,0.136,0.085
182634,1993,179,115,64,72,24,48,41.74,0.417,0.402,0.375
182795,1993,410,186,224,117,64,53,28.49,0.285,0.285,0.286
183062,1993,809,488,321,170,43,127,26.02,0.26,0.21,0.134
183080,1993,748,364,384,163,63,100,27.47,0.275,0.218,0.164
183239,1993,510,284,226,323,128,195,68.66,0.687,0.633,0.566
183822,1993,270,192,78,20,5,15,7.81,0.078,0.074,0.064
183974,1993,95,77,18,20,2,18,23.38,0.234,0.211,0.111
184348,1993,312,190,122,226,84,142,74.74,0.747,0.724,0.689
184603,1993,860,422,438,128,46,82,19.43,0.194,0.149,0.105
184612,1993,129,105,24,10,0,10,9.52,0.095,0.078,0
184782,1993,713,408,305,152,43,109,26.72,0.267,0.213,0.141
185129,1993,514,276,238,27,11,16,5.8,0.058,0.053,0.046
185572,1993,477,220,257,94,43,51,23.18,0.232,0.197,0.167
185590,1993,868,531,337,117,34,83,15.63,0.156,0.135,0.101
185828,1993,476,90,386,33,22,11,12.22,0.122,0.069,0.057
186131,1993,1152,514,638,1032,563,469,91.25,0.912,0.896,0.882
186201,1993,361,199,162,62,21,41,20.6,0.206,0.172,0.13
186283,1993,663,376,287,267,104,163,43.35,0.434,0.403,0.362
186584,1993,996,522,474,376,142,234,44.83,0.448,0.378,0.3
186876,1993,709,369,340,193,77,116,31.44,0.314,0.272,0.226
187134,1993,1064,628,436,576,186,390,62.1,0.621,0.541,0.427
187444,1993,1091,608,483,89,14,75,12.34,0.123,0.082,0.029
187985,1993,1910,1067,843,171,52,119,11.15,0.112,0.09,0.062
188030,1993,1602,780,822,153,64,89,11.41,0.114,0.096,0.078
188429,1993,464,282,182,154,48,106,37.59,0.376,0.332,0.264
188641,1993,314,148,166,165,74,91,61.49,0.615,0.525,0.446
190044,1993,557,120,437,285,221,64,53.33,0.533,0.512,0.506
190099,1993,726,378,348,603,269,334,88.36,0.884,0.831,0.773
190150,1993,1626,997,629,1243,482,761,76.33,0.763,0.764,0.766
190248,1993,81,40,41,27,12,15,37.5,0.375,0.333,0.293
190415,1993,3172,1423,1749,2612,1400,1212,85.17,0.852,0.823,0.8
190512,1993,1300,798,502,63,25,38,4.76,0.048,0.048,0.05
190549,1993,1269,748,521,143,40,103,13.77,0.138,0.113,0.077
190558,1993,1100,579,521,23,9,14,2.42,0.024,0.021,0.017
190567,1993,1167,507,660,25,13,12,2.37,0.024,0.021,0.02
190594,1993,1308,1011,297,62,7,55,5.44,0.054,0.047,0.024
190637,1993,663,455,208,15,1,14,3.08,0.031,0.023,0.005
190664,1993,1526,831,695,180,55,125,15.04,0.15,0.118,0.079
190691,1993,607,359,248,29,13,16,4.46,0.045,0.048,0.052
190725,1993,405,271,134,58,19,39,14.39,0.144,0.143,0.142
191241,1993,989,532,457,587,271,316,59.4,0.594,0.594,0.593
191515,1993,452,195,257,361,192,169,86.67,0.867,0.799,0.747
191533,1993,429,217,212,201,80,121,55.76,0.558,0.469,0.377
191630,1993,493,236,257,325,146,179,75.85,0.758,0.659,0.568
191649,1993,1349,705,644,524,191,333,47.23,0.472,0.388,0.297
191676,1993,287,182,105,147,50,97,53.3,0.533,0.512,0.476
191931,1993,951,455,496,260,117,143,31.43,0.314,0.273,0.236
191968,1993,1365,721,644,813,345,468,64.91,0.649,0.596,0.536
192192,1993,172,124,48,47,13,34,27.42,0.274,0.273,0.271
192323,1993,415,213,202,254,107,147,69.01,0.69,0.612,0.53
192439,1993,918,633,285,36,13,23,3.63,0.036,0.039,0.046
192703,1993,546,254,292,307,152,155,61.02,0.61,0.562,0.521
192749,1993,214,133,81,86,30,56,42.11,0.421,0.402,0.37
192819,1993,806,460,346,371,134,237,51.52,0.515,0.46,0.387
192925,1993,202,94,108,38,16,22,23.4,0.234,0.188,0.148
193016,1993,733,403,330,16,6,10,2.48,0.025,0.022,0.018
193292,1993,175,139,36,74,8,66,47.48,0.475,0.423,0.222
193353,1993,239,164,75,90,29,61,37.2,0.372,0.377,0.387
193399,1993,174,136,38,71,9,62,45.59,0.456,0.408,0.237
193584,1993,266,192,74,142,29,113,58.85,0.589,0.534,0.392
193645,1993,821,677,144,89,14,75,11.08,0.111,0.108,0.097
193654,1993,441,282,159,142,50,92,32.62,0.326,0.322,0.314
193900,1993,2752,1592,1160,1395,546,849,53.33,0.533,0.507,0.471
193973,1993,432,259,173,202,68,134,51.74,0.517,0.468,0.393
194161,1993,109,69,40,30,8,22,31.88,0.319,0.275,0.2
194310,1993,659,430,229,228,64,164,38.14,0.381,0.346,0.279
194824,1993,936,168,768,408,303,105,62.5,0.625,0.436,0.395
195003,1993,1343,425,918,310,146,164,38.59,0.386,0.231,0.159
195030,1993,1229,599,630,754,365,389,64.94,0.649,0.614,0.579
195164,1993,370,187,183,215,95,120,64.17,0.642,0.581,0.519
195173,1993,358,214,144,107,40,67,31.31,0.313,0.299,0.278
195216,1993,507,260,247,353,167,186,71.54,0.715,0.696,0.676
195234,1993,236,160,76,116,24,92,57.5,0.575,0.492,0.316
195243,1993,211,132,79,86,24,62,46.97,0.47,0.408,0.304
195304,1993,255,195,60,131,31,100,51.28,0.513,0.514,0.517
195474,1993,616,339,277,421,185,236,69.62,0.696,0.683,0.668
195526,1993,588,355,233,414,153,261,73.52,0.735,0.704,0.657
195544,1993,78,61,17,42,10,32,52.46,0.525,0.538,0.588
195809,1993,2324,1174,1150,565,223,342,29.13,0.291,0.243,0.194
196413,1993,2418,1270,1148,1386,590,796,62.68,0.627,0.573,0.514
196592,1993,1236,815,421,70,6,64,7.85,0.078,0.057,0.014
197045,1993,256,140,116,84,35,49,35,0.35,0.328,0.302
197133,1993,649,414,235,497,169,328,79.23,0.792,0.766,0.719
197869,1993,1931,1098,833,603,192,411,37.43,0.374,0.312,0.23
197984,1993,136,69,67,44,20,24,34.78,0.348,0.324,0.299
198385,1993,452,195,257,381,212,169,86.67,0.867,0.843,0.825
198464,1993,2428,1417,1011,558,151,407,28.72,0.287,0.23,0.149
198507,1993,460,273,187,164,47,117,42.86,0.429,0.357,0.251
198516,1993,857,492,365,478,197,281,57.11,0.571,0.558,0.54
198835,1993,254,135,119,115,39,76,56.3,0.563,0.453,0.328
198969,1993,310,81,229,49,28,21,25.93,0.259,0.158,0.122
199102,1993,1429,775,654,300,85,215,27.74,0.277,0.21,0.13
199111,1993,394,222,172,129,42,87,39.19,0.392,0.327,0.244
199120,1993,3310,2048,1262,2089,744,1345,65.67,0.657,0.631,0.59
199139,1993,1685,845,840,312,111,201,23.79,0.238,0.185,0.132
199148,1993,1500,959,541,297,61,236,24.61,0.246,0.198,0.113
199157,1993,810,525,285,201,40,161,30.67,0.307,0.248,0.14
199193,1993,3277,1248,2029,841,397,444,35.58,0.356,0.257,0.196
199218,1993,1439,860,579,417,131,286,33.26,0.333,0.29,0.226
199281,1993,422,216,206,71,19,52,24.07,0.241,0.168,0.092
199306,1993,156,70,86,40,14,26,37.14,0.371,0.256,0.163
199412,1993,169,134,35,60,13,47,35.07,0.351,0.355,0.371
199582,1993,361,196,165,49,12,37,18.88,0.189,0.136,0.073
199643,1993,601,336,265,140,43,97,28.87,0.289,0.233,0.162
199847,1993,904,443,461,676,314,362,81.72,0.817,0.748,0.681
199962,1993,376,171,205,78,31,47,27.49,0.275,0.207,0.151
199999,1993,369,225,144,79,26,53,23.56,0.236,0.214,0.181
200004,1993,1051,509,542,226,91,135,26.52,0.265,0.215,0.168
200059,1993,300,148,152,22,5,17,11.49,0.115,0.073,0.033
200156,1993,262,121,141,62,27,35,28.93,0.289,0.237,0.191
200217,1993,350,224,126,91,20,71,31.7,0.317,0.26,0.159
200226,1993,146,61,85,17,4,13,21.31,0.213,0.116,0.047
200253,1993,579,346,233,48,13,35,10.12,0.101,0.083,0.056
200280,1993,1465,747,718,205,80,125,16.73,0.167,0.14,0.111
200332,1993,1433,571,862,182,76,106,18.56,0.186,0.127,0.088
200572,1993,196,80,116,34,12,22,27.5,0.275,0.173,0.103
201104,1993,510,268,242,134,29,105,39.18,0.392,0.263,0.12
201371,1993,214,105,109,110,43,67,63.81,0.638,0.514,0.394
201548,1993,448,266,182,238,81,157,59.02,0.59,0.531,0.445
201645,1993,712,249,463,354,201,153,61.45,0.615,0.497,0.434
201690,1993,613,301,312,66,18,48,15.95,0.16,0.108,0.058
202134,1993,942,479,463,77,26,51,10.65,0.107,0.082,0.056
202480,1993,1507,730,777,769,324,445,60.96,0.61,0.51,0.417
202523,1993,535,290,245,342,142,200,68.97,0.69,0.639,0.58
202763,1993,394,190,204,162,76,86,45.26,0.453,0.411,0.373
203085,1993,217,105,112,86,38,48,45.71,0.457,0.396,0.339
203128,1993,263,127,136,134,64,70,55.12,0.551,0.51,0.471
203368,1993,813,422,391,487,216,271,64.22,0.642,0.599,0.552
203517,1993,2371,1476,895,540,163,377,25.54,0.255,0.228,0.182
203535,1993,408,231,177,316,129,187,80.95,0.809,0.775,0.729
203580,1993,51,39,12,12,1,11,28.21,0.282,0.235,0.083
203775,1993,427,218,209,110,34,76,34.86,0.349,0.258,0.163
203845,1993,342,145,197,174,84,90,62.07,0.621,0.509,0.426
204024,1993,3264,1782,1482,1948,739,1209,67.85,0.678,0.597,0.499
204185,1993,396,194,202,197,89,108,55.67,0.557,0.497,0.441
204194,1993,335,201,134,108,35,73,36.32,0.363,0.322,0.261
204617,1993,225,123,102,61,16,45,36.59,0.366,0.271,0.157
204796,1993,5283,2710,2573,1074,371,703,25.94,0.259,0.203,0.144
204857,1993,3148,1782,1366,1297,433,864,48.48,0.485,0.412,0.317
206330,1993,200,61,139,33,15,18,29.51,0.295,0.165,0.108
206589,1993,548,291,257,346,139,207,71.13,0.711,0.631,0.541
206604,1993,2002,1045,957,190,73,117,11.2,0.112,0.095,0.076
206622,1993,696,381,315,368,170,198,51.97,0.52,0.529,0.54
206695,1993,1967,1005,962,180,78,102,10.15,0.102,0.092,0.081
206914,1993,626,350,276,54,26,28,8,0.08,0.086,0.094
207209,1993,479,253,226,28,10,18,7.11,0.071,0.058,0.044
207306,1993,228,119,109,33,12,21,17.65,0.176,0.145,0.11
207324,1993,291,157,134,56,31,25,15.92,0.159,0.192,0.231
207388,1993,2050,999,1051,377,130,247,24.72,0.247,0.184,0.124
207500,1993,2235,1072,1163,337,139,198,18.47,0.185,0.151,0.12
207722,1993,207,128,79,21,6,15,11.72,0.117,0.101,0.076
207847,1993,541,295,246,77,31,46,15.59,0.156,0.142,0.126
207865,1993,791,409,382,68,19,49,11.98,0.12,0.086,0.05
208822,1993,343,198,145,159,62,97,48.99,0.49,0.464,0.428
209056,1993,469,274,195,259,113,146,53.28,0.533,0.552,0.579
209065,1993,436,235,201,254,110,144,61.28,0.613,0.583,0.547
209542,1993,1625,705,920,395,169,226,32.06,0.321,0.243,0.184
209551,1993,2513,1422,1091,951,346,605,42.55,0.426,0.378,0.317
209612,1993,280,164,116,126,47,79,48.17,0.482,0.45,0.405
209807,1993,684,330,354,74,31,43,13.03,0.13,0.108,0.088
209922,1993,328,171,157,148,80,68,39.77,0.398,0.451,0.51
210146,1993,601,324,277,75,19,56,17.28,0.173,0.125,0.069
210401,1993,381,218,163,249,101,148,67.89,0.679,0.654,0.62
210429,1993,675,404,271,133,31,102,25.25,0.252,0.197,0.114
210571,1993,227,140,87,147,50,97,69.29,0.693,0.648,0.575
210669,1993,481,247,234,301,126,175,70.85,0.708,0.626,0.538
210775,1993,157,103,54,48,14,34,33.01,0.33,0.306,0.259
211088,1993,227,166,61,131,35,96,57.83,0.578,0.577,0.574
211158,1993,1017,615,402,379,115,264,42.93,0.429,0.373,0.286
211291,1993,854,454,400,717,324,393,86.56,0.866,0.84,0.81
211352,1993,224,158,66,115,29,86,54.43,0.544,0.513,0.439
211361,1993,951,401,550,145,55,90,22.44,0.224,0.152,0.1
211431,1993,169,158,11,80,3,77,48.73,0.487,0.473,0.273
211440,1993,1189,358,831,752,510,242,67.6,0.676,0.632,0.614
211468,1993,198,196,2,83,1,82,41.84,0.418,0.419,0.5
211556,1993,87,87,0,41,0,41,47.13,0.471,0.471,NA
211583,1993,132,132,0,73,0,73,55.3,0.553,0.553,NA
211608,1993,287,128,159,23,11,12,9.38,0.094,0.08,0.069
211644,1993,1081,650,431,246,70,176,27.08,0.271,0.228,0.162
211981,1993,435,212,223,142,65,77,36.32,0.363,0.326,0.291
212009,1993,482,277,205,330,124,206,74.37,0.744,0.685,0.605
212054,1993,1126,383,743,86,27,59,15.4,0.154,0.076,0.036
212106,1993,971,547,424,418,182,236,43.14,0.431,0.43,0.429
212115,1993,799,446,353,161,39,122,27.35,0.274,0.202,0.11
212133,1993,162,113,49,76,22,54,47.79,0.478,0.469,0.449
212160,1993,1315,763,552,221,65,156,20.45,0.204,0.168,0.118
212197,1993,424,276,148,270,76,194,70.29,0.703,0.637,0.514
212577,1993,507,229,278,364,190,174,75.98,0.76,0.718,0.683
212601,1993,450,257,193,177,79,98,38.13,0.381,0.393,0.409
212832,1993,86,74,12,32,2,30,40.54,0.405,0.372,0.167
212911,1993,292,143,149,243,122,121,84.62,0.846,0.832,0.819
213020,1993,2366,1365,1001,495,154,341,24.98,0.25,0.209,0.154
213251,1993,301,166,135,198,87,111,66.87,0.669,0.658,0.644
213321,1993,380,166,214,241,127,114,68.67,0.687,0.634,0.593
213349,1993,1309,771,538,236,57,179,23.22,0.232,0.18,0.106
213358,1993,181,85,96,61,31,30,35.29,0.353,0.337,0.323
213367,1993,597,327,270,321,125,196,59.94,0.599,0.538,0.463
213385,1993,570,252,318,443,226,217,86.11,0.861,0.777,0.711
213507,1993,314,170,144,191,77,114,67.06,0.671,0.608,0.535
213543,1993,1095,394,701,706,404,302,76.65,0.767,0.645,0.576
213613,1993,758,402,356,157,43,114,28.36,0.284,0.207,0.121
213668,1993,361,203,158,191,72,119,58.62,0.586,0.529,0.456
213783,1993,590,350,240,189,59,130,37.14,0.371,0.32,0.246
213826,1993,292,228,64,101,17,84,36.84,0.368,0.346,0.266
213996,1993,606,376,230,400,155,245,65.16,0.652,0.66,0.674
214041,1993,946,593,353,339,86,253,42.66,0.427,0.358,0.244
214069,1993,316,231,85,88,24,64,27.71,0.277,0.278,0.282
214157,1993,304,157,147,216,102,114,72.61,0.726,0.711,0.694
214175,1993,464,270,194,332,131,201,74.44,0.744,0.716,0.675
214272,1993,84,64,20,33,7,26,40.62,0.406,0.393,0.35
214777,1993,4265,2107,2158,1846,741,1105,52.44,0.524,0.433,0.343
215062,1993,2434,1086,1348,1923,1008,915,84.25,0.843,0.79,0.748
215743,1993,285,136,149,115,49,66,48.53,0.485,0.404,0.329
215798,1993,277,122,155,144,74,70,57.38,0.574,0.52,0.477
215929,1993,899,496,403,582,239,343,69.15,0.692,0.647,0.593
216010,1993,1114,603,511,443,162,281,46.6,0.466,0.398,0.317
216038,1993,1239,739,500,247,77,170,23,0.23,0.199,0.154
216287,1993,413,226,187,348,149,199,88.05,0.88,0.843,0.797
216339,1993,2186,1209,977,355,141,214,17.7,0.177,0.162,0.144
216524,1993,308,159,149,226,108,118,74.21,0.742,0.734,0.725
216694,1993,325,180,145,132,51,81,45,0.45,0.406,0.352
216764,1993,1386,876,510,346,74,272,31.05,0.31,0.25,0.145
216807,1993,375,216,159,250,93,157,72.69,0.727,0.667,0.585
216852,1993,473,215,258,182,79,103,47.91,0.479,0.385,0.306
216931,1993,434,198,236,177,85,92,46.46,0.465,0.408,0.36
217059,1993,691,397,294,274,102,172,43.32,0.433,0.397,0.347
217156,1993,1424,770,654,1109,494,615,79.87,0.799,0.779,0.755
217402,1993,968,503,465,775,368,407,80.91,0.809,0.801,0.791
217536,1993,345,235,110,181,57,124,52.77,0.528,0.525,0.518
217776,1993,90,48,42,23,8,15,31.25,0.312,0.256,0.19
217819,1993,1519,1004,515,485,123,362,36.06,0.361,0.319,0.239
217882,1993,2300,1053,1247,872,323,549,52.14,0.521,0.379,0.259
217998,1993,177,108,69,113,36,77,71.3,0.713,0.638,0.522
218061,1993,807,435,372,130,40,90,20.69,0.207,0.161,0.108
218229,1993,491,327,164,80,21,59,18.04,0.18,0.163,0.128
218238,1993,214,88,126,43,22,21,23.86,0.239,0.201,0.175
218399,1993,327,213,114,33,10,23,10.8,0.108,0.101,0.088
218414,1993,155,62,93,44,24,20,32.26,0.323,0.284,0.258
218663,1993,2298,1269,1029,681,246,435,34.28,0.343,0.296,0.239
218724,1993,732,379,353,86,26,60,15.83,0.158,0.117,0.074
218733,1993,613,329,284,80,20,60,18.24,0.182,0.131,0.07
218742,1993,327,216,111,46,6,40,18.52,0.185,0.141,0.054
218973,1993,273,109,164,210,117,93,85.32,0.853,0.769,0.713
219000,1993,306,208,98,128,25,103,49.52,0.495,0.418,0.255
219046,1993,1078,586,492,243,85,158,26.96,0.27,0.225,0.173
219082,1993,208,116,92,14,2,12,10.34,0.103,0.067,0.022
219198,1993,117,96,21,39,9,30,31.25,0.312,0.333,0.429
219259,1993,647,360,287,73,14,59,16.39,0.164,0.113,0.049
219356,1993,1670,831,839,320,128,192,23.1,0.231,0.192,0.153
219471,1993,1227,704,523,247,79,168,23.86,0.239,0.201,0.151
219602,1993,788,474,314,152,50,102,21.52,0.215,0.193,0.159
219709,1993,328,182,146,137,58,79,43.41,0.434,0.418,0.397
219718,1993,125,43,82,15,4,11,25.58,0.256,0.12,0.049
219949,1993,169,106,63,37,6,31,29.25,0.292,0.219,0.095
220075,1993,1289,757,532,128,51,77,10.17,0.102,0.099,0.096
220215,1993,296,169,127,83,31,52,30.77,0.308,0.28,0.244
220613,1993,395,205,190,87,37,50,24.39,0.244,0.22,0.195
220631,1993,217,134,83,59,23,36,26.87,0.269,0.272,0.277
220710,1993,175,73,102,56,28,28,38.36,0.384,0.32,0.275
221351,1993,385,215,170,284,124,160,74.42,0.744,0.738,0.729
221519,1993,322,157,165,250,131,119,75.8,0.758,0.776,0.794
221731,1993,90,28,62,8,2,6,21.43,0.214,0.089,0.032
221847,1993,1330,608,722,172,55,117,19.24,0.192,0.129,0.076
221892,1993,139,84,55,25,9,16,19.05,0.19,0.18,0.164
222178,1993,650,343,307,165,66,99,28.86,0.289,0.254,0.215
222983,1993,294,175,119,165,57,108,61.71,0.617,0.561,0.479
223232,1993,2426,1420,1006,978,350,628,44.23,0.442,0.403,0.348
224004,1993,107,62,45,26,7,19,30.65,0.306,0.243,0.156
224323,1993,246,138,108,118,56,62,44.93,0.449,0.48,0.519
225432,1993,666,362,304,8,2,6,1.66,0.017,0.012,0.007
225548,1993,322,133,189,56,31,25,18.8,0.188,0.174,0.164
225627,1993,297,202,95,29,8,21,10.4,0.104,0.098,0.084
226231,1993,202,33,169,46,36,10,30.3,0.303,0.228,0.213
226833,1993,553,284,269,49,23,26,9.15,0.092,0.089,0.086
227216,1993,1872,1045,827,211,63,148,14.16,0.142,0.113,0.076
227331,1993,291,224,67,29,0,29,12.95,0.13,0.1,0
227526,1993,1208,610,598,110,27,83,13.61,0.136,0.091,0.045
227757,1993,639,281,358,440,228,212,75.44,0.754,0.689,0.637
227845,1993,370,235,135,98,32,66,28.09,0.281,0.265,0.237
227863,1993,192,129,63,53,13,40,31.01,0.31,0.276,0.206
228042,1993,134,77,57,26,10,16,20.78,0.208,0.194,0.175
228149,1993,402,231,171,125,34,91,39.39,0.394,0.311,0.199
228246,1993,1161,630,531,657,265,392,62.22,0.622,0.566,0.499
228343,1993,351,207,144,218,79,139,67.15,0.672,0.621,0.549
228431,1993,2247,1255,992,308,81,227,18.09,0.181,0.137,0.082
228459,1993,2281,1358,923,248,62,186,13.7,0.137,0.109,0.067
228501,1993,317,107,210,23,9,14,13.08,0.131,0.073,0.043
228529,1993,923,432,491,82,24,58,13.43,0.134,0.089,0.049
228705,1993,1012,481,531,50,19,31,6.44,0.064,0.049,0.036
228723,1993,6341,3083,3258,1631,524,1107,35.91,0.359,0.257,0.161
228769,1993,1314,638,676,81,34,47,7.37,0.074,0.062,0.05
228778,1993,5872,2810,3062,1776,741,1035,36.83,0.368,0.302,0.242
228787,1993,414,156,258,125,76,49,31.41,0.314,0.302,0.295
228796,1993,1948,1023,925,59,22,37,3.62,0.036,0.03,0.024
228875,1993,1189,690,499,467,162,305,44.2,0.442,0.393,0.325
228981,1993,213,134,79,65,24,41,30.6,0.306,0.305,0.304
229018,1993,78,41,37,8,3,5,12.2,0.122,0.103,0.081
229027,1993,1591,855,736,84,43,41,4.8,0.048,0.053,0.058
229115,1993,3073,1525,1548,520,196,324,21.25,0.212,0.169,0.127
229780,1993,166,106,60,26,10,16,15.09,0.151,0.157,0.167
229814,1993,986,472,514,93,25,68,14.41,0.144,0.094,0.049
230603,1993,588,416,172,83,11,72,17.31,0.173,0.141,0.064
230728,1993,1321,850,471,212,42,170,20,0.2,0.16,0.089
230764,1993,1794,1004,790,202,59,143,14.24,0.142,0.113,0.075
230782,1993,1219,829,390,81,23,58,7,0.07,0.066,0.059
231059,1993,454,238,216,291,128,163,68.49,0.685,0.641,0.593
231174,1993,1706,955,751,828,319,509,53.3,0.533,0.485,0.425
231420,1993,168,101,67,56,17,39,38.61,0.386,0.333,0.254
231554,1993,210,119,91,88,36,52,43.7,0.437,0.419,0.396
231624,1993,1201,690,511,913,360,553,80.14,0.801,0.76,0.705
231712,1993,428,266,162,29,7,22,8.27,0.083,0.068,0.043
232025,1993,230,120,110,91,30,61,50.83,0.508,0.396,0.273
232043,1993,229,130,99,108,42,66,50.77,0.508,0.472,0.424
232089,1993,332,131,201,68,29,39,29.77,0.298,0.205,0.144
232186,1993,1670,934,736,442,140,302,32.33,0.323,0.265,0.19
232265,1993,1427,879,548,410,85,325,36.97,0.37,0.287,0.155
232423,1993,2079,1170,909,1239,453,786,67.18,0.672,0.596,0.498
232557,1993,1407,691,716,204,81,123,17.8,0.178,0.145,0.113
232566,1993,724,509,215,275,40,235,46.17,0.462,0.38,0.186
232609,1993,361,221,140,120,36,84,38.01,0.38,0.332,0.257
232681,1993,750,477,273,486,161,325,68.13,0.681,0.648,0.59
232706,1993,175,130,45,66,10,56,43.08,0.431,0.377,0.222
232937,1993,1324,759,565,70,24,46,6.06,0.061,0.053,0.042
232982,1993,1173,580,593,137,39,98,16.9,0.169,0.117,0.066
233277,1993,1736,1088,648,460,128,332,30.51,0.305,0.265,0.198
233374,1993,728,383,345,559,251,308,80.42,0.804,0.768,0.728
233426,1993,438,275,163,242,67,175,63.64,0.636,0.553,0.411
233541,1993,185,88,97,47,17,30,34.09,0.341,0.254,0.175
233897,1993,253,110,143,53,22,31,28.18,0.282,0.209,0.154
233921,1993,4270,1776,2494,1459,620,839,47.24,0.472,0.342,0.249
234030,1993,1466,874,592,281,80,201,23,0.23,0.192,0.135
234085,1993,278,0,278,131,131,0,NA,NA,0.471,0.471
234155,1993,695,409,286,88,33,55,13.45,0.134,0.127,0.115
234164,1993,435,240,195,49,15,34,14.17,0.142,0.113,0.077
235097,1993,725,424,301,131,45,86,20.28,0.203,0.181,0.15
235167,1993,435,253,182,158,63,95,37.55,0.376,0.363,0.346
236230,1993,499,269,230,228,90,138,51.3,0.513,0.457,0.391
236328,1993,687,402,285,402,159,243,60.45,0.605,0.585,0.558
236577,1993,395,263,132,117,42,75,28.52,0.285,0.296,0.318
236595,1993,489,276,213,165,61,104,37.68,0.377,0.337,0.286
236896,1993,263,138,125,70,29,41,29.71,0.297,0.266,0.232
236939,1993,2431,1234,1197,644,235,409,33.14,0.331,0.265,0.196
236948,1993,3206,1576,1630,1217,515,702,44.54,0.445,0.38,0.316
237011,1993,1542,941,601,365,91,274,29.12,0.291,0.237,0.151
237057,1993,341,196,145,249,102,147,75,0.75,0.73,0.703
237066,1993,361,206,155,160,59,101,49.03,0.49,0.443,0.381
237215,1993,358,215,143,10,5,5,2.33,0.023,0.028,0.035
237330,1993,487,284,203,71,25,46,16.2,0.162,0.146,0.123
237358,1993,167,100,67,24,10,14,14,0.14,0.144,0.149
237367,1993,1053,553,500,93,29,64,11.57,0.116,0.088,0.058
237792,1993,557,310,247,59,17,42,13.55,0.136,0.106,0.069
237899,1993,634,308,326,21,8,13,4.22,0.042,0.033,0.025
237932,1993,474,238,236,85,32,53,22.27,0.223,0.179,0.136
237969,1993,475,235,240,172,64,108,45.96,0.46,0.362,0.267
238032,1993,2806,1370,1436,658,252,406,29.64,0.296,0.234,0.175
238333,1993,284,161,123,158,61,97,60.25,0.603,0.556,0.496
238430,1993,481,327,154,39,12,27,8.26,0.083,0.081,0.078
238458,1993,345,211,134,130,45,85,40.28,0.403,0.377,0.336
238476,1993,441,227,214,216,99,117,51.54,0.515,0.49,0.463
238616,1993,289,139,150,81,37,44,31.65,0.316,0.28,0.247
238661,1993,161,121,40,42,7,35,28.93,0.289,0.261,0.175
239080,1993,170,115,55,47,12,35,30.43,0.304,0.276,0.218
239105,1993,1684,895,789,880,339,541,60.45,0.605,0.523,0.43
239628,1993,211,102,109,113,47,66,64.71,0.647,0.536,0.431
239716,1993,569,320,249,352,142,210,65.62,0.656,0.619,0.57
240107,1993,270,205,65,67,14,53,25.85,0.258,0.248,0.215
240189,1993,1823,1019,804,251,78,173,16.98,0.17,0.138,0.097
240277,1993,703,438,265,96,29,67,15.3,0.153,0.137,0.109
240329,1993,1695,1008,687,243,83,160,15.87,0.159,0.143,0.121
240338,1993,80,55,25,31,10,21,38.18,0.382,0.388,0.4
240365,1993,1465,833,632,200,53,147,17.65,0.176,0.137,0.084
240374,1993,668,355,313,51,17,34,9.58,0.096,0.076,0.054
240417,1993,1023,488,535,143,36,107,21.93,0.219,0.14,0.067
240426,1993,323,182,141,41,14,27,14.84,0.148,0.127,0.099
240444,1993,4585,2396,2189,1686,659,1027,42.86,0.429,0.368,0.301
240453,1993,1712,849,863,117,51,66,7.77,0.078,0.068,0.059
240462,1993,917,276,641,109,51,58,21.01,0.21,0.119,0.08
240471,1993,838,443,395,162,64,98,22.12,0.221,0.193,0.162
240480,1993,1359,702,657,201,72,129,18.38,0.184,0.148,0.11
240727,1993,1212,560,652,207,79,128,22.86,0.229,0.171,0.121
243443,1993,796,541,255,44,8,36,6.65,0.066,0.055,0.031
243780,1993,5725,2560,3165,1625,773,852,33.28,0.333,0.284,0.244
100654,1995,849,434,415,185,47,138,31.8,0.318,0.218,0.113
100663,1995,1052,599,453,128,37,91,15.19,0.152,0.122,0.082
100751,1995,2493,1387,1106,748,246,502,36.19,0.362,0.3,0.222
100858,1995,3486,1832,1654,1106,345,761,41.54,0.415,0.317,0.209
101435,1995,160,106,54,56,17,39,36.79,0.368,0.35,0.315
101480,1995,798,435,363,136,36,100,22.99,0.23,0.17,0.099
101675,1995,229,114,115,120,50,70,61.4,0.614,0.524,0.435
101879,1995,762,444,318,167,44,123,27.7,0.277,0.219,0.138
102049,1995,647,399,248,331,118,213,53.38,0.534,0.512,0.476
102094,1995,1192,674,518,167,54,113,16.77,0.168,0.14,0.104
102234,1995,232,141,91,113,34,79,56.03,0.56,0.487,0.374
102368,1995,877,477,400,354,120,234,49.06,0.491,0.404,0.3
102377,1995,645,383,262,139,35,104,27.15,0.272,0.216,0.134
104151,1995,3945,2096,1849,854,299,555,26.48,0.265,0.216,0.162
104179,1995,4370,2382,1988,1160,405,755,31.7,0.317,0.265,0.204
105330,1995,2015,1120,895,436,133,303,27.05,0.27,0.216,0.149
106245,1995,675,390,285,103,37,66,16.92,0.169,0.153,0.13
106342,1995,168,90,78,82,32,50,55.56,0.556,0.488,0.41
106397,1995,2249,1148,1101,425,155,270,23.52,0.235,0.189,0.141
106412,1995,565,302,263,39,11,28,9.27,0.093,0.069,0.042
106458,1995,1448,803,645,218,65,153,19.05,0.19,0.151,0.101
106467,1995,756,386,370,133,46,87,22.54,0.225,0.176,0.124
106485,1995,489,254,235,46,14,32,12.6,0.126,0.094,0.06
106704,1995,1469,920,549,207,46,161,17.5,0.175,0.141,0.084
107044,1995,779,437,342,250,92,158,36.16,0.362,0.321,0.269
107080,1995,273,166,107,148,58,90,54.22,0.542,0.542,0.542
107141,1995,224,115,109,71,28,43,37.39,0.374,0.317,0.257
107512,1995,380,206,174,173,75,98,47.57,0.476,0.455,0.431
107558,1995,133,66,67,29,14,15,22.73,0.227,0.218,0.209
110097,1995,407,278,129,168,45,123,44.24,0.442,0.413,0.349
110404,1995,218,52,166,156,108,48,92.31,0.923,0.716,0.651
110422,1995,2418,1092,1326,356,114,242,22.16,0.222,0.147,0.086
110486,1995,397,236,161,43,11,32,13.56,0.136,0.108,0.068
110495,1995,353,242,111,75,12,63,26.03,0.26,0.212,0.108
110510,1995,799,505,294,58,16,42,8.32,0.083,0.073,0.054
110529,1995,1422,621,801,96,37,59,9.5,0.095,0.068,0.046
110538,1995,1401,832,569,161,22,139,16.71,0.167,0.115,0.039
110547,1995,467,335,132,19,4,15,4.48,0.045,0.041,0.03
110556,1995,1571,915,656,176,44,132,14.43,0.144,0.112,0.067
110565,1995,1832,1036,796,148,41,107,10.33,0.103,0.081,0.052
110574,1995,542,331,211,55,22,33,9.97,0.1,0.101,0.104
110583,1995,2057,1307,750,88,26,62,4.74,0.047,0.043,0.035
110592,1995,1243,766,477,49,12,37,4.83,0.048,0.039,0.025
110617,1995,1219,735,484,96,24,72,9.8,0.098,0.079,0.05
113698,1995,69,51,18,27,5,22,43.14,0.431,0.391,0.278
115755,1995,908,503,405,69,18,51,10.14,0.101,0.076,0.044
119173,1995,222,220,2,50,2,48,21.82,0.218,0.225,1
120184,1995,115,79,36,44,9,35,44.3,0.443,0.383,0.25
121309,1995,475,313,162,185,57,128,40.89,0.409,0.389,0.352
121345,1995,392,190,202,336,166,170,89.47,0.895,0.857,0.822
122409,1995,2840,1716,1124,212,58,154,8.97,0.09,0.075,0.052
122436,1995,978,597,381,500,186,314,52.6,0.526,0.511,0.488
122597,1995,1539,966,573,89,26,63,6.52,0.065,0.058,0.045
122612,1995,550,350,200,237,71,166,47.43,0.474,0.431,0.355
122931,1995,1043,558,485,757,329,428,76.7,0.767,0.726,0.678
123554,1995,474,256,218,306,141,165,64.45,0.645,0.646,0.647
123572,1995,681,441,240,131,41,90,20.41,0.204,0.192,0.171
126562,1995,266,166,100,41,14,27,16.27,0.163,0.154,0.14
126580,1995,363,197,166,88,36,52,26.4,0.264,0.242,0.217
126614,1995,4170,2020,2150,1454,602,852,42.18,0.422,0.349,0.28
126818,1995,2546,1354,1192,805,287,518,38.26,0.383,0.316,0.241
127060,1995,654,330,324,376,175,201,60.91,0.609,0.575,0.54
127185,1995,1010,434,576,96,26,70,16.13,0.161,0.095,0.045
127565,1995,1239,691,548,48,19,29,4.2,0.042,0.039,0.035
127741,1995,1763,1091,672,404,90,314,28.78,0.288,0.229,0.134
128106,1995,590,299,291,69,31,38,12.71,0.127,0.117,0.107
128744,1995,123,73,50,38,14,24,32.88,0.329,0.309,0.28
128771,1995,1076,566,510,68,28,40,7.07,0.071,0.063,0.055
129020,1995,2010,1051,959,855,341,514,48.91,0.489,0.425,0.356
129242,1995,784,450,334,602,248,354,78.67,0.787,0.768,0.743
129941,1995,352,115,237,110,74,36,31.3,0.313,0.312,0.312
130253,1995,639,357,282,269,107,162,45.38,0.454,0.421,0.379
130314,1995,153,152,1,82,0,82,53.95,0.54,0.536,0
130493,1995,917,526,391,121,36,85,16.16,0.162,0.132,0.092
130590,1995,507,246,261,388,174,214,86.99,0.87,0.765,0.667
130697,1995,710,356,354,584,288,296,83.15,0.832,0.823,0.814
130776,1995,460,237,223,79,35,44,18.57,0.186,0.172,0.157
130794,1995,1360,692,668,1198,575,623,90.03,0.9,0.881,0.861
130934,1995,563,333,230,76,27,49,14.71,0.147,0.135,0.117
130943,1995,3155,1883,1272,1719,621,1098,58.31,0.583,0.545,0.488
131159,1995,1221,794,427,789,288,501,63.1,0.631,0.646,0.674
131283,1995,514,265,249,290,125,165,62.26,0.623,0.564,0.502
131450,1995,225,120,105,10,2,8,6.67,0.067,0.044,0.019
131469,1995,1367,803,564,905,346,559,69.61,0.696,0.662,0.613
131496,1995,1403,742,661,1207,568,639,86.12,0.861,0.86,0.859
131520,1995,834,540,294,438,117,321,59.44,0.594,0.525,0.398
132471,1995,177,103,74,46,10,36,34.95,0.35,0.26,0.135
132602,1995,729,393,336,106,31,75,19.08,0.191,0.145,0.092
132903,1995,2411,1295,1116,661,217,444,34.29,0.343,0.274,0.194
133492,1995,334,184,150,199,83,116,63.04,0.63,0.596,0.553
133553,1995,665,100,565,128,105,23,23,0.23,0.192,0.186
133650,1995,1574,952,622,245,63,182,19.12,0.191,0.156,0.101
133669,1995,901,504,397,162,51,111,22.02,0.22,0.18,0.128
133711,1995,355,217,138,143,45,98,45.16,0.452,0.403,0.326
133881,1995,370,111,259,113,70,43,38.74,0.387,0.305,0.27
133951,1995,1752,1003,749,270,74,196,19.54,0.195,0.154,0.099
134079,1995,527,302,225,230,76,154,50.99,0.51,0.436,0.338
134097,1995,3826,2210,1616,1534,530,1004,45.43,0.454,0.401,0.328
134130,1995,5655,3023,2632,2443,903,1540,50.94,0.509,0.432,0.343
134945,1995,356,197,159,129,51,78,39.59,0.396,0.362,0.321
135726,1995,1684,913,771,832,348,484,53.01,0.53,0.494,0.451
136172,1995,762,463,299,145,26,119,25.7,0.257,0.19,0.087
136950,1995,412,248,164,250,88,162,65.32,0.653,0.607,0.537
137546,1995,464,253,211,228,89,139,54.94,0.549,0.491,0.422
138354,1995,509,279,230,101,30,71,25.45,0.254,0.198,0.13
138716,1995,530,291,239,37,10,27,9.28,0.093,0.07,0.042
138789,1995,773,497,276,50,13,37,7.44,0.074,0.065,0.047
139144,1995,522,316,206,184,68,116,36.71,0.367,0.352,0.33
139366,1995,633,390,243,54,17,37,9.49,0.095,0.085,0.07
139393,1995,155,90,65,75,33,42,46.67,0.467,0.484,0.508
139658,1995,1587,896,691,1093,441,652,72.77,0.728,0.689,0.638
139719,1995,522,261,261,38,8,30,11.49,0.115,0.073,0.031
139755,1995,2120,600,1520,451,271,180,30,0.3,0.213,0.178
139764,1995,328,211,117,26,3,23,10.9,0.109,0.079,0.026
139861,1995,754,467,287,123,28,95,20.34,0.203,0.163,0.098
139931,1995,3193,1825,1368,407,112,295,16.16,0.162,0.127,0.082
139940,1995,1276,750,526,127,51,76,10.13,0.101,0.1,0.097
139959,1995,3996,2376,1620,1702,570,1132,47.64,0.476,0.426,0.352
140447,1995,630,381,249,199,65,134,35.17,0.352,0.316,0.261
140960,1995,676,358,318,25,2,23,6.42,0.064,0.037,0.006
140988,1995,167,118,49,76,24,52,44.07,0.441,0.455,0.49
141185,1995,210,124,86,8,2,6,4.84,0.048,0.038,0.023
141264,1995,1665,985,680,247,71,176,17.87,0.179,0.148,0.104
141334,1995,1430,841,589,128,32,96,11.41,0.114,0.09,0.054
141486,1995,123,72,51,31,12,19,26.39,0.264,0.252,0.235
141565,1995,359,216,143,32,5,27,12.5,0.125,0.089,0.035
141574,1995,1671,967,704,184,57,127,13.13,0.131,0.11,0.081
142276,1995,1363,783,580,37,6,31,3.96,0.04,0.027,0.01
142285,1995,1242,602,640,225,78,147,24.42,0.244,0.181,0.122
142461,1995,320,183,137,86,27,59,32.24,0.322,0.269,0.197
143084,1995,605,352,253,394,151,243,69.03,0.69,0.651,0.597
143288,1995,157,66,91,37,17,20,30.3,0.303,0.236,0.187
144005,1995,613,410,203,35,3,32,7.8,0.078,0.057,0.015
144281,1995,939,464,475,131,67,64,13.79,0.138,0.14,0.141
144740,1995,1225,700,525,447,177,270,38.57,0.386,0.365,0.337
144892,1995,1538,973,565,468,117,351,36.07,0.361,0.304,0.207
144962,1995,253,147,106,128,41,87,59.18,0.592,0.506,0.387
144971,1995,139,58,81,68,35,33,56.9,0.569,0.489,0.432
145600,1995,2469,1401,1068,309,110,199,14.2,0.142,0.125,0.103
145619,1995,245,123,122,95,38,57,46.34,0.463,0.388,0.311
145637,1995,6101,2944,3157,3312,1492,1820,61.82,0.618,0.543,0.473
145691,1995,223,139,84,98,30,68,48.92,0.489,0.439,0.357
145813,1995,2950,1798,1152,823,240,583,32.42,0.324,0.279,0.208
146481,1995,266,155,111,156,58,98,63.23,0.632,0.586,0.523
146612,1995,331,158,173,104,49,55,34.81,0.348,0.314,0.283
146719,1995,1182,733,449,544,167,377,51.43,0.514,0.46,0.372
146825,1995,175,75,100,50,12,38,50.67,0.507,0.286,0.12
147013,1995,188,109,79,54,16,38,34.86,0.349,0.287,0.203
147244,1995,494,272,222,248,98,150,55.15,0.551,0.502,0.441
147341,1995,308,187,121,156,54,102,54.55,0.545,0.506,0.446
147703,1995,2429,1368,1061,582,200,382,27.92,0.279,0.24,0.189
147767,1995,1948,1066,882,1595,672,923,86.59,0.866,0.819,0.762
147776,1995,812,488,324,20,7,13,2.66,0.027,0.025,0.022
147828,1995,389,217,172,150,60,90,41.47,0.415,0.386,0.349
148131,1995,259,126,133,89,30,59,46.83,0.468,0.344,0.226
148496,1995,124,95,29,67,13,54,56.84,0.568,0.54,0.448
148584,1995,165,82,83,67,30,37,45.12,0.451,0.406,0.361
148627,1995,226,139,87,67,19,48,34.53,0.345,0.296,0.218
149222,1995,2277,1006,1271,371,162,209,20.78,0.208,0.163,0.127
149231,1995,1085,644,441,154,40,114,17.7,0.177,0.142,0.091
149772,1995,1538,757,781,392,168,224,29.59,0.296,0.255,0.215
149781,1995,546,281,265,425,198,227,80.78,0.808,0.778,0.747
150066,1995,498,298,200,169,59,110,36.91,0.369,0.339,0.295
150136,1995,3855,2068,1787,787,262,525,25.39,0.254,0.204,0.147
150145,1995,184,118,66,63,18,45,38.14,0.381,0.342,0.273
150163,1995,847,510,337,409,145,264,51.76,0.518,0.483,0.43
150400,1995,580,328,252,434,187,247,75.3,0.753,0.748,0.742
150534,1995,826,504,322,370,131,239,47.42,0.474,0.448,0.407
150668,1995,213,111,102,104,40,64,57.66,0.577,0.488,0.392
150941,1995,191,113,78,87,27,60,53.1,0.531,0.455,0.346
151102,1995,1063,577,486,43,14,29,5.03,0.05,0.04,0.029
151111,1995,1860,1024,836,148,65,83,8.11,0.081,0.08,0.078
151306,1995,1407,813,594,138,30,108,13.28,0.133,0.098,0.051
151324,1995,1980,1032,948,350,132,218,21.12,0.211,0.177,0.139
151333,1995,294,184,110,27,7,20,10.87,0.109,0.092,0.064
151342,1995,626,374,252,51,19,32,8.56,0.086,0.081,0.075
151351,1995,5705,3293,2412,3057,1182,1875,56.94,0.569,0.536,0.49
151360,1995,599,383,216,42,13,29,7.57,0.076,0.07,0.06
151379,1995,593,357,236,74,27,47,13.17,0.132,0.125,0.114
151388,1995,242,144,98,12,5,7,4.86,0.049,0.05,0.051
151777,1995,321,158,163,136,61,75,47.47,0.475,0.424,0.374
151786,1995,255,168,87,90,28,62,36.9,0.369,0.353,0.322
152080,1995,1902,870,1032,1667,887,780,89.66,0.897,0.876,0.859
152248,1995,906,487,419,71,21,50,10.27,0.103,0.078,0.05
152363,1995,237,106,131,99,52,47,44.34,0.443,0.418,0.397
152530,1995,419,224,195,270,112,158,70.54,0.705,0.644,0.574
152600,1995,673,370,303,405,141,264,71.35,0.713,0.602,0.465
153001,1995,352,167,185,168,71,97,58.08,0.581,0.477,0.384
153108,1995,410,249,161,247,92,155,62.25,0.623,0.602,0.571
153269,1995,734,435,299,365,144,221,50.8,0.508,0.497,0.482
153384,1995,307,168,139,238,106,132,78.57,0.786,0.775,0.763
153603,1995,3274,1490,1784,822,341,481,32.28,0.323,0.251,0.191
153834,1995,590,372,218,375,122,253,68.01,0.68,0.636,0.56
154095,1995,2007,1244,763,604,170,434,34.89,0.349,0.301,0.223
155089,1995,200,109,91,43,19,24,22.02,0.22,0.215,0.209
155317,1995,3474,1857,1617,905,351,554,29.83,0.298,0.261,0.217
155335,1995,118,74,44,23,6,17,22.97,0.23,0.195,0.136
155399,1995,2877,1380,1497,558,219,339,24.57,0.246,0.194,0.146
155520,1995,246,124,122,62,17,45,36.29,0.363,0.252,0.139
155627,1995,137,44,93,21,9,12,27.27,0.273,0.153,0.097
155937,1995,120,63,57,42,12,30,47.62,0.476,0.35,0.211
156213,1995,298,180,118,140,65,75,41.67,0.417,0.47,0.551
156286,1995,329,189,140,151,49,102,53.97,0.54,0.459,0.35
156295,1995,416,220,196,146,64,82,37.27,0.373,0.351,0.327
156365,1995,322,156,166,84,34,50,32.05,0.32,0.261,0.205
156541,1995,377,204,173,107,33,74,36.27,0.363,0.284,0.191
156745,1995,304,201,103,134,30,104,51.74,0.517,0.441,0.291
157058,1995,370,189,181,13,10,3,1.59,0.016,0.035,0.055
157076,1995,151,79,72,49,17,32,40.51,0.405,0.325,0.236
157085,1995,2612,1383,1229,620,235,385,27.84,0.278,0.237,0.191
157289,1995,1835,903,932,193,69,124,13.73,0.137,0.105,0.074
157386,1995,1119,646,473,104,7,97,15.02,0.15,0.093,0.015
157401,1995,1201,661,540,262,82,180,27.23,0.272,0.218,0.152
157447,1995,1545,873,672,79,22,57,6.53,0.065,0.051,0.033
157535,1995,227,154,73,34,8,26,16.88,0.169,0.15,0.11
157951,1995,2454,1364,1090,496,159,337,24.71,0.247,0.202,0.146
158477,1995,213,134,79,91,26,65,48.51,0.485,0.427,0.329
159009,1995,1121,569,552,107,23,84,14.76,0.148,0.095,0.042
159391,1995,3646,2007,1639,746,257,489,24.36,0.244,0.205,0.157
159647,1995,1278,598,680,281,103,178,29.77,0.298,0.22,0.151
159717,1995,1376,775,601,71,22,49,6.32,0.063,0.052,0.037
159966,1995,1170,672,498,76,19,57,8.48,0.085,0.065,0.038
160038,1995,1556,947,609,165,41,124,13.09,0.131,0.106,0.067
160612,1995,2367,1387,980,94,21,73,5.26,0.053,0.04,0.021
160621,1995,1846,991,855,101,21,80,8.07,0.081,0.055,0.025
160658,1995,2609,1453,1156,110,24,86,5.92,0.059,0.042,0.021
161004,1995,446,225,221,369,180,189,84,0.84,0.827,0.814
161226,1995,473,335,138,153,35,118,35.22,0.352,0.323,0.254
161235,1995,74,34,40,6,2,4,11.76,0.118,0.081,0.05
161244,1995,129,73,56,10,5,5,6.85,0.068,0.078,0.089
161253,1995,1118,526,592,322,148,174,33.08,0.331,0.288,0.25
161554,1995,620,358,262,66,23,43,12.01,0.12,0.106,0.088
162007,1995,435,260,175,62,11,51,19.62,0.196,0.143,0.063
162210,1995,137,84,53,24,9,15,17.86,0.179,0.175,0.17
162283,1995,439,303,136,31,8,23,7.59,0.076,0.071,0.059
162584,1995,909,433,476,194,68,126,29.1,0.291,0.213,0.143
162654,1995,277,193,84,154,41,113,58.55,0.586,0.556,0.488
162760,1995,177,172,5,103,2,101,58.72,0.587,0.582,0.4
162928,1995,873,332,541,683,401,282,84.94,0.849,0.782,0.741
163046,1995,798,450,348,581,240,341,75.78,0.758,0.728,0.69
163268,1995,968,485,483,295,115,180,37.11,0.371,0.305,0.238
163286,1995,3577,1722,1855,1343,539,804,46.69,0.467,0.375,0.291
163453,1995,959,580,379,166,30,136,23.45,0.234,0.173,0.079
163462,1995,315,169,146,205,95,110,65.09,0.651,0.651,0.651
163851,1995,642,412,230,322,101,221,53.64,0.536,0.502,0.439
163912,1995,352,201,151,207,81,126,62.69,0.627,0.588,0.536
164076,1995,1488,934,554,468,121,347,37.15,0.372,0.315,0.218
164173,1995,253,180,73,94,26,68,37.78,0.378,0.372,0.356
164216,1995,241,134,107,144,60,84,62.69,0.627,0.598,0.561
164270,1995,316,163,153,206,80,126,77.3,0.773,0.652,0.523
164447,1995,260,104,156,84,37,47,45.19,0.452,0.323,0.237
164492,1995,69,43,26,28,7,21,48.84,0.488,0.406,0.269
164562,1995,446,262,184,295,119,176,67.18,0.672,0.661,0.647
165015,1995,874,483,391,702,306,396,81.99,0.82,0.803,0.783
165024,1995,1087,620,467,211,57,154,24.84,0.248,0.194,0.122
165334,1995,505,318,187,311,103,208,65.41,0.654,0.616,0.551
165662,1995,526,313,213,310,121,189,60.38,0.604,0.589,0.568
165671,1995,100,100,0,43,0,43,43,0.43,0.43,NA
165820,1995,574,329,245,106,20,86,26.14,0.261,0.185,0.082
165866,1995,600,404,196,122,28,94,23.27,0.233,0.203,0.143
165936,1995,330,226,104,152,43,109,48.23,0.482,0.461,0.413
166027,1995,1606,738,868,1343,705,638,86.45,0.865,0.836,0.812
166124,1995,710,384,326,618,287,331,86.2,0.862,0.87,0.88
166513,1995,1102,422,680,195,90,105,24.88,0.249,0.177,0.132
166629,1995,3959,1946,2013,1429,583,846,43.47,0.435,0.361,0.29
166638,1995,502,222,280,38,17,21,9.46,0.095,0.076,0.061
166683,1995,1115,468,647,921,517,404,86.32,0.863,0.826,0.799
167288,1995,290,171,119,80,15,65,38.01,0.38,0.276,0.126
167987,1995,886,420,466,253,90,163,38.81,0.388,0.286,0.193
167996,1995,547,328,219,443,166,277,84.45,0.845,0.81,0.758
168005,1995,386,214,172,110,39,71,33.18,0.332,0.285,0.227
168148,1995,1147,594,553,944,439,505,85.02,0.85,0.823,0.794
168254,1995,580,222,358,223,116,107,48.2,0.482,0.384,0.324
168281,1995,359,249,110,241,72,169,67.87,0.679,0.671,0.655
168342,1995,524,243,281,453,237,216,88.89,0.889,0.865,0.843
168546,1995,473,238,235,334,150,184,77.31,0.773,0.706,0.638
168786,1995,241,139,102,69,28,41,29.5,0.295,0.286,0.275
169080,1995,1013,571,442,506,215,291,50.96,0.51,0.5,0.486
169798,1995,2172,1230,942,198,65,133,10.81,0.108,0.091,0.069
169910,1995,1893,752,1141,55,28,27,3.59,0.036,0.029,0.025
170082,1995,1773,1087,686,287,95,192,17.66,0.177,0.162,0.138
170301,1995,709,418,291,412,143,269,64.35,0.643,0.581,0.491
170532,1995,350,197,153,221,90,131,66.5,0.665,0.631,0.588
170639,1995,593,281,312,80,39,41,14.59,0.146,0.135,0.125
170976,1995,5265,2658,2607,3223,1428,1795,67.53,0.675,0.612,0.548
171100,1995,6396,3546,2850,2076,693,1383,39,0.39,0.325,0.243
171128,1995,1072,285,787,218,134,84,29.47,0.295,0.203,0.17
171137,1995,600,320,280,49,23,26,8.12,0.081,0.082,0.082
171146,1995,263,169,94,116,45,71,42.01,0.42,0.441,0.479
171599,1995,209,69,140,28,20,8,11.59,0.116,0.134,0.143
172051,1995,752,412,340,40,14,26,6.31,0.063,0.053,0.041
172699,1995,3165,1851,1314,524,148,376,20.31,0.203,0.166,0.113
173160,1995,475,303,172,282,90,192,63.37,0.634,0.594,0.523
173258,1995,463,232,231,393,191,202,87.07,0.871,0.849,0.827
173328,1995,153,91,62,42,13,29,31.87,0.319,0.275,0.21
173647,1995,690,380,310,478,196,282,74.21,0.742,0.693,0.632
173902,1995,437,231,206,322,143,179,77.49,0.775,0.737,0.694
174066,1995,4128,2100,2028,984,418,566,26.95,0.27,0.238,0.206
174233,1995,1462,688,774,361,146,215,31.25,0.312,0.247,0.189
174251,1995,503,297,206,202,66,136,45.79,0.458,0.402,0.32
174491,1995,378,245,133,155,43,112,45.71,0.457,0.41,0.323
174792,1995,430,0,430,286,286,0,NA,NA,0.665,0.665
174844,1995,742,431,311,557,223,334,77.49,0.775,0.751,0.717
174899,1995,270,201,69,142,30,112,55.72,0.557,0.526,0.435
174914,1995,852,454,398,430,181,249,54.85,0.548,0.505,0.455
175342,1995,746,410,336,148,38,110,26.83,0.268,0.198,0.113
175421,1995,112,67,45,39,13,26,38.81,0.388,0.348,0.289
175616,1995,464,301,163,102,25,77,25.58,0.256,0.22,0.153
175856,1995,1212,679,533,162,39,123,18.11,0.181,0.134,0.073
175980,1995,261,128,133,180,74,106,82.81,0.828,0.69,0.556
176017,1995,1526,825,701,490,180,310,37.58,0.376,0.321,0.257
176035,1995,288,238,50,59,7,52,21.85,0.219,0.205,0.14
176044,1995,448,244,204,87,23,64,26.23,0.262,0.194,0.113
176080,1995,1826,845,981,382,158,224,26.51,0.265,0.209,0.161
176406,1995,218,141,77,65,19,46,32.62,0.326,0.298,0.247
176628,1995,101,61,40,31,11,20,32.79,0.328,0.307,0.275
176947,1995,229,95,134,73,36,37,38.95,0.39,0.319,0.269
176965,1995,1428,755,673,243,79,164,21.72,0.217,0.17,0.117
177418,1995,143,110,33,51,11,40,36.36,0.364,0.357,0.333
178059,1995,167,123,44,77,16,61,49.59,0.496,0.461,0.364
178341,1995,720,359,361,77,37,40,11.14,0.111,0.107,0.102
178387,1995,923,530,393,92,24,68,12.83,0.128,0.1,0.061
178396,1995,3782,2099,1683,1210,420,790,37.64,0.376,0.32,0.25
178402,1995,568,318,250,70,25,45,14.15,0.142,0.123,0.1
178411,1995,804,190,614,121,75,46,24.21,0.242,0.15,0.122
178420,1995,552,315,237,85,31,54,17.14,0.171,0.154,0.131
178615,1995,1498,883,615,577,183,394,44.62,0.446,0.385,0.298
179043,1995,288,161,127,174,74,100,62.11,0.621,0.604,0.583
179159,1995,1055,604,451,501,195,306,50.66,0.507,0.475,0.432
179557,1995,1385,824,561,334,90,244,29.61,0.296,0.241,0.16
179566,1995,2479,1394,1085,440,156,284,20.37,0.204,0.177,0.144
179867,1995,1180,608,572,911,411,500,82.24,0.822,0.772,0.719
179894,1995,227,105,122,90,52,38,36.19,0.362,0.396,0.426
179946,1995,190,88,102,91,47,44,50,0.5,0.479,0.461
180179,1995,384,255,129,12,2,10,3.92,0.039,0.031,0.016
180461,1995,1744,714,1030,224,101,123,17.23,0.172,0.128,0.098
180522,1995,192,99,93,38,16,22,22.22,0.222,0.198,0.172
180984,1995,227,128,99,92,37,55,42.97,0.43,0.405,0.374
181002,1995,746,441,305,421,157,264,59.86,0.599,0.564,0.515
181020,1995,243,130,113,140,56,84,64.62,0.646,0.576,0.496
181127,1995,271,134,137,117,44,73,54.48,0.545,0.432,0.321
181215,1995,1306,729,577,138,46,92,12.62,0.126,0.106,0.08
181394,1995,1123,607,516,64,20,44,7.25,0.072,0.057,0.039
181446,1995,362,214,148,164,57,107,50,0.5,0.453,0.385
181464,1995,3891,1925,1966,620,256,364,18.91,0.189,0.159,0.13
181534,1995,225,122,103,45,19,26,21.31,0.213,0.2,0.184
181783,1995,722,382,340,146,45,101,26.44,0.264,0.202,0.132
182281,1995,1324,748,576,161,54,107,14.3,0.143,0.122,0.094
182290,1995,1035,591,444,170,52,118,19.97,0.2,0.164,0.117
182634,1995,240,154,86,115,46,69,44.81,0.448,0.479,0.535
182795,1995,464,220,244,174,75,99,45,0.45,0.375,0.307
183062,1995,988,588,400,251,86,165,28.06,0.281,0.254,0.215
183080,1995,872,426,446,204,80,124,29.11,0.291,0.234,0.179
183239,1995,612,369,243,424,163,261,70.73,0.707,0.693,0.671
183822,1995,275,196,79,40,11,29,14.8,0.148,0.145,0.139
183974,1995,73,53,20,19,3,16,30.19,0.302,0.26,0.15
184348,1995,433,255,178,312,122,190,74.51,0.745,0.721,0.685
184603,1995,781,396,385,128,57,71,17.93,0.179,0.164,0.148
184612,1995,87,70,17,18,9,9,12.86,0.129,0.207,0.529
184782,1995,927,516,411,226,69,157,30.43,0.304,0.244,0.168
185129,1995,457,246,211,40,11,29,11.79,0.118,0.088,0.052
185572,1995,764,412,352,234,82,152,36.89,0.369,0.306,0.233
185590,1995,1068,651,417,216,69,147,22.58,0.226,0.202,0.165
185828,1995,552,131,421,60,35,25,19.08,0.191,0.109,0.083
186131,1995,1207,569,638,1105,579,526,92.44,0.924,0.915,0.908
186201,1995,319,190,129,67,20,47,24.74,0.247,0.21,0.155
186283,1995,612,329,283,242,103,139,42.25,0.422,0.395,0.364
186584,1995,955,527,428,371,145,226,42.88,0.429,0.388,0.339
186876,1995,726,438,288,258,86,172,39.27,0.393,0.355,0.299
187134,1995,1087,670,417,638,212,426,63.58,0.636,0.587,0.508
187444,1995,831,476,355,87,23,64,13.45,0.134,0.105,0.065
187985,1995,1712,956,756,221,76,145,15.17,0.152,0.129,0.101
188030,1995,1419,726,693,146,51,95,13.09,0.131,0.103,0.074
188429,1995,370,212,158,140,52,88,41.51,0.415,0.378,0.329
188641,1995,326,158,168,153,56,97,61.39,0.614,0.469,0.333
190044,1995,645,170,475,305,221,84,49.41,0.494,0.473,0.465
190099,1995,722,361,361,604,290,314,86.98,0.87,0.837,0.803
190150,1995,1157,505,652,918,501,417,82.57,0.826,0.793,0.768
190248,1995,118,63,55,29,13,16,25.4,0.254,0.246,0.236
190415,1995,2070,842,1228,1625,931,694,82.42,0.824,0.785,0.758
190512,1995,1445,839,606,149,55,94,11.2,0.112,0.103,0.091
190549,1995,1167,685,482,182,60,122,17.81,0.178,0.156,0.124
190558,1995,1426,728,698,33,17,16,2.2,0.022,0.023,0.024
190567,1995,865,449,416,31,18,13,2.9,0.029,0.036,0.043
190594,1995,1091,807,284,82,13,69,8.55,0.086,0.075,0.046
190637,1995,506,345,161,32,7,25,7.25,0.072,0.063,0.043
190664,1995,1444,805,639,228,81,147,18.26,0.183,0.158,0.127
190691,1995,486,294,192,22,7,15,5.1,0.051,0.045,0.036
190725,1995,398,269,129,77,20,57,21.19,0.212,0.193,0.155
191241,1995,1120,620,500,794,323,471,75.97,0.76,0.709,0.646
191515,1995,488,237,251,392,194,198,83.54,0.835,0.803,0.773
191533,1995,453,229,224,227,88,139,60.7,0.607,0.501,0.393
191630,1995,458,244,214,318,137,181,74.18,0.742,0.694,0.64
191649,1995,1518,830,688,559,201,358,43.13,0.431,0.368,0.292
191676,1995,293,213,80,171,52,119,55.87,0.559,0.584,0.65
191931,1995,609,288,321,203,73,130,45.14,0.451,0.333,0.227
191968,1995,1625,878,747,1052,440,612,69.7,0.697,0.647,0.589
192192,1995,200,154,46,69,10,59,38.31,0.383,0.345,0.217
192323,1995,397,236,161,258,98,160,67.8,0.678,0.65,0.609
192439,1995,1043,700,343,55,17,38,5.43,0.054,0.053,0.05
192703,1995,572,256,316,321,160,161,62.89,0.629,0.561,0.506
192749,1995,161,115,46,87,18,69,60,0.6,0.54,0.391
192819,1995,926,527,399,472,181,291,55.22,0.552,0.51,0.454
192925,1995,78,50,28,15,5,10,20,0.2,0.192,0.179
193016,1995,1002,623,379,4,2,2,0.32,0.003,0.004,0.005
193292,1995,135,108,27,30,5,25,23.15,0.231,0.222,0.185
193353,1995,258,196,62,114,24,90,45.92,0.459,0.442,0.387
193399,1995,217,164,53,107,27,80,48.78,0.488,0.493,0.509
193584,1995,302,227,75,182,36,146,64.32,0.643,0.603,0.48
193645,1995,718,595,123,120,13,107,17.98,0.18,0.167,0.106
193654,1995,445,275,170,178,54,124,45.09,0.451,0.4,0.318
193900,1995,3156,1851,1305,1652,681,971,52.46,0.525,0.523,0.522
193973,1995,424,264,160,204,67,137,51.89,0.519,0.481,0.419
194161,1995,160,92,68,56,21,35,38.04,0.38,0.35,0.309
194310,1995,1139,681,458,420,139,281,41.26,0.413,0.369,0.303
194824,1995,962,243,719,425,296,129,53.09,0.531,0.442,0.412
195003,1995,1634,502,1132,621,379,242,48.21,0.482,0.38,0.335
195030,1995,1205,583,622,751,354,397,68.1,0.681,0.623,0.569
195164,1995,547,278,269,285,127,158,56.83,0.568,0.521,0.472
195173,1995,281,145,136,89,48,41,28.28,0.283,0.317,0.353
195216,1995,571,287,284,382,176,206,71.78,0.718,0.669,0.62
195234,1995,248,170,78,111,34,77,45.29,0.453,0.448,0.436
195243,1995,276,162,114,74,22,52,32.1,0.321,0.268,0.193
195304,1995,233,183,50,118,29,89,48.63,0.486,0.506,0.58
195474,1995,590,317,273,393,182,211,66.56,0.666,0.666,0.667
195526,1995,606,373,233,438,152,286,76.68,0.767,0.723,0.652
195544,1995,84,64,20,56,9,47,73.44,0.734,0.667,0.45
195809,1995,2206,1181,1025,629,234,395,33.45,0.334,0.285,0.228
196413,1995,2392,1259,1133,1467,631,836,66.4,0.664,0.613,0.557
196592,1995,1899,1266,633,136,70,66,5.21,0.052,0.072,0.111
197045,1995,255,162,93,100,27,73,45.06,0.451,0.392,0.29
197133,1995,632,381,251,509,193,316,82.94,0.829,0.805,0.769
197869,1995,2205,1198,1007,749,273,476,39.73,0.397,0.34,0.271
197984,1995,114,45,69,47,26,21,46.67,0.467,0.412,0.377
198385,1995,429,209,220,373,186,187,89.47,0.895,0.869,0.845
198464,1995,2635,1550,1085,630,189,441,28.45,0.284,0.239,0.174
198507,1995,381,222,159,162,47,115,51.8,0.518,0.425,0.296
198516,1995,907,545,362,548,198,350,64.22,0.642,0.604,0.547
198835,1995,287,157,130,132,47,85,54.14,0.541,0.46,0.362
198969,1995,370,121,249,67,37,30,24.79,0.248,0.181,0.149
199102,1995,1396,706,690,339,117,222,31.44,0.314,0.243,0.17
199111,1995,393,235,158,123,35,88,37.45,0.375,0.313,0.222
199120,1995,3229,1982,1247,2101,732,1369,69.07,0.691,0.651,0.587
199139,1995,1663,974,689,396,115,281,28.85,0.289,0.238,0.167
199148,1995,1804,1234,570,376,77,299,24.23,0.242,0.208,0.135
199157,1995,510,309,201,139,34,105,33.98,0.34,0.273,0.169
199193,1995,3607,1523,2084,900,395,505,33.16,0.332,0.25,0.19
199218,1995,1370,863,507,463,133,330,38.24,0.382,0.338,0.262
199281,1995,410,199,211,81,34,47,23.62,0.236,0.198,0.161
199306,1995,146,66,80,31,10,21,31.82,0.318,0.212,0.125
199412,1995,146,110,36,72,19,53,48.18,0.482,0.493,0.528
199582,1995,385,203,182,61,17,44,21.67,0.217,0.158,0.093
199643,1995,518,305,213,127,29,98,32.13,0.321,0.245,0.136
199847,1995,962,458,504,720,357,363,79.26,0.793,0.748,0.708
199962,1995,334,157,177,113,45,68,43.31,0.433,0.338,0.254
199999,1995,446,298,148,121,32,89,29.87,0.299,0.271,0.216
200004,1995,1156,608,548,259,78,181,29.77,0.298,0.224,0.142
200059,1995,296,140,156,27,10,17,12.14,0.121,0.091,0.064
200156,1995,289,144,145,89,32,57,39.58,0.396,0.308,0.221
200217,1995,412,234,178,115,32,83,35.47,0.355,0.279,0.18
200226,1995,193,80,113,25,10,15,18.75,0.188,0.13,0.088
200253,1995,525,322,203,36,11,25,7.76,0.078,0.069,0.054
200280,1995,1407,665,742,190,81,109,16.39,0.164,0.135,0.109
200332,1995,1482,661,821,189,87,102,15.43,0.154,0.128,0.106
200572,1995,166,80,86,32,11,21,26.25,0.262,0.193,0.128
201104,1995,549,269,280,214,67,147,54.65,0.546,0.39,0.239
201371,1995,248,163,85,125,39,86,52.76,0.528,0.504,0.459
201548,1995,474,296,178,306,108,198,66.89,0.669,0.646,0.607
201645,1995,729,275,454,388,205,183,66.55,0.665,0.532,0.452
201690,1995,597,262,335,25,5,20,7.63,0.076,0.042,0.015
202134,1995,856,463,393,71,26,45,9.72,0.097,0.083,0.066
202480,1995,1610,836,774,890,342,548,65.55,0.655,0.553,0.442
202523,1995,701,357,344,488,221,267,74.79,0.748,0.696,0.642
202763,1995,591,306,285,205,78,127,41.5,0.415,0.347,0.274
203085,1995,220,87,133,94,46,48,55.17,0.552,0.427,0.346
203128,1995,217,119,98,124,47,77,64.71,0.647,0.571,0.48
203368,1995,844,424,420,587,257,330,77.83,0.778,0.695,0.612
203517,1995,2623,1580,1043,353,85,268,16.96,0.17,0.135,0.081
203535,1995,438,223,215,350,161,189,84.75,0.848,0.799,0.749
203580,1995,66,50,16,26,5,21,42,0.42,0.394,0.312
203775,1995,408,261,147,131,39,92,35.25,0.352,0.321,0.265
203845,1995,292,120,172,124,51,73,60.83,0.608,0.425,0.297
204024,1995,3211,1817,1394,1990,750,1240,68.24,0.682,0.62,0.538
204185,1995,478,229,249,248,107,141,61.57,0.616,0.519,0.43
204194,1995,379,228,151,121,51,70,30.7,0.307,0.319,0.338
204617,1995,172,110,62,46,12,34,30.91,0.309,0.267,0.194
204796,1995,5788,2951,2837,1354,478,876,29.68,0.297,0.234,0.168
204857,1995,3358,1939,1419,1459,479,980,50.54,0.505,0.434,0.338
206330,1995,213,87,126,28,12,16,18.39,0.184,0.131,0.095
206589,1995,433,228,205,347,147,200,87.72,0.877,0.801,0.717
206604,1995,1910,1033,877,214,68,146,14.13,0.141,0.112,0.078
206622,1995,698,396,302,394,177,217,54.8,0.548,0.564,0.586
206695,1995,1905,1004,901,208,85,123,12.25,0.122,0.109,0.094
206914,1995,620,358,262,61,26,35,9.78,0.098,0.098,0.099
207209,1995,485,220,265,24,7,17,7.73,0.077,0.049,0.026
207306,1995,240,127,113,39,11,28,22.05,0.22,0.162,0.097
207324,1995,320,158,162,78,28,50,31.65,0.316,0.244,0.173
207388,1995,2362,1185,1177,475,186,289,24.39,0.244,0.201,0.158
207500,1995,2712,1321,1391,519,191,328,24.83,0.248,0.191,0.137
207722,1995,259,164,95,33,6,27,16.46,0.165,0.127,0.063
207847,1995,570,282,288,91,48,43,15.25,0.152,0.16,0.167
207865,1995,769,470,299,123,34,89,18.94,0.189,0.16,0.114
208822,1995,347,232,115,162,54,108,46.55,0.465,0.467,0.47
209056,1995,455,280,175,228,85,143,51.07,0.511,0.501,0.486
209065,1995,438,260,178,276,105,171,65.77,0.658,0.63,0.59
209542,1995,2018,965,1053,561,194,367,38.03,0.38,0.278,0.184
209551,1995,2583,1429,1154,950,329,621,43.46,0.435,0.368,0.285
209612,1995,242,153,89,108,33,75,49.02,0.49,0.446,0.371
209807,1995,682,358,324,82,29,53,14.8,0.148,0.12,0.09
209922,1995,352,188,164,166,78,88,46.81,0.468,0.472,0.476
210146,1995,661,362,299,89,33,56,15.47,0.155,0.135,0.11
210401,1995,432,248,184,330,132,198,79.84,0.798,0.764,0.717
210429,1995,641,380,261,95,22,73,19.21,0.192,0.148,0.084
210571,1995,312,153,159,169,66,103,67.32,0.673,0.542,0.415
210669,1995,564,284,280,353,162,191,67.25,0.672,0.626,0.579
210775,1995,150,76,74,46,14,32,42.11,0.421,0.307,0.189
211088,1995,257,186,71,145,36,109,58.6,0.586,0.564,0.507
211158,1995,1054,689,365,372,88,284,41.22,0.412,0.353,0.241
211291,1995,910,474,436,736,342,394,83.12,0.831,0.809,0.784
211352,1995,218,150,68,110,25,85,56.67,0.567,0.505,0.368
211361,1995,892,465,427,124,45,79,16.99,0.17,0.139,0.105
211431,1995,125,122,3,57,2,55,45.08,0.451,0.456,0.667
211440,1995,1233,376,857,772,515,257,68.35,0.683,0.626,0.601
211468,1995,164,164,0,90,0,90,54.88,0.549,0.549,NA
211556,1995,109,109,0,48,0,48,44.04,0.44,0.44,NA
211583,1995,83,83,0,53,0,53,63.86,0.639,0.639,NA
211608,1995,256,131,125,20,5,15,11.45,0.114,0.078,0.04
211644,1995,1241,768,473,210,46,164,21.35,0.214,0.169,0.097
211981,1995,384,193,191,138,45,93,48.19,0.482,0.359,0.236
212009,1995,520,286,234,393,174,219,76.57,0.766,0.756,0.744
212054,1995,935,341,594,111,40,71,20.82,0.208,0.119,0.067
212106,1995,1215,703,512,523,193,330,46.94,0.469,0.43,0.377
212115,1995,820,457,363,169,45,124,27.13,0.271,0.206,0.124
212133,1995,226,171,55,103,21,82,47.95,0.48,0.456,0.382
212160,1995,1332,763,569,213,69,144,18.87,0.189,0.16,0.121
212197,1995,434,307,127,282,72,210,68.4,0.684,0.65,0.567
212577,1995,498,234,264,372,179,193,82.48,0.825,0.747,0.678
212601,1995,394,225,169,174,73,101,44.89,0.449,0.442,0.432
212832,1995,40,35,5,16,0,16,45.71,0.457,0.4,0
212911,1995,306,162,144,269,126,143,88.27,0.883,0.879,0.875
213020,1995,2661,1552,1109,652,187,465,29.96,0.3,0.245,0.169
213251,1995,282,175,107,196,73,123,70.29,0.703,0.695,0.682
213321,1995,426,180,246,247,126,121,67.22,0.672,0.58,0.512
213349,1995,1229,715,514,192,52,140,19.58,0.196,0.156,0.101
213358,1995,147,85,62,37,9,28,32.94,0.329,0.252,0.145
213367,1995,741,438,303,404,140,264,60.27,0.603,0.545,0.462
213385,1995,525,241,284,415,208,207,85.89,0.859,0.79,0.732
213507,1995,297,155,142,183,79,104,67.1,0.671,0.616,0.556
213543,1995,1045,412,633,734,404,330,80.1,0.801,0.702,0.638
213613,1995,693,359,334,133,43,90,25.07,0.251,0.192,0.129
213668,1995,366,210,156,237,82,155,73.81,0.738,0.648,0.526
213783,1995,577,340,237,135,41,94,27.65,0.276,0.234,0.173
213826,1995,245,193,52,99,13,86,44.56,0.446,0.404,0.25
213996,1995,671,416,255,428,163,265,63.7,0.637,0.638,0.639
214041,1995,1157,700,457,389,132,257,36.71,0.367,0.336,0.289
214069,1995,280,204,76,88,28,60,29.41,0.294,0.314,0.368
214157,1995,319,169,150,217,97,120,71.01,0.71,0.68,0.647
214175,1995,486,277,209,392,161,231,83.39,0.834,0.807,0.77
214272,1995,159,114,45,15,5,10,8.77,0.088,0.094,0.111
214777,1995,5400,2712,2688,2410,947,1463,53.95,0.54,0.446,0.352
215062,1995,2349,1158,1191,1954,952,1002,86.53,0.865,0.832,0.799
215743,1995,334,145,189,135,61,74,51.03,0.51,0.404,0.323
215798,1995,260,129,131,161,72,89,68.99,0.69,0.619,0.55
215929,1995,907,515,392,590,261,329,63.88,0.639,0.65,0.666
216010,1995,1278,665,613,497,188,309,46.47,0.465,0.389,0.307
216038,1995,1279,715,564,254,82,172,24.06,0.241,0.199,0.145
216287,1995,354,190,164,308,134,174,91.58,0.916,0.87,0.817
216339,1995,2302,1366,936,440,143,297,21.74,0.217,0.191,0.153
216524,1995,315,170,145,230,106,124,72.94,0.729,0.73,0.731
216694,1995,295,141,154,109,46,63,44.68,0.447,0.369,0.299
216764,1995,1384,873,511,363,85,278,31.84,0.318,0.262,0.166
216807,1995,376,230,146,250,86,164,71.3,0.713,0.665,0.589
216852,1995,421,175,246,141,64,77,44,0.44,0.335,0.26
216931,1995,369,167,202,118,60,58,34.73,0.347,0.32,0.297
217059,1995,851,483,368,350,121,229,47.41,0.474,0.411,0.329
217156,1995,1370,739,631,1106,492,614,83.09,0.831,0.807,0.78
217402,1995,954,589,365,795,297,498,84.55,0.846,0.833,0.814
217536,1995,354,258,96,190,49,141,54.65,0.546,0.537,0.51
217776,1995,69,32,37,11,3,8,25,0.25,0.159,0.081
217819,1995,1748,1190,558,596,136,460,38.66,0.387,0.341,0.244
217882,1995,2556,1255,1301,905,319,586,46.69,0.467,0.354,0.245
217998,1995,143,77,66,93,42,51,66.23,0.662,0.65,0.636
218061,1995,757,405,352,140,43,97,23.95,0.24,0.185,0.122
218229,1995,477,301,176,155,46,109,36.21,0.362,0.325,0.261
218238,1995,164,82,82,40,18,22,26.83,0.268,0.244,0.22
218399,1995,241,167,74,35,8,27,16.17,0.162,0.145,0.108
218414,1995,166,70,96,50,19,31,44.29,0.443,0.301,0.198
218663,1995,2593,1477,1116,799,282,517,35,0.35,0.308,0.253
218724,1995,734,411,323,117,27,90,21.9,0.219,0.159,0.084
218733,1995,859,447,412,279,100,179,40.04,0.4,0.325,0.243
218742,1995,427,264,163,66,15,51,19.32,0.193,0.155,0.092
218973,1995,286,140,146,219,99,120,85.71,0.857,0.766,0.678
219000,1995,372,242,130,168,52,116,47.93,0.479,0.452,0.4
219046,1995,435,234,201,33,8,25,10.68,0.107,0.076,0.04
219082,1995,256,125,131,22,5,17,13.6,0.136,0.086,0.038
219198,1995,95,62,33,27,11,16,25.81,0.258,0.284,0.333
219259,1995,574,343,231,75,19,56,16.33,0.163,0.131,0.082
219356,1995,1659,813,846,359,135,224,27.55,0.276,0.216,0.16
219471,1995,1160,660,500,224,60,164,24.85,0.249,0.193,0.12
219602,1995,776,457,319,105,26,79,17.29,0.173,0.135,0.082
219709,1995,347,221,126,14,3,11,4.98,0.05,0.04,0.024
219718,1995,149,52,97,17,5,12,23.08,0.231,0.114,0.052
219949,1995,171,64,107,38,17,21,32.81,0.328,0.222,0.159
220075,1995,1505,867,638,178,59,119,13.73,0.137,0.118,0.092
220215,1995,294,170,124,90,37,53,31.18,0.312,0.306,0.298
220613,1995,493,287,206,115,37,78,27.18,0.272,0.233,0.18
220631,1995,204,131,73,31,9,22,16.79,0.168,0.152,0.123
220710,1995,217,106,111,86,32,54,50.94,0.509,0.396,0.288
221351,1995,373,204,169,256,105,151,74.02,0.74,0.686,0.621
221519,1995,370,197,173,275,120,155,78.68,0.787,0.743,0.694
221731,1995,90,49,41,29,7,22,44.9,0.449,0.322,0.171
221847,1995,1113,513,600,130,37,93,18.13,0.181,0.117,0.062
221892,1995,214,113,101,43,14,29,25.66,0.257,0.201,0.139
222178,1995,917,506,411,250,93,157,31.03,0.31,0.273,0.226
222983,1995,293,155,138,195,90,105,67.74,0.677,0.666,0.652
223232,1995,2329,1390,939,1004,337,667,47.99,0.48,0.431,0.359
224004,1995,90,55,35,18,5,13,23.64,0.236,0.2,0.143
224323,1995,244,146,98,134,58,76,52.05,0.52,0.549,0.592
225432,1995,624,351,273,10,3,7,1.99,0.02,0.016,0.011
225548,1995,325,170,155,82,28,54,31.76,0.318,0.252,0.181
225627,1995,370,259,111,50,11,39,15.06,0.151,0.135,0.099
226231,1995,218,66,152,68,42,26,39.39,0.394,0.312,0.276
226833,1995,578,276,302,49,16,33,11.96,0.12,0.085,0.053
227216,1995,2134,1180,954,201,50,151,12.8,0.128,0.094,0.052
227331,1995,258,189,69,34,8,26,13.76,0.138,0.132,0.116
227526,1995,1114,536,578,105,29,76,14.18,0.142,0.094,0.05
227757,1995,688,338,350,472,213,259,76.63,0.766,0.686,0.609
227845,1995,387,230,157,119,37,82,35.65,0.356,0.307,0.236
227863,1995,232,145,87,58,17,41,28.28,0.283,0.25,0.195
228042,1995,221,107,114,35,15,20,18.69,0.187,0.158,0.132
228149,1995,452,254,198,123,34,89,35.04,0.35,0.272,0.172
228246,1995,1228,662,566,743,287,456,68.88,0.689,0.605,0.507
228343,1995,326,188,138,188,69,119,63.3,0.633,0.577,0.5
228431,1995,1714,986,728,275,69,206,20.89,0.209,0.16,0.095
228459,1995,2426,1461,965,309,80,229,15.67,0.157,0.127,0.083
228501,1995,393,140,253,34,16,18,12.86,0.129,0.087,0.063
228529,1995,1021,531,490,140,52,88,16.57,0.166,0.137,0.106
228705,1995,893,420,473,40,17,23,5.48,0.055,0.045,0.036
228723,1995,5985,2986,2999,1643,498,1145,38.35,0.384,0.275,0.166
228769,1995,1243,623,620,117,47,70,11.24,0.112,0.094,0.076
228778,1995,6212,3139,3073,2207,865,1342,42.75,0.428,0.355,0.281
228787,1995,351,154,197,113,45,68,44.16,0.442,0.322,0.228
228796,1995,1618,887,731,36,12,24,2.71,0.027,0.022,0.016
228875,1995,1325,813,512,511,146,365,44.9,0.449,0.386,0.285
228981,1995,213,142,71,78,20,58,40.85,0.409,0.366,0.282
229018,1995,100,61,39,10,3,7,11.48,0.115,0.1,0.077
229027,1995,1528,821,707,79,20,59,7.19,0.072,0.052,0.028
229115,1995,3461,1764,1697,747,260,487,27.61,0.276,0.216,0.153
229780,1995,167,102,65,26,7,19,18.63,0.186,0.156,0.108
229814,1995,901,506,395,108,35,73,14.43,0.144,0.12,0.089
230603,1995,643,471,172,90,16,74,15.71,0.157,0.14,0.093
230728,1995,1175,803,372,251,43,208,25.9,0.259,0.214,0.116
230764,1995,1356,837,519,284,73,211,25.21,0.252,0.209,0.141
230782,1995,1338,889,449,109,23,86,9.67,0.097,0.081,0.051
231059,1995,529,301,228,383,160,223,74.09,0.741,0.724,0.702
231174,1995,1853,1037,816,853,338,515,49.66,0.497,0.46,0.414
231420,1995,147,79,68,35,13,22,27.85,0.278,0.238,0.191
231554,1995,139,68,71,47,22,25,36.76,0.368,0.338,0.31
231624,1995,1369,850,519,1086,378,708,83.29,0.833,0.793,0.728
231712,1995,534,320,214,59,18,41,12.81,0.128,0.11,0.084
232025,1995,221,107,114,103,47,56,52.34,0.523,0.466,0.412
232043,1995,206,144,62,96,27,69,47.92,0.479,0.466,0.435
232089,1995,297,109,188,66,28,38,34.86,0.349,0.222,0.149
232186,1995,1852,1065,787,486,145,341,32.02,0.32,0.262,0.184
232265,1995,1272,780,492,418,98,320,41.03,0.41,0.329,0.199
232423,1995,2537,1484,1053,1548,523,1025,69.07,0.691,0.61,0.497
232557,1995,1165,600,565,224,70,154,25.67,0.257,0.192,0.124
232566,1995,671,445,226,283,57,226,50.79,0.508,0.422,0.252
232609,1995,262,181,81,142,42,100,55.25,0.552,0.542,0.519
232681,1995,758,497,261,443,138,305,61.37,0.614,0.584,0.529
232706,1995,167,122,45,82,22,60,49.18,0.492,0.491,0.489
232937,1995,1257,706,551,91,24,67,9.49,0.095,0.072,0.044
232982,1995,1514,827,687,149,30,119,14.39,0.144,0.098,0.044
233277,1995,1381,833,548,425,121,304,36.49,0.365,0.308,0.221
233374,1995,762,398,364,581,251,330,82.91,0.829,0.762,0.69
233426,1995,431,247,184,223,77,146,59.11,0.591,0.517,0.418
233541,1995,212,118,94,53,16,37,31.36,0.314,0.25,0.17
233897,1995,269,141,128,67,27,40,28.37,0.284,0.249,0.211
233921,1995,4687,2050,2637,1819,745,1074,52.39,0.524,0.388,0.283
234030,1995,1655,963,692,320,104,216,22.43,0.224,0.193,0.15
234085,1995,335,0,335,182,182,0,NA,NA,0.543,0.543
234155,1995,734,431,303,131,35,96,22.27,0.223,0.178,0.116
234164,1995,441,234,207,2,0,2,0.85,0.009,0.005,0
235097,1995,687,464,223,109,18,91,19.61,0.196,0.159,0.081
235167,1995,536,318,218,224,88,136,42.77,0.428,0.418,0.404
236230,1995,667,394,273,264,81,183,46.45,0.464,0.396,0.297
236328,1995,656,374,282,404,162,242,64.71,0.647,0.616,0.574
236577,1995,397,254,143,138,58,80,31.5,0.315,0.348,0.406
236595,1995,426,245,181,165,56,109,44.49,0.445,0.387,0.309
236896,1995,288,145,143,57,22,35,24.14,0.241,0.198,0.154
236939,1995,2512,1217,1295,734,315,419,34.43,0.344,0.292,0.243
236948,1995,3500,1783,1717,1405,562,843,47.28,0.473,0.401,0.327
237011,1995,1745,1105,640,457,120,337,30.5,0.305,0.262,0.188
237057,1995,369,189,180,247,119,128,67.72,0.677,0.669,0.661
237066,1995,395,229,166,198,73,125,54.59,0.546,0.501,0.44
237215,1995,416,243,173,8,5,3,1.23,0.012,0.019,0.029
237330,1995,542,282,260,148,62,86,30.5,0.305,0.273,0.238
237358,1995,180,101,79,35,13,22,21.78,0.218,0.194,0.165
237367,1995,1123,618,505,96,36,60,9.71,0.097,0.085,0.071
237792,1995,598,333,265,74,20,54,16.22,0.162,0.124,0.075
237899,1995,572,292,280,28,13,15,5.14,0.051,0.049,0.046
237932,1995,509,273,236,108,27,81,29.67,0.297,0.212,0.114
237969,1995,453,240,213,200,77,123,51.25,0.512,0.442,0.362
238032,1995,2938,1457,1481,783,324,459,31.5,0.315,0.267,0.219
238333,1995,291,163,128,187,74,113,69.33,0.693,0.643,0.578
238430,1995,139,93,46,20,3,17,18.28,0.183,0.144,0.065
238458,1995,429,296,133,202,41,161,54.39,0.544,0.471,0.308
238476,1995,395,175,220,190,89,101,57.71,0.577,0.481,0.405
238616,1995,234,132,102,59,21,38,28.79,0.288,0.252,0.206
238661,1995,231,155,76,44,10,34,21.94,0.219,0.19,0.132
239080,1995,184,117,67,44,15,29,24.79,0.248,0.239,0.224
239105,1995,1627,883,744,870,327,543,61.49,0.615,0.535,0.44
239628,1995,184,101,83,99,42,57,56.44,0.564,0.538,0.506
239716,1995,520,296,224,319,112,207,69.93,0.699,0.613,0.5
240107,1995,335,224,111,92,24,68,30.36,0.304,0.275,0.216
240189,1995,1856,989,867,294,108,186,18.81,0.188,0.158,0.125
240277,1995,780,522,258,98,30,68,13.03,0.13,0.126,0.116
240329,1995,1731,1035,696,324,104,220,21.26,0.213,0.187,0.149
240338,1995,109,63,46,51,18,33,52.38,0.524,0.468,0.391
240365,1995,1487,844,643,211,74,137,16.23,0.162,0.142,0.115
240374,1995,637,369,268,42,13,29,7.86,0.079,0.066,0.049
240417,1995,1133,542,591,143,36,107,19.74,0.197,0.126,0.061
240426,1995,288,173,115,52,17,35,20.23,0.202,0.181,0.148
240444,1995,5101,2779,2322,2037,768,1269,45.66,0.457,0.399,0.331
240453,1995,1785,926,859,186,75,111,11.99,0.12,0.104,0.087
240462,1995,926,315,611,125,59,66,20.95,0.21,0.135,0.097
240471,1995,957,548,409,204,73,131,23.91,0.239,0.213,0.178
240480,1995,1474,817,657,285,82,203,24.85,0.249,0.193,0.125
240727,1995,1267,661,606,276,88,188,28.44,0.284,0.218,0.145
243443,1995,728,466,262,33,8,25,5.36,0.054,0.045,0.031
243780,1995,6064,2696,3368,1625,786,839,31.12,0.311,0.268,0.233
100654,1996,716,372,344,147,44,103,27.69,0.277,0.205,0.128
100663,1996,1027,597,430,134,35,99,16.58,0.166,0.13,0.081
100751,1996,2049,1195,854,744,240,504,42.18,0.422,0.363,0.281
100858,1996,3287,1746,1541,1321,446,875,50.11,0.501,0.402,0.289
101435,1996,165,95,70,62,16,46,48.42,0.484,0.376,0.229
101480,1996,817,446,371,122,23,99,22.2,0.222,0.149,0.062
101675,1996,327,146,181,125,58,67,45.89,0.459,0.382,0.32
101879,1996,790,459,331,99,28,71,15.47,0.155,0.125,0.085
102049,1996,646,388,258,329,117,212,54.64,0.546,0.509,0.453
102094,1996,1066,590,476,147,37,110,18.64,0.186,0.138,0.078
102234,1996,201,121,80,96,32,64,52.89,0.529,0.478,0.4
102368,1996,877,483,394,340,133,207,42.86,0.429,0.388,0.338
102377,1996,810,497,313,180,34,146,29.38,0.294,0.222,0.109
104151,1996,4001,2117,1884,1028,398,630,29.76,0.298,0.257,0.211
104179,1996,4006,2102,1904,1145,441,704,33.49,0.335,0.286,0.232
105330,1996,2267,1288,979,538,170,368,28.57,0.286,0.237,0.174
106245,1996,691,429,262,65,18,47,10.96,0.11,0.094,0.069
106342,1996,129,69,60,60,22,38,55.07,0.551,0.465,0.367
106397,1996,2174,1105,1069,490,184,306,27.69,0.277,0.225,0.172
106412,1996,575,302,273,47,12,35,11.59,0.116,0.082,0.044
106458,1996,1592,893,699,216,64,152,17.02,0.17,0.136,0.092
106467,1996,668,339,329,94,40,54,15.93,0.159,0.141,0.122
106485,1996,453,240,213,44,19,25,10.42,0.104,0.097,0.089
106704,1996,1478,928,550,239,69,170,18.32,0.183,0.162,0.125
107044,1996,846,497,349,266,85,181,36.42,0.364,0.314,0.244
107080,1996,306,185,121,188,78,110,59.46,0.595,0.614,0.645
107141,1996,266,148,118,101,37,64,43.24,0.432,0.38,0.314
107512,1996,451,237,214,184,69,115,48.52,0.485,0.408,0.322
107558,1996,110,52,58,37,14,23,44.23,0.442,0.336,0.241
110097,1996,407,268,139,184,62,122,45.52,0.455,0.452,0.446
110404,1996,216,64,152,156,112,44,68.75,0.688,0.722,0.737
110422,1996,2757,1202,1555,448,132,316,26.29,0.263,0.162,0.085
110486,1996,418,253,165,56,14,42,16.6,0.166,0.134,0.085
110495,1996,381,244,137,85,22,63,25.82,0.258,0.223,0.161
110510,1996,882,554,328,78,18,60,10.83,0.108,0.088,0.055
110529,1996,1497,647,850,128,56,72,11.13,0.111,0.086,0.066
110538,1996,1524,874,650,173,35,138,15.79,0.158,0.114,0.054
110547,1996,475,358,117,24,3,21,5.87,0.059,0.051,0.026
110556,1996,1503,846,657,198,54,144,17.02,0.17,0.132,0.082
110565,1996,2028,1158,870,199,48,151,13.04,0.13,0.098,0.055
110574,1996,661,420,241,83,26,57,13.57,0.136,0.126,0.108
110583,1996,2299,1407,892,152,38,114,8.1,0.081,0.066,0.043
110592,1996,1313,763,550,51,15,36,4.72,0.047,0.039,0.027
110617,1996,1396,826,570,84,23,61,7.38,0.074,0.06,0.04
113698,1996,58,41,17,23,6,17,41.46,0.415,0.397,0.353
115755,1996,823,471,352,62,13,49,10.4,0.104,0.075,0.037
119173,1996,112,112,0,61,0,61,54.46,0.545,0.545,NA
120184,1996,124,75,49,49,16,33,44,0.44,0.395,0.327
121309,1996,515,313,202,218,70,148,47.28,0.473,0.423,0.347
121345,1996,396,187,209,331,173,158,84.49,0.845,0.836,0.828
122409,1996,2908,1752,1156,208,55,153,8.73,0.087,0.072,0.048
122436,1996,1042,569,473,542,213,329,57.82,0.578,0.52,0.45
122597,1996,1727,1102,625,111,35,76,6.9,0.069,0.064,0.056
122612,1996,616,413,203,307,89,218,52.78,0.528,0.498,0.438
122931,1996,1075,586,489,798,349,449,76.62,0.766,0.742,0.714
123554,1996,488,288,200,307,102,205,71.18,0.712,0.629,0.51
123572,1996,781,502,279,156,36,120,23.9,0.239,0.2,0.129
126562,1996,373,215,158,54,20,34,15.81,0.158,0.145,0.127
126580,1996,375,227,148,63,18,45,19.82,0.198,0.168,0.122
126614,1996,3953,1983,1970,1529,623,906,45.69,0.457,0.387,0.316
126818,1996,2695,1511,1184,847,307,540,35.74,0.357,0.314,0.259
127060,1996,717,372,345,389,168,221,59.41,0.594,0.543,0.487
127185,1996,1124,493,631,122,43,79,16.02,0.16,0.109,0.068
127565,1996,1324,677,647,51,15,36,5.32,0.053,0.039,0.023
127741,1996,1642,1000,642,413,120,293,29.3,0.293,0.252,0.187
128106,1996,574,305,269,68,19,49,16.07,0.161,0.118,0.071
128744,1996,116,58,58,35,17,18,31.03,0.31,0.302,0.293
128771,1996,1092,534,558,165,65,100,18.73,0.187,0.151,0.116
129020,1996,2142,1156,986,908,311,597,51.64,0.516,0.424,0.315
129242,1996,876,440,436,642,299,343,77.95,0.78,0.733,0.686
129941,1996,329,109,220,68,40,28,25.69,0.257,0.207,0.182
130253,1996,602,361,241,281,81,200,55.4,0.554,0.467,0.336
130314,1996,164,164,0,66,0,66,40.24,0.402,0.402,NA
130493,1996,1009,587,422,137,39,98,16.7,0.167,0.136,0.092
130590,1996,504,238,266,387,195,192,80.67,0.807,0.768,0.733
130697,1996,738,374,364,633,311,322,86.1,0.861,0.858,0.854
130776,1996,496,242,254,60,32,28,11.57,0.116,0.121,0.126
130794,1996,1403,688,715,1235,611,624,90.7,0.907,0.88,0.855
130934,1996,544,305,239,87,21,66,21.64,0.216,0.16,0.088
130943,1996,3290,1980,1310,1823,623,1200,60.61,0.606,0.554,0.476
131159,1996,1107,703,404,643,224,419,59.6,0.596,0.581,0.554
131283,1996,452,264,188,261,100,161,60.98,0.61,0.577,0.532
131450,1996,186,105,81,13,6,7,6.67,0.067,0.07,0.074
131469,1996,1643,973,670,1082,427,655,67.32,0.673,0.659,0.637
131496,1996,1408,760,648,1256,569,687,90.39,0.904,0.892,0.878
131520,1996,1002,648,354,463,126,337,52.01,0.52,0.462,0.356
132471,1996,177,101,76,40,16,24,23.76,0.238,0.226,0.211
132602,1996,575,322,253,93,20,73,22.67,0.227,0.162,0.079
132903,1996,2579,1316,1263,672,219,453,34.42,0.344,0.261,0.173
133492,1996,429,260,169,242,84,158,60.77,0.608,0.564,0.497
133553,1996,711,95,616,132,119,13,13.68,0.137,0.186,0.193
133650,1996,1717,1017,700,281,83,198,19.47,0.195,0.164,0.119
133669,1996,1001,551,450,155,57,98,17.79,0.178,0.155,0.127
133711,1996,355,217,138,143,45,98,45.16,0.452,0.403,0.326
133881,1996,491,149,342,171,101,70,46.98,0.47,0.348,0.295
133951,1996,1846,1067,779,314,87,227,21.27,0.213,0.17,0.112
134079,1996,458,287,171,224,67,157,54.7,0.547,0.489,0.392
134097,1996,3999,2329,1670,1583,536,1047,44.95,0.45,0.396,0.321
134130,1996,5171,2899,2272,2599,929,1670,57.61,0.576,0.503,0.409
134945,1996,365,197,168,113,44,69,35.03,0.35,0.31,0.262
135726,1996,1678,893,785,887,381,506,56.66,0.567,0.529,0.485
136172,1996,987,583,404,213,62,151,25.9,0.259,0.216,0.153
136950,1996,418,240,178,194,69,125,52.08,0.521,0.464,0.388
137546,1996,416,229,187,211,83,128,55.9,0.559,0.507,0.444
138354,1996,459,261,198,107,39,68,26.05,0.26,0.233,0.197
138716,1996,503,281,222,34,10,24,8.54,0.085,0.068,0.045
138789,1996,805,519,286,60,14,46,8.86,0.089,0.075,0.049
139144,1996,539,339,200,252,79,173,51.03,0.51,0.468,0.395
139366,1996,616,383,233,43,10,33,8.62,0.086,0.07,0.043
139393,1996,206,119,87,109,43,66,55.46,0.555,0.529,0.494
139658,1996,1508,867,641,1076,438,638,73.59,0.736,0.714,0.683
139719,1996,573,307,266,48,6,42,13.68,0.137,0.084,0.023
139755,1996,2120,596,1524,484,288,196,32.89,0.329,0.228,0.189
139764,1996,315,199,116,43,10,33,16.58,0.166,0.137,0.086
139861,1996,715,483,232,119,23,96,19.88,0.199,0.166,0.099
139931,1996,3159,1699,1460,385,115,270,15.89,0.159,0.122,0.079
139940,1996,1551,985,566,211,58,153,15.53,0.155,0.136,0.102
139959,1996,3671,2184,1487,1546,494,1052,48.17,0.482,0.421,0.332
140447,1996,681,432,249,228,63,165,38.19,0.382,0.335,0.253
140960,1996,483,268,215,13,3,10,3.73,0.037,0.027,0.014
140988,1996,204,134,70,75,22,53,39.55,0.395,0.368,0.314
141185,1996,187,120,67,66,22,44,36.67,0.367,0.353,0.328
141264,1996,1838,1030,808,227,65,162,15.73,0.157,0.124,0.08
141334,1996,1296,801,495,141,28,113,14.11,0.141,0.109,0.057
141486,1996,152,100,52,31,10,21,21,0.21,0.204,0.192
141565,1996,333,207,126,35,11,24,11.59,0.116,0.105,0.087
141574,1996,1357,769,588,154,45,109,14.17,0.142,0.113,0.077
142276,1996,1378,789,589,49,15,34,4.31,0.043,0.036,0.025
142285,1996,1201,574,627,222,85,137,23.87,0.239,0.185,0.136
142461,1996,264,156,108,18,4,14,8.97,0.09,0.068,0.037
143084,1996,574,345,229,397,153,244,70.72,0.707,0.692,0.668
143288,1996,142,72,70,35,13,22,30.56,0.306,0.246,0.186
144005,1996,563,409,154,17,4,13,3.18,0.032,0.03,0.026
144281,1996,868,411,457,130,52,78,18.98,0.19,0.15,0.114
144740,1996,1122,668,454,483,184,299,44.76,0.448,0.43,0.405
144892,1996,1640,1000,640,505,126,379,37.9,0.379,0.308,0.197
144962,1996,222,137,85,130,49,81,59.12,0.591,0.586,0.576
144971,1996,128,67,61,55,19,36,53.73,0.537,0.43,0.311
145600,1996,2720,1505,1215,454,179,275,18.27,0.183,0.167,0.147
145619,1996,231,112,119,82,30,52,46.43,0.464,0.355,0.252
145637,1996,5938,2865,3073,3321,1507,1814,63.32,0.633,0.559,0.49
145691,1996,200,123,77,87,22,65,52.85,0.528,0.435,0.286
145813,1996,2888,1793,1095,877,245,632,35.25,0.352,0.304,0.224
146481,1996,324,152,172,188,90,98,64.47,0.645,0.58,0.523
146612,1996,312,137,175,120,57,63,45.99,0.46,0.385,0.326
146719,1996,1063,690,373,562,175,387,56.09,0.561,0.529,0.469
146825,1996,156,90,66,54,15,39,43.33,0.433,0.346,0.227
147013,1996,309,142,167,106,46,60,42.25,0.422,0.343,0.275
147244,1996,497,284,213,253,80,173,60.92,0.609,0.509,0.376
147341,1996,282,167,115,139,52,87,52.1,0.521,0.493,0.452
147703,1996,2434,1339,1095,613,246,367,27.41,0.274,0.252,0.225
147767,1996,1947,1035,912,1639,719,920,88.89,0.889,0.842,0.788
147776,1996,799,474,325,12,6,6,1.27,0.013,0.015,0.018
147828,1996,400,231,169,141,55,86,37.23,0.372,0.352,0.325
148131,1996,283,135,148,112,50,62,45.93,0.459,0.396,0.338
148496,1996,153,106,47,80,27,53,50,0.5,0.523,0.574
148584,1996,151,91,60,53,15,38,41.76,0.418,0.351,0.25
148627,1996,203,116,87,56,14,42,36.21,0.362,0.276,0.161
149222,1996,2404,1054,1350,376,152,224,21.25,0.212,0.156,0.113
149231,1996,1176,741,435,170,36,134,18.08,0.181,0.145,0.083
149772,1996,1477,720,757,428,171,257,35.69,0.357,0.29,0.226
149781,1996,557,278,279,424,207,217,78.06,0.781,0.761,0.742
150066,1996,406,222,184,144,47,97,43.69,0.437,0.355,0.255
150136,1996,3763,1959,1804,726,241,485,24.76,0.248,0.193,0.134
150145,1996,201,117,84,68,22,46,39.32,0.393,0.338,0.262
150163,1996,777,475,302,426,137,289,60.84,0.608,0.548,0.454
150400,1996,619,351,268,450,192,258,73.5,0.735,0.727,0.716
150534,1996,694,428,266,294,99,195,45.56,0.456,0.424,0.372
150668,1996,197,107,90,90,39,51,47.66,0.477,0.457,0.433
150941,1996,174,104,70,95,37,58,55.77,0.558,0.546,0.529
151102,1996,1196,647,549,44,16,28,4.33,0.043,0.037,0.029
151111,1996,2100,1172,928,87,30,57,4.86,0.049,0.041,0.032
151306,1996,1573,912,661,173,45,128,14.04,0.14,0.11,0.068
151324,1996,1911,1026,885,355,111,244,23.78,0.238,0.186,0.125
151333,1996,339,227,112,20,6,14,6.17,0.062,0.059,0.054
151342,1996,593,360,233,41,9,32,8.89,0.089,0.069,0.039
151351,1996,5766,3376,2390,2660,975,1685,49.91,0.499,0.461,0.408
151360,1996,560,355,205,37,14,23,6.48,0.065,0.066,0.068
151379,1996,643,375,268,60,18,42,11.2,0.112,0.093,0.067
151388,1996,233,148,85,9,3,6,4.05,0.04,0.039,0.035
151777,1996,305,151,154,113,46,67,44.37,0.444,0.37,0.299
151786,1996,221,151,70,67,16,51,33.77,0.338,0.303,0.229
152080,1996,1920,862,1058,1698,915,783,90.84,0.908,0.884,0.865
152248,1996,1026,558,468,92,42,50,8.96,0.09,0.09,0.09
152363,1996,212,107,105,93,40,53,49.53,0.495,0.439,0.381
152530,1996,485,270,215,348,147,201,74.44,0.744,0.718,0.684
152600,1996,656,348,308,381,149,232,66.67,0.667,0.581,0.484
153001,1996,311,161,150,124,52,72,44.72,0.447,0.399,0.347
153108,1996,303,178,125,160,58,102,57.3,0.573,0.528,0.464
153269,1996,638,385,253,352,145,207,53.77,0.538,0.552,0.573
153384,1996,354,210,144,271,106,165,78.57,0.786,0.766,0.736
153603,1996,3599,1592,2007,1022,455,567,35.62,0.356,0.284,0.227
153834,1996,615,347,268,437,190,247,71.18,0.712,0.711,0.709
154095,1996,2012,1234,778,673,224,449,36.39,0.364,0.334,0.288
155089,1996,196,111,85,47,12,35,31.53,0.315,0.24,0.141
155317,1996,3546,1902,1644,926,349,577,30.34,0.303,0.261,0.212
155335,1996,96,61,35,29,10,19,31.15,0.312,0.302,0.286
155399,1996,2681,1326,1355,583,208,375,28.28,0.283,0.217,0.154
155520,1996,230,129,101,70,21,49,37.98,0.38,0.304,0.208
155627,1996,130,48,82,52,23,29,60.42,0.604,0.4,0.28
155937,1996,146,72,74,50,18,32,44.44,0.444,0.342,0.243
156213,1996,289,184,105,133,50,83,45.11,0.451,0.46,0.476
156286,1996,327,203,124,164,57,107,52.71,0.527,0.502,0.46
156295,1996,396,225,171,125,53,72,32,0.32,0.316,0.31
156365,1996,295,151,144,66,21,45,29.8,0.298,0.224,0.146
156541,1996,421,210,211,95,40,55,26.19,0.262,0.226,0.19
156745,1996,326,193,133,131,41,90,46.63,0.466,0.402,0.308
157058,1996,364,163,201,27,7,20,12.27,0.123,0.074,0.035
157076,1996,179,103,76,44,22,22,21.36,0.214,0.246,0.289
157085,1996,2640,1459,1181,720,253,467,32.01,0.32,0.273,0.214
157289,1996,1861,950,911,197,69,128,13.47,0.135,0.106,0.076
157386,1996,1271,687,584,157,55,102,14.85,0.148,0.124,0.094
157401,1996,1366,749,617,339,105,234,31.24,0.312,0.248,0.17
157447,1996,1487,823,664,71,16,55,6.68,0.067,0.048,0.024
157535,1996,211,144,67,34,11,23,15.97,0.16,0.161,0.164
157951,1996,2257,1234,1023,471,164,307,24.88,0.249,0.209,0.16
158477,1996,190,103,87,74,29,45,43.69,0.437,0.389,0.333
159009,1996,1091,574,517,90,27,63,10.98,0.11,0.082,0.052
159391,1996,3992,2169,1823,867,264,603,27.8,0.278,0.217,0.145
159647,1996,1279,618,661,330,133,197,31.88,0.319,0.258,0.201
159717,1996,1357,750,607,105,24,81,10.8,0.108,0.077,0.04
159966,1996,1008,603,405,54,13,41,6.8,0.068,0.054,0.032
160038,1996,1480,891,589,22,5,17,1.91,0.019,0.015,0.008
160612,1996,2337,1273,1064,107,33,74,5.81,0.058,0.046,0.031
160621,1996,1910,1041,869,129,24,105,10.09,0.101,0.068,0.028
160658,1996,2674,1461,1213,161,41,120,8.21,0.082,0.06,0.034
161004,1996,443,223,220,369,175,194,87,0.87,0.833,0.795
161226,1996,477,332,145,147,32,115,34.64,0.346,0.308,0.221
161235,1996,84,49,35,9,1,8,16.33,0.163,0.107,0.029
161244,1996,143,86,57,9,3,6,6.98,0.07,0.063,0.053
161253,1996,1264,549,715,340,156,184,33.52,0.335,0.269,0.218
161554,1996,683,383,300,56,17,39,10.18,0.102,0.082,0.057
162007,1996,301,169,132,41,9,32,18.93,0.189,0.136,0.068
162210,1996,154,79,75,20,6,14,17.72,0.177,0.13,0.08
162283,1996,513,357,156,33,11,22,6.16,0.062,0.064,0.071
162584,1996,975,482,493,195,70,125,25.93,0.259,0.2,0.142
162654,1996,268,188,80,165,38,127,67.55,0.675,0.616,0.475
162760,1996,129,128,1,73,0,73,57.03,0.57,0.566,0
162928,1996,1018,408,610,826,483,343,84.07,0.841,0.811,0.792
163046,1996,812,443,369,592,245,347,78.33,0.783,0.729,0.664
163268,1996,1005,505,500,280,106,174,34.46,0.345,0.279,0.212
163286,1996,3539,1720,1819,1449,585,864,50.23,0.502,0.409,0.322
163453,1996,917,546,371,162,27,135,24.73,0.247,0.177,0.073
163462,1996,367,207,160,214,80,134,64.73,0.647,0.583,0.5
163851,1996,689,393,296,311,98,213,54.2,0.542,0.451,0.331
163912,1996,312,180,132,221,93,128,71.11,0.711,0.708,0.705
164076,1996,1851,1127,724,513,127,386,34.25,0.342,0.277,0.175
164173,1996,286,205,81,89,20,69,33.66,0.337,0.311,0.247
164216,1996,312,198,114,203,67,136,68.69,0.687,0.651,0.588
164270,1996,385,199,186,236,100,136,68.34,0.683,0.613,0.538
164447,1996,253,133,120,79,30,49,36.84,0.368,0.312,0.25
164492,1996,112,69,43,53,24,29,42.03,0.42,0.473,0.558
164562,1996,431,266,165,296,112,184,69.17,0.692,0.687,0.679
165015,1996,761,393,368,608,275,333,84.73,0.847,0.799,0.747
165024,1996,1155,697,458,222,52,170,24.39,0.244,0.192,0.114
165334,1996,527,301,226,336,128,208,69.1,0.691,0.638,0.566
165662,1996,547,318,229,358,161,197,61.95,0.62,0.654,0.703
165671,1996,86,86,0,45,0,45,52.33,0.523,0.523,NA
165820,1996,436,265,171,95,19,76,28.68,0.287,0.218,0.111
165866,1996,644,429,215,127,26,101,23.54,0.235,0.197,0.121
165936,1996,326,210,116,152,41,111,52.86,0.529,0.466,0.353
166027,1996,1611,721,890,1390,754,636,88.21,0.882,0.863,0.847
166124,1996,688,349,339,611,287,324,92.84,0.928,0.888,0.847
166513,1996,1022,428,594,228,96,132,30.84,0.308,0.223,0.162
166629,1996,4073,1964,2109,1577,660,917,46.69,0.467,0.387,0.313
166638,1996,538,274,264,55,14,41,14.96,0.15,0.102,0.053
166683,1996,1065,446,619,875,498,377,84.53,0.845,0.822,0.805
167288,1996,311,176,135,101,35,66,37.5,0.375,0.325,0.259
167987,1996,825,429,396,240,71,169,39.39,0.394,0.291,0.179
167996,1996,551,310,241,419,169,250,80.65,0.807,0.76,0.701
168005,1996,507,288,219,140,46,94,32.64,0.326,0.276,0.21
168148,1996,1179,597,582,950,452,498,83.42,0.834,0.806,0.777
168254,1996,478,174,304,173,104,69,39.66,0.397,0.362,0.342
168281,1996,445,315,130,295,82,213,67.62,0.676,0.663,0.631
168342,1996,553,276,277,507,248,259,93.84,0.938,0.917,0.895
168546,1996,433,227,206,278,120,158,69.6,0.696,0.642,0.583
168786,1996,283,177,106,92,28,64,36.16,0.362,0.325,0.264
169080,1996,960,565,395,545,209,336,59.47,0.595,0.568,0.529
169798,1996,2298,1371,927,225,77,148,10.8,0.108,0.098,0.083
169910,1996,1831,731,1100,48,28,20,2.74,0.027,0.026,0.025
170082,1996,2039,1200,839,356,112,244,20.33,0.203,0.175,0.133
170301,1996,695,415,280,474,166,308,74.22,0.742,0.682,0.593
170532,1996,360,202,158,239,108,131,64.85,0.648,0.664,0.684
170639,1996,540,247,293,63,27,36,14.57,0.146,0.117,0.092
170976,1996,5328,2710,2618,3399,1533,1866,68.86,0.689,0.638,0.586
171100,1996,6708,3728,2980,2358,809,1549,41.55,0.416,0.352,0.271
171128,1996,1068,260,808,298,199,99,38.08,0.381,0.279,0.246
171137,1996,666,321,345,67,23,44,13.71,0.137,0.101,0.067
171146,1996,551,352,199,53,15,38,10.8,0.108,0.096,0.075
171599,1996,241,93,148,45,21,24,25.81,0.258,0.187,0.142
172051,1996,747,425,322,33,8,25,5.88,0.059,0.044,0.025
172699,1996,3121,1801,1320,557,177,380,21.1,0.211,0.178,0.134
173160,1996,468,284,184,292,103,189,66.55,0.665,0.624,0.56
173258,1996,471,256,215,387,164,223,87.11,0.871,0.822,0.763
173328,1996,161,82,79,53,25,28,34.15,0.341,0.329,0.316
173647,1996,633,375,258,504,202,302,80.53,0.805,0.796,0.783
173902,1996,491,293,198,377,151,226,77.13,0.771,0.768,0.763
174066,1996,4057,2049,2008,1050,451,599,29.23,0.292,0.259,0.225
174233,1996,1736,886,850,411,156,255,28.78,0.288,0.237,0.184
174251,1996,522,310,212,223,71,152,49.03,0.49,0.427,0.335
174491,1996,358,223,135,140,36,104,46.64,0.466,0.391,0.267
174792,1996,426,0,426,296,296,0,NA,NA,0.695,0.695
174844,1996,771,448,323,565,228,337,75.22,0.752,0.733,0.706
174899,1996,295,229,66,145,36,109,47.6,0.476,0.492,0.545
174914,1996,991,540,451,519,204,315,58.33,0.583,0.524,0.452
175342,1996,621,384,237,175,44,131,34.11,0.341,0.282,0.186
175421,1996,84,42,42,21,11,10,23.81,0.238,0.25,0.262
175616,1996,449,278,171,94,27,67,24.1,0.241,0.209,0.158
175856,1996,906,508,398,140,33,107,21.06,0.211,0.155,0.083
175980,1996,292,163,129,166,64,102,62.58,0.626,0.568,0.496
176017,1996,1736,909,827,580,199,381,41.91,0.419,0.334,0.241
176035,1996,291,248,43,58,2,56,22.58,0.226,0.199,0.047
176044,1996,367,170,197,59,26,33,19.41,0.194,0.161,0.132
176080,1996,1864,869,995,463,175,288,33.14,0.331,0.248,0.176
176406,1996,211,144,67,68,11,57,39.58,0.396,0.322,0.164
176628,1996,91,56,35,20,5,15,26.79,0.268,0.22,0.143
176947,1996,212,82,130,48,19,29,35.37,0.354,0.226,0.146
176965,1996,1252,655,597,221,77,144,21.98,0.22,0.177,0.129
177418,1996,146,104,42,66,13,53,50.96,0.51,0.452,0.31
178059,1996,185,127,58,100,28,72,56.69,0.567,0.541,0.483
178341,1996,685,373,312,77,25,52,13.94,0.139,0.112,0.08
178387,1996,963,564,399,113,28,85,15.07,0.151,0.117,0.07
178396,1996,3687,2046,1641,1282,462,820,40.08,0.401,0.348,0.282
178402,1996,567,299,268,86,33,53,17.73,0.177,0.152,0.123
178411,1996,777,179,598,121,77,44,24.58,0.246,0.156,0.129
178420,1996,632,351,281,78,20,58,16.52,0.165,0.123,0.071
178615,1996,1480,868,612,592,185,407,46.89,0.469,0.4,0.302
179043,1996,362,196,166,9,3,6,3.06,0.031,0.025,0.018
179159,1996,1047,609,438,577,202,375,61.58,0.616,0.551,0.461
179557,1996,1212,681,531,294,82,212,31.13,0.311,0.243,0.154
179566,1996,2447,1404,1043,433,127,306,21.79,0.218,0.177,0.122
179867,1996,1275,642,633,1006,463,543,84.58,0.846,0.789,0.731
179894,1996,270,139,131,116,50,66,47.48,0.475,0.43,0.382
179946,1996,214,84,130,100,62,38,45.24,0.452,0.467,0.477
180179,1996,520,332,188,79,28,51,15.36,0.154,0.152,0.149
180461,1996,1740,780,960,246,120,126,16.15,0.161,0.141,0.125
180522,1996,218,96,122,24,13,11,11.46,0.115,0.11,0.107
180984,1996,247,133,114,67,27,40,30.08,0.301,0.271,0.237
181002,1996,832,494,338,489,194,295,59.72,0.597,0.588,0.574
181020,1996,276,139,137,146,62,84,60.43,0.604,0.529,0.453
181127,1996,262,140,122,138,51,87,62.14,0.621,0.527,0.418
181215,1996,1279,707,572,174,59,115,16.27,0.163,0.136,0.103
181394,1996,1129,588,541,87,32,55,9.35,0.094,0.077,0.059
181446,1996,383,225,158,202,79,123,54.67,0.547,0.527,0.5
181464,1996,3625,1814,1811,654,248,406,22.38,0.224,0.18,0.137
181534,1996,223,97,126,38,11,27,27.84,0.278,0.17,0.087
181783,1996,690,397,293,147,53,94,23.68,0.237,0.213,0.181
182281,1996,1509,797,712,179,49,130,16.31,0.163,0.119,0.069
182290,1996,1123,605,518,163,46,117,19.34,0.193,0.145,0.089
182634,1996,227,158,69,91,31,60,37.97,0.38,0.401,0.449
182795,1996,438,210,228,181,81,100,47.62,0.476,0.413,0.355
183062,1996,839,499,340,211,68,143,28.66,0.287,0.251,0.2
183080,1996,894,433,461,196,87,109,25.17,0.252,0.219,0.189
183239,1996,549,301,248,397,172,225,74.75,0.748,0.723,0.694
183822,1996,227,150,77,36,6,30,20,0.2,0.159,0.078
183974,1996,86,63,23,21,0,21,33.33,0.333,0.244,0
184348,1996,371,203,168,265,118,147,72.41,0.724,0.714,0.702
184603,1996,915,494,421,187,76,111,22.47,0.225,0.204,0.181
184612,1996,141,92,49,8,3,5,5.43,0.054,0.057,0.061
184782,1996,1132,609,523,414,173,241,39.57,0.396,0.366,0.331
185129,1996,531,283,248,32,10,22,7.77,0.078,0.06,0.04
185572,1996,799,411,388,261,99,162,39.42,0.394,0.327,0.255
185590,1996,1194,706,488,243,64,179,25.35,0.254,0.204,0.131
185828,1996,599,116,483,60,39,21,18.1,0.181,0.1,0.081
186131,1996,1123,525,598,1032,540,492,93.71,0.937,0.919,0.903
186201,1996,413,240,173,101,29,72,30,0.3,0.245,0.168
186283,1996,678,394,284,311,113,198,50.25,0.503,0.459,0.398
186584,1996,968,547,421,349,112,237,43.33,0.433,0.361,0.266
186876,1996,705,404,301,278,110,168,41.58,0.416,0.394,0.365
187134,1996,1009,675,334,648,187,461,68.3,0.683,0.642,0.56
187444,1996,918,523,395,148,41,107,20.46,0.205,0.161,0.104
187985,1996,1600,875,725,217,67,150,17.14,0.171,0.136,0.092
188030,1996,1510,807,703,188,51,137,16.98,0.17,0.125,0.073
188429,1996,316,204,112,128,40,88,43.14,0.431,0.405,0.357
188641,1996,330,166,164,178,76,102,61.45,0.615,0.539,0.463
190044,1996,664,176,488,349,253,96,54.55,0.545,0.526,0.518
190099,1996,718,351,367,592,282,310,88.32,0.883,0.825,0.768
190150,1996,1260,576,684,1041,542,499,86.63,0.866,0.826,0.792
190248,1996,94,43,51,19,7,12,27.91,0.279,0.202,0.137
190415,1996,2001,870,1131,1570,872,698,80.23,0.802,0.785,0.771
190512,1996,1365,797,568,196,82,114,14.3,0.143,0.144,0.144
190549,1996,1211,739,472,183,49,134,18.13,0.181,0.151,0.104
190558,1996,1434,727,707,32,9,23,3.16,0.032,0.022,0.013
190567,1996,768,352,416,28,14,14,3.98,0.04,0.036,0.034
190594,1996,1456,1008,448,127,28,99,9.82,0.098,0.087,0.062
190637,1996,605,422,183,45,8,37,8.77,0.088,0.074,0.044
190664,1996,1040,621,419,225,56,169,27.21,0.272,0.216,0.134
190691,1996,543,368,175,47,16,31,8.42,0.084,0.087,0.091
190725,1996,372,259,113,69,11,58,22.39,0.224,0.185,0.097
191241,1996,1206,694,512,822,338,484,69.74,0.697,0.682,0.66
191515,1996,497,239,258,392,196,196,82.01,0.82,0.789,0.76
191533,1996,482,257,225,228,93,135,52.53,0.525,0.473,0.413
191630,1996,530,267,263,356,161,195,73.03,0.73,0.672,0.612
191649,1996,1735,996,739,653,217,436,43.78,0.438,0.376,0.294
191676,1996,288,194,94,164,47,117,60.31,0.603,0.569,0.5
191931,1996,662,320,342,260,100,160,50,0.5,0.393,0.292
191968,1996,1426,820,606,908,355,553,67.44,0.674,0.637,0.586
192192,1996,234,168,66,61,17,44,26.19,0.262,0.261,0.258
192323,1996,434,255,179,305,115,190,74.51,0.745,0.703,0.642
192439,1996,956,654,302,51,17,34,5.2,0.052,0.053,0.056
192703,1996,557,258,299,313,143,170,65.89,0.659,0.562,0.478
192749,1996,271,181,90,117,33,84,46.41,0.464,0.432,0.367
192819,1996,839,482,357,510,187,323,67.01,0.67,0.608,0.524
192925,1996,81,58,23,6,2,4,6.9,0.069,0.074,0.087
193016,1996,551,336,215,62,12,50,14.88,0.149,0.113,0.056
193292,1996,183,125,58,21,5,16,12.8,0.128,0.115,0.086
193353,1996,266,199,67,105,20,85,42.71,0.427,0.395,0.299
193399,1996,208,162,46,111,26,85,52.47,0.525,0.534,0.565
193584,1996,337,242,95,208,55,153,63.22,0.632,0.617,0.579
193645,1996,931,787,144,129,13,116,14.74,0.147,0.139,0.09
193654,1996,401,272,129,132,27,105,38.6,0.386,0.329,0.209
193900,1996,3393,2002,1391,1838,770,1068,53.35,0.533,0.542,0.554
193973,1996,552,314,238,253,107,146,46.5,0.465,0.458,0.45
194161,1996,208,129,79,69,23,46,35.66,0.357,0.332,0.291
194310,1996,1388,788,600,487,180,307,38.96,0.39,0.351,0.3
194824,1996,898,225,673,454,318,136,60.44,0.604,0.506,0.473
195003,1996,1725,571,1154,690,419,271,47.46,0.475,0.4,0.363
195030,1996,1011,501,510,719,336,383,76.45,0.765,0.711,0.659
195164,1996,590,311,279,327,153,174,55.95,0.559,0.554,0.548
195173,1996,305,181,124,93,35,58,32.04,0.32,0.305,0.282
195216,1996,592,281,311,388,209,179,63.7,0.637,0.655,0.672
195234,1996,319,226,93,146,30,116,51.33,0.513,0.458,0.323
195243,1996,238,142,96,65,16,49,34.51,0.345,0.273,0.167
195304,1996,294,219,75,193,47,146,66.67,0.667,0.656,0.627
195474,1996,558,325,233,354,137,217,66.77,0.668,0.634,0.588
195526,1996,702,424,278,501,196,305,71.93,0.719,0.714,0.705
195544,1996,97,76,21,59,8,51,67.11,0.671,0.608,0.381
195809,1996,2157,1146,1011,629,229,400,34.9,0.349,0.292,0.227
196413,1996,2652,1429,1223,1722,735,987,69.07,0.691,0.649,0.601
196592,1996,2337,1646,691,73,40,33,2,0.02,0.031,0.058
197045,1996,338,223,115,126,34,92,41.26,0.413,0.373,0.296
197133,1996,614,375,239,499,191,308,82.13,0.821,0.813,0.799
197869,1996,2026,1111,915,689,226,463,41.67,0.417,0.34,0.247
197984,1996,181,93,88,62,30,32,34.41,0.344,0.343,0.341
198385,1996,439,230,209,385,181,204,88.7,0.887,0.877,0.866
198464,1996,2626,1581,1045,673,216,457,28.91,0.289,0.256,0.207
198507,1996,380,205,175,130,44,86,41.95,0.42,0.342,0.251
198516,1996,941,569,372,551,204,347,60.98,0.61,0.586,0.548
198835,1996,232,135,97,96,32,64,47.41,0.474,0.414,0.33
198969,1996,320,100,220,55,30,25,25,0.25,0.172,0.136
199102,1996,1313,692,621,300,90,210,30.35,0.304,0.228,0.145
199111,1996,450,275,175,139,42,97,35.27,0.353,0.309,0.24
199120,1996,3270,2065,1205,2185,718,1467,71.04,0.71,0.668,0.596
199139,1996,1682,952,730,359,113,246,25.84,0.258,0.213,0.155
199148,1996,1552,1075,477,390,77,313,29.12,0.291,0.251,0.161
199157,1996,681,441,240,179,38,141,31.97,0.32,0.263,0.158
199193,1996,3630,1457,2173,968,442,526,36.1,0.361,0.267,0.203
199218,1996,1619,990,629,602,196,406,41.01,0.41,0.372,0.312
199281,1996,450,211,239,80,30,50,23.7,0.237,0.178,0.126
199306,1996,120,54,66,26,12,14,25.93,0.259,0.217,0.182
199412,1996,155,116,39,80,14,66,56.9,0.569,0.516,0.359
199582,1996,408,228,180,46,21,25,10.96,0.11,0.113,0.117
199643,1996,374,232,142,67,17,50,21.55,0.216,0.179,0.12
199847,1996,934,500,434,707,297,410,82,0.82,0.757,0.684
199962,1996,331,137,194,101,43,58,42.34,0.423,0.305,0.222
199999,1996,480,351,129,95,19,76,21.65,0.216,0.198,0.147
200004,1996,1177,560,617,260,87,173,30.89,0.309,0.221,0.141
200059,1996,397,193,204,24,9,15,7.77,0.078,0.06,0.044
200156,1996,288,159,129,90,25,65,40.88,0.409,0.312,0.194
200217,1996,440,266,174,117,36,81,30.45,0.304,0.266,0.207
200226,1996,148,79,69,22,7,15,18.99,0.19,0.149,0.101
200253,1996,457,304,153,35,10,25,8.22,0.082,0.077,0.065
200280,1996,1365,630,735,194,92,102,16.19,0.162,0.142,0.125
200332,1996,1295,543,752,169,83,86,15.84,0.158,0.131,0.11
200572,1996,178,99,79,38,15,23,23.23,0.232,0.213,0.19
201104,1996,432,240,192,150,47,103,42.92,0.429,0.347,0.245
201371,1996,183,115,68,97,38,59,51.3,0.513,0.53,0.559
201548,1996,468,285,183,275,90,185,64.91,0.649,0.588,0.492
201645,1996,738,284,454,387,202,185,65.14,0.651,0.524,0.445
201690,1996,330,161,169,28,12,16,9.94,0.099,0.085,0.071
202134,1996,845,443,402,80,25,55,12.42,0.124,0.095,0.062
202480,1996,1553,845,708,890,310,580,68.64,0.686,0.573,0.438
202523,1996,642,305,337,464,229,235,77.05,0.77,0.723,0.68
202763,1996,553,302,251,210,83,127,42.05,0.42,0.38,0.331
203085,1996,303,141,162,141,68,73,51.77,0.518,0.465,0.42
203128,1996,232,129,103,144,60,84,65.12,0.651,0.621,0.583
203368,1996,775,425,350,483,201,282,66.35,0.663,0.623,0.574
203517,1996,2600,1516,1084,448,150,298,19.66,0.197,0.172,0.138
203535,1996,423,238,185,338,147,191,80.25,0.802,0.799,0.795
203580,1996,61,44,17,32,10,22,50,0.5,0.525,0.588
203775,1996,400,234,166,141,41,100,42.74,0.427,0.352,0.247
203845,1996,271,111,160,110,50,60,54.05,0.54,0.406,0.312
204024,1996,3342,1935,1407,2180,798,1382,71.42,0.714,0.652,0.567
204185,1996,483,217,266,254,113,141,64.98,0.65,0.526,0.425
204194,1996,407,252,155,154,43,111,44.05,0.44,0.378,0.277
204617,1996,180,113,67,52,11,41,36.28,0.363,0.289,0.164
204796,1996,6027,3018,3009,1526,565,961,31.84,0.318,0.253,0.188
204857,1996,3123,1832,1291,1390,446,944,51.53,0.515,0.445,0.345
206330,1996,235,94,141,31,12,19,20.21,0.202,0.132,0.085
206589,1996,516,255,261,302,136,166,65.1,0.651,0.585,0.521
206604,1996,1859,995,864,281,78,203,20.4,0.204,0.151,0.09
206622,1996,778,461,317,458,184,274,59.44,0.594,0.589,0.58
206695,1996,1685,859,826,212,88,124,14.44,0.144,0.126,0.107
206914,1996,616,353,263,63,25,38,10.76,0.108,0.102,0.095
207209,1996,518,259,259,33,8,25,9.65,0.096,0.064,0.031
207306,1996,234,110,124,22,11,11,10,0.1,0.094,0.089
207324,1996,464,234,230,106,41,65,27.78,0.278,0.228,0.178
207388,1996,2336,1223,1113,488,155,333,27.23,0.272,0.209,0.139
207500,1996,2605,1264,1341,525,200,325,25.71,0.257,0.202,0.149
207722,1996,261,138,123,26,11,15,10.87,0.109,0.1,0.089
207847,1996,579,266,313,78,41,37,13.91,0.139,0.135,0.131
207865,1996,737,386,351,92,34,58,15.03,0.15,0.125,0.097
208822,1996,386,250,136,200,71,129,51.6,0.516,0.518,0.522
209056,1996,443,262,181,249,91,158,60.31,0.603,0.562,0.503
209065,1996,445,238,207,272,109,163,68.49,0.685,0.611,0.527
209542,1996,1833,883,950,492,181,311,35.22,0.352,0.268,0.191
209551,1996,2580,1444,1136,958,349,609,42.17,0.422,0.371,0.307
209612,1996,268,179,89,117,36,81,45.25,0.452,0.437,0.404
209807,1996,726,351,375,97,34,63,17.95,0.18,0.134,0.091
209922,1996,357,200,157,159,59,100,50,0.5,0.445,0.376
210146,1996,701,388,313,111,48,63,16.24,0.162,0.158,0.153
210401,1996,419,241,178,304,115,189,78.42,0.784,0.726,0.646
210429,1996,742,448,294,107,33,74,16.52,0.165,0.144,0.112
210571,1996,354,190,164,215,77,138,72.63,0.726,0.607,0.47
210669,1996,523,311,212,346,125,221,71.06,0.711,0.662,0.59
210775,1996,143,73,70,44,16,28,38.36,0.384,0.308,0.229
211088,1996,292,219,73,131,29,102,46.58,0.466,0.449,0.397
211158,1996,1556,994,562,567,147,420,42.25,0.422,0.364,0.262
211291,1996,895,440,455,761,365,396,90,0.9,0.85,0.802
211352,1996,247,186,61,114,23,91,48.92,0.489,0.462,0.377
211361,1996,805,398,407,140,47,93,23.37,0.234,0.174,0.115
211431,1996,148,145,3,65,0,65,44.83,0.448,0.439,0
211440,1996,1386,472,914,903,563,340,72.03,0.72,0.652,0.616
211468,1996,329,328,1,189,0,189,57.62,0.576,0.574,0
211556,1996,102,102,0,60,0,60,58.82,0.588,0.588,NA
211583,1996,77,77,0,46,0,46,59.74,0.597,0.597,NA
211608,1996,236,124,112,16,2,14,11.29,0.113,0.068,0.018
211644,1996,1215,711,504,284,79,205,28.83,0.288,0.234,0.157
211981,1996,385,177,208,149,67,82,46.33,0.463,0.387,0.322
212009,1996,491,264,227,371,168,203,76.89,0.769,0.756,0.74
212054,1996,1348,476,872,172,76,96,20.17,0.202,0.128,0.087
212106,1996,1196,690,506,558,204,354,51.3,0.513,0.467,0.403
212115,1996,872,499,373,198,50,148,29.66,0.297,0.227,0.134
212133,1996,245,168,77,138,34,104,61.9,0.619,0.563,0.442
212160,1996,1250,707,543,214,69,145,20.51,0.205,0.171,0.127
212197,1996,429,295,134,263,73,190,64.41,0.644,0.613,0.545
212577,1996,522,272,250,408,175,233,85.66,0.857,0.782,0.7
212601,1996,504,305,199,229,72,157,51.48,0.515,0.454,0.362
212832,1996,44,32,12,16,3,13,40.62,0.406,0.364,0.25
212911,1996,313,172,141,267,116,151,87.79,0.878,0.853,0.823
213020,1996,2617,1493,1124,613,163,450,30.14,0.301,0.234,0.145
213251,1996,349,182,167,237,100,137,75.27,0.753,0.679,0.599
213321,1996,432,236,196,284,116,168,71.19,0.712,0.657,0.592
213349,1996,1440,883,557,245,56,189,21.4,0.214,0.17,0.101
213358,1996,152,106,46,57,19,38,35.85,0.359,0.375,0.413
213367,1996,648,355,293,362,146,216,60.85,0.609,0.559,0.498
213385,1996,572,281,291,460,215,245,87.19,0.872,0.804,0.739
213507,1996,287,172,115,165,53,112,65.12,0.651,0.575,0.461
213543,1996,1101,409,692,768,433,335,81.91,0.819,0.698,0.626
213613,1996,780,419,361,179,62,117,27.92,0.279,0.229,0.172
213668,1996,386,186,200,226,102,124,66.67,0.667,0.585,0.51
213783,1996,590,316,274,154,57,97,30.7,0.307,0.261,0.208
213826,1996,251,191,60,103,18,85,44.5,0.445,0.41,0.3
213996,1996,672,407,265,448,168,280,68.8,0.688,0.667,0.634
214041,1996,979,587,392,327,121,206,35.09,0.351,0.334,0.309
214069,1996,251,186,65,59,16,43,23.12,0.231,0.235,0.246
214157,1996,284,138,146,194,90,104,75.36,0.754,0.683,0.616
214175,1996,532,307,225,414,161,253,82.41,0.824,0.778,0.716
214272,1996,114,82,32,41,11,30,36.59,0.366,0.36,0.344
214777,1996,4701,2344,2357,2052,837,1215,51.83,0.518,0.437,0.355
215062,1996,2307,1169,1138,1976,924,1052,89.99,0.9,0.857,0.812
215743,1996,346,205,141,95,24,71,34.63,0.346,0.275,0.17
215798,1996,271,136,135,168,76,92,67.65,0.677,0.62,0.563
215929,1996,948,550,398,623,254,369,67.09,0.671,0.657,0.638
216010,1996,1272,674,598,455,168,287,42.58,0.426,0.358,0.281
216038,1996,1197,677,520,247,85,162,23.93,0.239,0.206,0.163
216287,1996,412,217,195,354,167,187,86.18,0.862,0.859,0.856
216339,1996,2155,1284,871,442,138,304,23.68,0.237,0.205,0.158
216524,1996,327,180,147,244,105,139,77.22,0.772,0.746,0.714
216694,1996,305,134,171,138,59,79,58.96,0.59,0.452,0.345
216764,1996,1454,943,511,376,88,288,30.54,0.305,0.259,0.172
216807,1996,304,176,128,208,78,130,73.86,0.739,0.684,0.609
216852,1996,462,217,245,172,73,99,45.62,0.456,0.372,0.298
216931,1996,448,181,267,154,83,71,39.23,0.392,0.344,0.311
217059,1996,805,443,362,319,122,197,44.47,0.445,0.396,0.337
217156,1996,1469,810,659,1220,536,684,84.44,0.844,0.83,0.813
217402,1996,938,556,382,786,310,476,85.61,0.856,0.838,0.812
217536,1996,393,271,122,209,61,148,54.61,0.546,0.532,0.5
217776,1996,73,36,37,19,8,11,30.56,0.306,0.26,0.216
217819,1996,1867,1236,631,624,149,475,38.43,0.384,0.334,0.236
217882,1996,2538,1234,1304,945,327,618,50.08,0.501,0.372,0.251
217998,1996,134,82,52,89,34,55,67.07,0.671,0.664,0.654
218061,1996,636,365,271,119,39,80,21.92,0.219,0.187,0.144
218229,1996,437,273,164,134,40,94,34.43,0.344,0.307,0.244
218238,1996,87,38,49,16,5,11,28.95,0.29,0.184,0.102
218399,1996,246,145,101,45,11,34,23.45,0.234,0.183,0.109
218414,1996,234,103,131,91,36,55,53.4,0.534,0.389,0.275
218663,1996,2635,1518,1117,857,289,568,37.42,0.374,0.325,0.259
218724,1996,823,408,415,120,44,76,18.63,0.186,0.146,0.106
218733,1996,801,452,349,159,24,135,29.87,0.299,0.199,0.069
218742,1996,438,284,154,75,12,63,22.18,0.222,0.171,0.078
218973,1996,291,132,159,204,106,98,74.24,0.742,0.701,0.667
219000,1996,383,244,139,190,55,135,55.33,0.553,0.496,0.396
219046,1996,452,260,192,58,15,43,16.54,0.165,0.128,0.078
219082,1996,189,100,89,25,5,20,20,0.2,0.132,0.056
219198,1996,117,77,40,42,11,31,40.26,0.403,0.359,0.275
219259,1996,560,324,236,68,24,44,13.58,0.136,0.121,0.102
219356,1996,1481,733,748,303,129,174,23.74,0.237,0.205,0.172
219471,1996,875,489,386,175,62,113,23.11,0.231,0.2,0.161
219602,1996,777,498,279,156,38,118,23.69,0.237,0.201,0.136
219709,1996,418,262,156,185,66,119,45.42,0.454,0.443,0.423
219718,1996,180,82,98,24,6,18,21.95,0.22,0.133,0.061
219949,1996,154,78,76,37,10,27,34.62,0.346,0.24,0.132
220075,1996,1532,894,638,186,62,124,13.87,0.139,0.121,0.097
220215,1996,314,194,120,107,30,77,39.69,0.397,0.341,0.25
220613,1996,525,304,221,128,45,83,27.3,0.273,0.244,0.204
220631,1996,212,134,78,58,23,35,26.12,0.261,0.274,0.295
220710,1996,259,134,125,134,54,80,59.7,0.597,0.517,0.432
221351,1996,375,196,179,264,128,136,69.39,0.694,0.704,0.715
221519,1996,365,205,160,264,115,149,72.68,0.727,0.723,0.719
221731,1996,145,98,47,2,0,2,2.04,0.02,0.014,0
221847,1996,1130,497,633,134,39,95,19.11,0.191,0.119,0.062
221892,1996,189,108,81,37,9,28,25.93,0.259,0.196,0.111
222178,1996,898,478,420,241,97,144,30.13,0.301,0.268,0.231
222983,1996,344,181,163,254,106,148,81.77,0.818,0.738,0.65
223232,1996,2463,1444,1019,1062,350,712,49.31,0.493,0.431,0.343
224004,1996,121,74,47,42,12,30,40.54,0.405,0.347,0.255
224323,1996,251,157,94,141,46,95,60.51,0.605,0.562,0.489
225432,1996,638,385,253,13,5,8,2.08,0.021,0.02,0.02
225548,1996,335,151,184,83,27,56,37.09,0.371,0.248,0.147
225627,1996,404,288,116,46,6,40,13.89,0.139,0.114,0.052
226231,1996,163,35,128,26,19,7,20,0.2,0.16,0.148
226833,1996,602,312,290,52,17,35,11.22,0.112,0.086,0.059
227216,1996,2268,1304,964,256,70,186,14.26,0.143,0.113,0.073
227331,1996,355,257,98,66,12,54,21.01,0.21,0.186,0.122
227526,1996,1166,568,598,133,48,85,14.96,0.15,0.114,0.08
227757,1996,668,314,354,499,240,259,82.48,0.825,0.747,0.678
227845,1996,373,239,134,107,35,72,30.13,0.301,0.287,0.261
227863,1996,222,136,86,55,19,36,26.47,0.265,0.248,0.221
228042,1996,180,112,68,34,10,24,21.43,0.214,0.189,0.147
228149,1996,507,312,195,177,56,121,38.78,0.388,0.349,0.287
228246,1996,1217,663,554,687,270,417,62.9,0.629,0.565,0.487
228343,1996,310,198,112,179,60,119,60.1,0.601,0.577,0.536
228431,1996,2007,1188,819,332,71,261,21.97,0.22,0.165,0.087
228459,1996,2396,1472,924,408,88,320,21.74,0.217,0.17,0.095
228501,1996,355,135,220,22,8,14,10.37,0.104,0.062,0.036
228529,1996,919,455,464,117,35,82,18.02,0.18,0.127,0.075
228705,1996,916,406,510,55,22,33,8.13,0.081,0.06,0.043
228723,1996,6326,3218,3108,1931,625,1306,40.58,0.406,0.305,0.201
228769,1996,1208,617,591,235,90,145,23.5,0.235,0.195,0.152
228778,1996,6281,3087,3194,2420,985,1435,46.49,0.465,0.385,0.308
228787,1996,451,199,252,138,59,79,39.7,0.397,0.306,0.234
228796,1996,1393,728,665,38,13,25,3.43,0.034,0.027,0.02
228875,1996,1238,735,503,502,181,321,43.67,0.437,0.405,0.36
228981,1996,210,132,78,79,23,56,42.42,0.424,0.376,0.295
229018,1996,108,58,50,10,6,4,6.9,0.069,0.093,0.12
229027,1996,1679,852,827,93,39,54,6.34,0.063,0.055,0.047
229115,1996,3632,1860,1772,746,252,494,26.56,0.266,0.205,0.142
229780,1996,228,134,94,41,10,31,23.13,0.231,0.18,0.106
229814,1996,849,411,438,167,69,98,23.84,0.238,0.197,0.158
230603,1996,626,443,183,69,19,50,11.29,0.113,0.11,0.104
230728,1996,967,685,282,267,41,226,32.99,0.33,0.276,0.145
230764,1996,1800,1019,781,436,155,281,27.58,0.276,0.242,0.198
230782,1996,1237,833,404,136,25,111,13.33,0.133,0.11,0.062
231059,1996,486,284,202,335,138,197,69.37,0.694,0.689,0.683
231174,1996,1779,971,808,915,374,541,55.72,0.557,0.514,0.463
231420,1996,149,81,68,42,20,22,27.16,0.272,0.282,0.294
231554,1996,109,56,53,39,20,19,33.93,0.339,0.358,0.377
231624,1996,1328,789,539,1053,381,672,85.17,0.852,0.793,0.707
231712,1996,517,304,213,65,16,49,16.12,0.161,0.126,0.075
232025,1996,256,121,135,123,52,71,58.68,0.587,0.48,0.385
232043,1996,228,143,85,90,26,64,44.76,0.448,0.395,0.306
232089,1996,309,111,198,59,24,35,31.53,0.315,0.191,0.121
232186,1996,1875,1040,835,480,150,330,31.73,0.317,0.256,0.18
232265,1996,917,591,326,358,70,288,48.73,0.487,0.39,0.215
232423,1996,3258,1878,1380,1958,704,1254,66.77,0.668,0.601,0.51
232557,1996,1253,635,618,253,91,162,25.51,0.255,0.202,0.147
232566,1996,657,447,210,242,53,189,42.28,0.423,0.368,0.252
232609,1996,287,169,118,151,51,100,59.17,0.592,0.526,0.432
232681,1996,729,504,225,450,112,338,67.06,0.671,0.617,0.498
232706,1996,212,145,67,102,27,75,51.72,0.517,0.481,0.403
232937,1996,1329,809,520,124,34,90,11.12,0.111,0.093,0.065
232982,1996,1478,803,675,210,60,150,18.68,0.187,0.142,0.089
233277,1996,1419,867,552,476,141,335,38.64,0.386,0.335,0.255
233374,1996,793,399,394,610,284,326,81.7,0.817,0.769,0.721
233426,1996,437,278,159,263,84,179,64.39,0.644,0.602,0.528
233541,1996,251,149,102,59,14,45,30.2,0.302,0.235,0.137
233897,1996,247,132,115,69,31,38,28.79,0.288,0.279,0.27
233921,1996,5057,2061,2996,2120,970,1150,55.8,0.558,0.419,0.324
234030,1996,1875,1146,729,352,103,249,21.73,0.217,0.188,0.141
234085,1996,339,0,339,170,170,0,NA,NA,0.501,0.501
234155,1996,782,465,317,186,47,139,29.89,0.299,0.238,0.148
234164,1996,380,211,169,75,16,59,27.96,0.28,0.197,0.095
235097,1996,639,399,240,114,29,85,21.3,0.213,0.178,0.121
235167,1996,530,308,222,200,74,126,40.91,0.409,0.377,0.333
236230,1996,610,359,251,284,97,187,52.09,0.521,0.466,0.386
236328,1996,740,445,295,459,171,288,64.72,0.647,0.62,0.58
236577,1996,465,323,142,173,52,121,37.46,0.375,0.372,0.366
236595,1996,576,358,218,245,78,167,46.65,0.466,0.425,0.358
236896,1996,292,144,148,40,18,22,15.28,0.153,0.137,0.122
236939,1996,2272,1169,1103,694,263,431,36.87,0.369,0.305,0.238
236948,1996,3789,1964,1825,1613,648,965,49.13,0.491,0.426,0.355
237011,1996,2026,1177,849,507,176,331,28.12,0.281,0.25,0.207
237057,1996,355,207,148,274,111,163,78.74,0.787,0.772,0.75
237066,1996,315,193,122,177,56,121,62.69,0.627,0.562,0.459
237215,1996,384,207,177,4,1,3,1.45,0.014,0.01,0.006
237330,1996,582,301,281,107,34,73,24.25,0.242,0.184,0.121
237358,1996,120,66,54,27,16,11,16.67,0.167,0.225,0.296
237367,1996,1049,570,479,119,43,76,13.33,0.133,0.113,0.09
237792,1996,617,363,254,97,24,73,20.11,0.201,0.157,0.094
237899,1996,529,254,275,28,10,18,7.09,0.071,0.053,0.036
237932,1996,464,250,214,77,20,57,22.8,0.228,0.166,0.093
237969,1996,377,204,173,161,57,104,50.98,0.51,0.427,0.329
238032,1996,3065,1499,1566,817,335,482,32.15,0.322,0.267,0.214
238333,1996,284,147,137,175,76,99,67.35,0.673,0.616,0.555
238430,1996,253,174,79,40,16,24,13.79,0.138,0.158,0.203
238458,1996,450,295,155,214,67,147,49.83,0.498,0.476,0.432
238476,1996,401,210,191,215,87,128,60.95,0.61,0.536,0.455
238616,1996,254,138,116,117,44,73,52.9,0.529,0.461,0.379
238661,1996,210,152,58,40,4,36,23.68,0.237,0.19,0.069
239080,1996,199,126,73,53,21,32,25.4,0.254,0.266,0.288
239105,1996,1420,799,621,803,303,500,62.58,0.626,0.565,0.488
239628,1996,169,97,72,81,28,53,54.64,0.546,0.479,0.389
239716,1996,508,321,187,339,121,218,67.91,0.679,0.667,0.647
240107,1996,284,195,89,70,10,60,30.77,0.308,0.246,0.112
240189,1996,1825,995,830,369,137,232,23.32,0.233,0.202,0.165
240277,1996,939,581,358,138,48,90,15.49,0.155,0.147,0.134
240329,1996,1721,1074,647,393,109,284,26.44,0.264,0.228,0.168
240338,1996,101,71,30,55,12,43,60.56,0.606,0.545,0.4
240365,1996,1501,855,646,227,65,162,18.95,0.19,0.151,0.101
240374,1996,606,354,252,49,14,35,9.89,0.099,0.081,0.056
240417,1996,1275,644,631,194,61,133,20.65,0.206,0.152,0.097
240426,1996,308,158,150,42,13,29,18.35,0.184,0.136,0.087
240444,1996,5394,2954,2440,2090,769,1321,44.72,0.447,0.387,0.315
240453,1996,2033,1113,920,233,88,145,13.03,0.13,0.115,0.096
240462,1996,933,300,633,120,59,61,20.33,0.203,0.129,0.093
240471,1996,1149,688,461,249,82,167,24.27,0.243,0.217,0.178
240480,1996,1555,806,749,301,97,204,25.31,0.253,0.194,0.13
240727,1996,1203,628,575,297,101,196,31.21,0.312,0.247,0.176
243443,1996,780,483,297,46,11,35,7.25,0.072,0.059,0.037
243780,1996,6339,2713,3626,1843,903,940,34.65,0.346,0.291,0.249
100654,1997,789,412,377,159,41,118,28.64,0.286,0.202,0.109
100663,1997,1115,657,458,161,52,109,16.59,0.166,0.144,0.114
100751,1997,2572,1403,1169,859,307,552,39.34,0.393,0.334,0.263
100858,1997,3140,1676,1464,1165,385,780,46.54,0.465,0.371,0.263
101435,1997,191,114,77,89,28,61,53.51,0.535,0.466,0.364
101480,1997,764,401,363,123,43,80,19.95,0.2,0.161,0.118
101675,1997,374,169,205,3,2,1,0.59,0.006,0.008,0.01
101879,1997,751,448,303,111,20,91,20.31,0.203,0.148,0.066
102049,1997,745,470,275,405,139,266,56.6,0.566,0.544,0.505
102094,1997,1132,663,469,138,38,100,15.08,0.151,0.122,0.081
102234,1997,254,144,110,118,55,63,43.75,0.438,0.465,0.5
102368,1997,803,474,329,307,109,198,41.77,0.418,0.382,0.331
102377,1997,713,466,247,179,29,150,32.19,0.322,0.251,0.117
104151,1997,4938,2646,2292,1284,448,836,31.59,0.316,0.26,0.195
104179,1997,4431,2409,2022,1294,463,831,34.5,0.345,0.292,0.229
105330,1997,1983,1169,814,530,154,376,32.16,0.322,0.267,0.189
106245,1997,841,503,338,46,13,33,6.56,0.066,0.055,0.038
106342,1997,125,63,62,54,19,35,55.56,0.556,0.432,0.306
106397,1997,2125,1077,1048,515,191,324,30.08,0.301,0.242,0.182
106412,1997,608,297,311,51,12,39,13.13,0.131,0.084,0.039
106458,1997,1687,922,765,249,89,160,17.35,0.174,0.148,0.116
106467,1997,725,376,349,83,32,51,13.56,0.136,0.114,0.092
106485,1997,620,342,278,47,8,39,11.4,0.114,0.076,0.029
106704,1997,1598,1031,567,284,55,229,22.21,0.222,0.178,0.097
107044,1997,863,495,368,271,85,186,37.58,0.376,0.314,0.231
107080,1997,329,193,136,184,76,108,55.96,0.56,0.559,0.559
107141,1997,225,121,104,83,37,46,38.02,0.38,0.369,0.356
107512,1997,404,230,174,164,59,105,45.65,0.456,0.406,0.339
107558,1997,155,66,89,44,21,23,34.85,0.349,0.284,0.236
110097,1997,437,296,141,204,60,144,48.65,0.486,0.467,0.426
110404,1997,217,64,153,169,119,50,78.12,0.781,0.779,0.778
110422,1997,2114,951,1163,318,108,210,22.08,0.221,0.15,0.093
110486,1997,467,288,179,49,15,34,11.81,0.118,0.105,0.084
110495,1997,409,270,139,84,19,65,24.07,0.241,0.205,0.137
110510,1997,890,559,331,83,26,57,10.2,0.102,0.093,0.079
110529,1997,1856,810,1046,157,56,101,12.47,0.125,0.085,0.054
110538,1997,1618,948,670,246,45,201,21.2,0.212,0.152,0.067
110547,1997,512,363,149,17,2,15,4.13,0.041,0.033,0.013
110556,1997,1510,901,609,180,69,111,12.32,0.123,0.119,0.113
110565,1997,2192,1317,875,215,48,167,12.68,0.127,0.098,0.055
110574,1997,711,451,260,94,26,68,15.08,0.151,0.132,0.1
110583,1997,2498,1597,901,205,60,145,9.08,0.091,0.082,0.067
110592,1997,1274,828,446,82,17,65,7.85,0.078,0.064,0.038
110617,1997,1350,777,573,95,31,64,8.24,0.082,0.07,0.054
113698,1997,74,55,19,24,5,19,34.55,0.346,0.324,0.263
115755,1997,718,401,317,85,14,71,17.71,0.177,0.118,0.044
119173,1997,258,258,0,82,0,82,31.78,0.318,0.318,NA
120184,1997,129,79,50,38,15,23,29.11,0.291,0.295,0.3
121309,1997,494,306,188,187,64,123,40.2,0.402,0.379,0.34
121345,1997,393,195,198,338,166,172,88.21,0.882,0.86,0.838
122409,1997,3008,1766,1242,280,73,207,11.72,0.117,0.093,0.059
122436,1997,1036,630,406,589,194,395,62.7,0.627,0.569,0.478
122597,1997,1732,1086,646,115,36,79,7.27,0.073,0.066,0.056
122612,1997,600,385,215,285,96,189,49.09,0.491,0.475,0.447
122931,1997,1004,543,461,766,328,438,80.66,0.807,0.763,0.711
123554,1997,596,348,248,390,144,246,70.69,0.707,0.654,0.581
123572,1997,872,581,291,192,43,149,25.65,0.256,0.22,0.148
126562,1997,439,245,194,63,23,40,16.33,0.163,0.144,0.119
126580,1997,519,298,221,83,27,56,18.79,0.188,0.16,0.122
126614,1997,4259,2157,2102,1565,633,932,43.21,0.432,0.367,0.301
126818,1997,2615,1435,1180,861,304,557,38.82,0.388,0.329,0.258
127060,1997,689,354,335,387,173,214,60.45,0.605,0.562,0.516
127185,1997,1056,450,606,97,39,58,12.89,0.129,0.092,0.064
127565,1997,1478,787,691,69,19,50,6.35,0.064,0.047,0.027
127741,1997,1905,1147,758,490,107,383,33.39,0.334,0.257,0.141
128106,1997,580,299,281,49,20,29,9.7,0.097,0.084,0.071
128744,1997,187,93,94,58,24,34,36.56,0.366,0.31,0.255
128771,1997,1213,626,587,82,36,46,7.35,0.074,0.068,0.061
129020,1997,2172,1181,991,977,340,637,53.94,0.539,0.45,0.343
129242,1997,876,462,414,649,286,363,78.57,0.786,0.741,0.691
129941,1997,324,130,194,87,46,41,31.54,0.315,0.269,0.237
130253,1997,632,377,255,297,113,184,48.81,0.488,0.47,0.443
130314,1997,174,174,0,87,0,87,50,0.5,0.5,NA
130493,1997,1089,624,465,146,39,107,17.15,0.171,0.134,0.084
130590,1997,500,220,280,386,205,181,82.27,0.823,0.772,0.732
130697,1997,700,371,329,583,263,320,86.25,0.863,0.833,0.799
130776,1997,668,303,365,90,35,55,18.15,0.182,0.135,0.096
130794,1997,1307,662,645,1170,552,618,93.35,0.933,0.895,0.856
130934,1997,637,359,278,121,35,86,23.96,0.24,0.19,0.126
130943,1997,3179,1881,1298,1823,622,1201,63.85,0.639,0.573,0.479
131159,1997,1056,665,391,678,239,439,66.02,0.66,0.642,0.611
131283,1997,567,313,254,337,148,189,60.38,0.604,0.594,0.583
131450,1997,211,116,95,10,3,7,6.03,0.06,0.047,0.032
131469,1997,1716,972,744,1185,485,700,72.02,0.72,0.691,0.652
131496,1997,1394,757,637,1247,561,686,90.62,0.906,0.895,0.881
131520,1997,1098,715,383,402,98,304,42.52,0.425,0.366,0.256
132471,1997,176,112,64,58,18,40,35.71,0.357,0.33,0.281
132602,1997,749,388,361,77,25,52,13.4,0.134,0.103,0.069
132903,1997,2839,1510,1329,785,265,520,34.44,0.344,0.277,0.199
133492,1997,386,230,156,230,88,142,61.74,0.617,0.596,0.564
133553,1997,1020,136,884,213,184,29,21.32,0.213,0.209,0.208
133650,1997,1947,1148,799,328,84,244,21.25,0.212,0.168,0.105
133669,1997,1174,669,505,161,54,107,15.99,0.16,0.137,0.107
133711,1997,424,272,152,176,55,121,44.49,0.445,0.415,0.362
133881,1997,367,112,255,128,84,44,39.29,0.393,0.349,0.329
133951,1997,1987,1144,843,352,91,261,22.81,0.228,0.177,0.108
134079,1997,428,270,158,196,67,129,47.78,0.478,0.458,0.424
134097,1997,4491,2525,1966,1822,606,1216,48.16,0.482,0.406,0.308
134130,1997,5959,3307,2652,2950,1073,1877,56.76,0.568,0.495,0.405
134945,1997,290,125,165,65,19,46,36.8,0.368,0.224,0.115
135726,1997,1814,960,854,962,421,541,56.35,0.564,0.53,0.493
136172,1997,1105,646,459,269,77,192,29.72,0.297,0.243,0.168
136950,1997,415,253,162,192,65,127,50.2,0.502,0.463,0.401
137546,1997,504,289,215,283,104,179,61.94,0.619,0.562,0.484
138354,1997,620,372,248,101,28,73,19.62,0.196,0.163,0.113
138716,1997,575,359,216,35,9,26,7.24,0.072,0.061,0.042
138789,1997,690,470,220,50,7,43,9.15,0.092,0.072,0.032
139144,1997,504,332,172,295,99,196,59.04,0.59,0.585,0.576
139366,1997,612,354,258,53,14,39,11.02,0.11,0.087,0.054
139393,1997,197,112,85,89,31,58,51.79,0.518,0.452,0.365
139658,1997,1477,762,715,1120,525,595,78.08,0.781,0.758,0.734
139719,1997,502,270,232,75,19,56,20.74,0.207,0.149,0.082
139755,1997,2069,565,1504,487,305,182,32.21,0.322,0.235,0.203
139764,1997,449,283,166,85,29,56,19.79,0.198,0.189,0.175
139861,1997,818,528,290,130,31,99,18.75,0.188,0.159,0.107
139931,1997,2596,1387,1209,306,81,225,16.22,0.162,0.118,0.067
139940,1997,1906,1172,734,211,60,151,12.88,0.129,0.111,0.082
139959,1997,4348,2544,1804,1729,569,1160,45.6,0.456,0.398,0.315
140447,1997,679,428,251,215,70,145,33.88,0.339,0.317,0.279
140960,1997,455,240,215,19,4,15,6.25,0.062,0.042,0.019
140988,1997,242,162,80,90,26,64,39.51,0.395,0.372,0.325
141185,1997,263,157,106,79,29,50,31.85,0.318,0.3,0.274
141264,1997,1594,947,647,179,50,129,13.62,0.136,0.112,0.077
141334,1997,1208,718,490,135,29,106,14.76,0.148,0.112,0.059
141486,1997,146,105,41,30,9,21,20,0.2,0.205,0.22
141565,1997,335,202,133,36,11,25,12.38,0.124,0.107,0.083
141574,1997,1439,807,632,174,50,124,15.37,0.154,0.121,0.079
142276,1997,1400,793,607,44,11,33,4.16,0.042,0.031,0.018
142285,1997,1360,687,673,240,82,158,23,0.23,0.176,0.122
142461,1997,277,148,129,91,37,54,36.49,0.365,0.329,0.287
143084,1997,564,328,236,400,146,254,77.44,0.774,0.709,0.619
143288,1997,155,81,74,39,11,28,34.57,0.346,0.252,0.149
144005,1997,487,332,155,6,1,5,1.51,0.015,0.012,0.006
144281,1997,1078,519,559,147,61,86,16.57,0.166,0.136,0.109
144740,1997,1211,713,498,566,212,354,49.65,0.496,0.467,0.426
144892,1997,1552,950,602,479,121,358,37.68,0.377,0.309,0.201
144962,1997,289,155,134,2,1,1,0.65,0.007,0.007,0.007
144971,1997,141,50,91,54,25,29,58,0.58,0.383,0.275
145600,1997,2820,1560,1260,460,165,295,18.91,0.189,0.163,0.131
145619,1997,300,129,171,117,56,61,47.29,0.473,0.39,0.327
145637,1997,5789,2865,2924,3331,1523,1808,63.11,0.631,0.575,0.521
145691,1997,242,148,94,102,30,72,48.65,0.486,0.421,0.319
145813,1997,3253,1981,1272,1016,297,719,36.29,0.363,0.312,0.233
146481,1997,337,191,146,205,77,128,67.02,0.67,0.608,0.527
146612,1997,386,176,210,145,70,75,42.61,0.426,0.376,0.333
146719,1997,1189,758,431,558,189,369,48.68,0.487,0.469,0.439
146825,1997,127,49,78,47,24,23,46.94,0.469,0.37,0.308
147013,1997,242,131,111,98,35,63,48.09,0.481,0.405,0.315
147244,1997,569,302,267,286,112,174,57.62,0.576,0.503,0.419
147341,1997,272,176,96,150,48,102,57.95,0.58,0.551,0.5
147703,1997,2673,1444,1229,691,252,439,30.4,0.304,0.259,0.205
147767,1997,1889,959,930,1578,743,835,87.07,0.871,0.835,0.799
147776,1997,1007,630,377,25,9,16,2.54,0.025,0.025,0.024
147828,1997,426,229,197,170,53,117,51.09,0.511,0.399,0.269
148131,1997,224,116,108,77,26,51,43.97,0.44,0.344,0.241
148496,1997,199,140,59,99,28,71,50.71,0.507,0.497,0.475
148584,1997,134,82,52,48,13,35,42.68,0.427,0.358,0.25
148627,1997,270,180,90,82,21,61,33.89,0.339,0.304,0.233
149222,1997,2400,1051,1349,451,188,263,25.02,0.25,0.188,0.139
149231,1997,1219,734,485,242,65,177,24.11,0.241,0.199,0.134
149772,1997,1602,833,769,450,180,270,32.41,0.324,0.281,0.234
149781,1997,546,290,256,418,189,229,78.97,0.79,0.766,0.738
150066,1997,451,266,185,172,54,118,44.36,0.444,0.381,0.292
150136,1997,4047,2177,1870,837,242,595,27.33,0.273,0.207,0.129
150145,1997,223,144,79,97,33,64,44.44,0.444,0.435,0.418
150163,1997,699,458,241,369,120,249,54.37,0.544,0.528,0.498
150400,1997,673,363,310,493,228,265,73,0.73,0.733,0.735
150534,1997,719,424,295,312,108,204,48.11,0.481,0.434,0.366
150668,1997,209,116,93,89,32,57,49.14,0.491,0.426,0.344
150941,1997,197,129,68,95,21,74,57.36,0.574,0.482,0.309
151102,1997,1196,659,537,49,7,42,6.37,0.064,0.041,0.013
151111,1997,2154,1198,956,113,55,58,4.84,0.048,0.052,0.058
151306,1997,1839,1053,786,239,63,176,16.71,0.167,0.13,0.08
151324,1997,1878,998,880,356,127,229,22.95,0.23,0.19,0.144
151333,1997,306,204,102,17,5,12,5.88,0.059,0.056,0.049
151342,1997,629,384,245,47,20,27,7.03,0.07,0.075,0.082
151351,1997,6036,3497,2539,2827,1045,1782,50.96,0.51,0.468,0.412
151360,1997,508,340,168,21,7,14,4.12,0.041,0.041,0.042
151379,1997,641,376,265,57,12,45,11.97,0.12,0.089,0.045
151388,1997,278,193,85,14,7,7,3.63,0.036,0.05,0.082
151777,1997,288,135,153,122,47,75,55.56,0.556,0.424,0.307
151786,1997,255,156,99,73,21,52,33.33,0.333,0.286,0.212
152080,1997,1904,875,1029,1675,879,796,90.97,0.91,0.88,0.854
152248,1997,1071,556,515,101,49,52,9.35,0.094,0.094,0.095
152363,1997,267,138,129,112,46,66,47.83,0.478,0.419,0.357
152530,1997,486,262,224,321,143,178,67.94,0.679,0.66,0.638
152600,1997,702,382,320,416,163,253,66.23,0.662,0.593,0.509
153001,1997,385,185,200,169,70,99,53.51,0.535,0.439,0.35
153108,1997,306,178,128,183,67,116,65.17,0.652,0.598,0.523
153269,1997,636,368,268,389,141,248,67.39,0.674,0.612,0.526
153384,1997,413,234,179,330,140,190,81.2,0.812,0.799,0.782
153603,1997,4007,1790,2217,1081,437,644,35.98,0.36,0.27,0.197
153834,1997,629,385,244,431,161,270,70.13,0.701,0.685,0.66
154095,1997,1920,1192,728,553,169,384,32.21,0.322,0.288,0.232
155089,1997,179,99,80,39,11,28,28.28,0.283,0.218,0.138
155317,1997,3808,1989,1819,1093,424,669,33.63,0.336,0.287,0.233
155335,1997,89,50,39,22,10,12,24,0.24,0.247,0.256
155399,1997,2906,1382,1524,640,232,408,29.52,0.295,0.22,0.152
155520,1997,256,140,116,107,38,69,49.29,0.493,0.418,0.328
155627,1997,149,39,110,39,23,16,41.03,0.41,0.262,0.209
155937,1997,140,56,84,45,21,24,42.86,0.429,0.321,0.25
156213,1997,365,223,142,179,66,113,50.67,0.507,0.49,0.465
156286,1997,318,178,140,155,62,93,52.25,0.522,0.487,0.443
156295,1997,404,239,165,118,36,82,34.31,0.343,0.292,0.218
156365,1997,342,182,160,93,32,61,33.52,0.335,0.272,0.2
156541,1997,418,227,191,87,30,57,25.11,0.251,0.208,0.157
156745,1997,394,239,155,208,59,149,62.34,0.623,0.528,0.381
157058,1997,302,172,130,33,5,28,16.28,0.163,0.109,0.038
157076,1997,203,131,72,84,27,57,43.51,0.435,0.414,0.375
157085,1997,2740,1499,1241,743,281,462,30.82,0.308,0.271,0.226
157289,1997,1931,1024,907,241,86,155,15.14,0.151,0.125,0.095
157386,1997,1227,674,553,160,55,105,15.58,0.156,0.13,0.099
157401,1997,1206,691,515,184,51,133,19.25,0.192,0.153,0.099
157447,1997,1657,949,708,84,21,63,6.64,0.066,0.051,0.03
157535,1997,178,110,68,25,8,17,15.45,0.154,0.14,0.118
157951,1997,2205,1244,961,445,148,297,23.87,0.239,0.202,0.154
158477,1997,226,116,110,88,28,60,51.72,0.517,0.389,0.255
159009,1997,799,408,391,52,25,27,6.62,0.066,0.065,0.064
159391,1997,4443,2533,1910,959,319,640,25.27,0.253,0.216,0.167
159647,1997,1428,714,714,361,133,228,31.93,0.319,0.253,0.186
159717,1997,1447,779,668,116,27,89,11.42,0.114,0.08,0.04
159966,1997,1075,646,429,81,14,67,10.37,0.104,0.075,0.033
160038,1997,1415,878,537,129,35,94,10.71,0.107,0.091,0.065
160612,1997,2487,1371,1116,107,24,83,6.05,0.06,0.043,0.022
160621,1997,1853,997,856,106,28,78,7.82,0.078,0.057,0.033
160658,1997,2764,1543,1221,169,44,125,8.1,0.081,0.061,0.036
161004,1997,473,246,227,384,175,209,84.96,0.85,0.812,0.771
161226,1997,466,308,158,148,28,120,38.96,0.39,0.318,0.177
161235,1997,77,47,30,5,0,5,10.64,0.106,0.065,0
161244,1997,121,63,58,9,3,6,9.52,0.095,0.074,0.052
161253,1997,1091,513,578,327,144,183,35.67,0.357,0.3,0.249
161554,1997,760,450,310,90,31,59,13.11,0.131,0.118,0.1
162007,1997,357,190,167,44,8,36,18.95,0.19,0.123,0.048
162210,1997,164,99,65,34,11,23,23.23,0.232,0.207,0.169
162283,1997,382,268,114,17,3,14,5.22,0.052,0.045,0.026
162584,1997,865,444,421,210,71,139,31.31,0.313,0.243,0.169
162654,1997,335,255,80,212,49,163,63.92,0.639,0.633,0.613
162760,1997,162,158,4,109,3,106,67.09,0.671,0.673,0.75
162928,1997,941,411,530,749,411,338,82.24,0.822,0.796,0.775
163046,1997,833,478,355,650,258,392,82.01,0.82,0.78,0.727
163268,1997,1135,605,530,343,133,210,34.71,0.347,0.302,0.251
163286,1997,3950,1873,2077,1699,731,968,51.68,0.517,0.43,0.352
163453,1997,1016,588,428,176,30,146,24.83,0.248,0.173,0.07
163462,1997,325,179,146,221,95,126,70.39,0.704,0.68,0.651
163851,1997,886,515,371,418,133,285,55.34,0.553,0.472,0.358
163912,1997,345,194,151,232,92,140,72.16,0.722,0.672,0.609
164076,1997,1808,1079,729,557,166,391,36.24,0.362,0.308,0.228
164173,1997,367,259,108,122,21,101,39,0.39,0.332,0.194
164216,1997,290,162,128,182,79,103,63.58,0.636,0.628,0.617
164270,1997,427,241,186,274,98,176,73.03,0.73,0.642,0.527
164447,1997,253,133,120,79,30,49,36.84,0.368,0.312,0.25
164492,1997,135,90,45,54,19,35,38.89,0.389,0.4,0.422
164562,1997,582,365,217,386,137,249,68.22,0.682,0.663,0.631
165015,1997,794,470,324,633,250,383,81.49,0.815,0.797,0.772
165024,1997,1147,672,475,206,46,160,23.81,0.238,0.18,0.097
165334,1997,520,313,207,313,110,203,64.86,0.649,0.602,0.531
165662,1997,547,333,214,343,130,213,63.96,0.64,0.627,0.607
165671,1997,112,112,0,59,0,59,52.68,0.527,0.527,NA
165820,1997,488,270,218,104,29,75,27.78,0.278,0.213,0.133
165866,1997,590,397,193,120,25,95,23.93,0.239,0.203,0.13
165936,1997,406,279,127,206,68,138,49.46,0.495,0.507,0.535
166027,1997,1642,782,860,1436,744,692,88.49,0.885,0.875,0.865
166124,1997,726,409,317,635,270,365,89.24,0.892,0.875,0.852
166513,1997,989,367,622,232,104,128,34.88,0.349,0.235,0.167
166629,1997,3831,2012,1819,1635,614,1021,50.75,0.508,0.427,0.338
166638,1997,533,284,249,65,25,40,14.08,0.141,0.122,0.1
166683,1997,1066,405,661,861,521,340,83.95,0.84,0.808,0.788
167288,1997,274,152,122,89,30,59,38.82,0.388,0.325,0.246
167987,1997,835,440,395,217,72,145,32.95,0.33,0.26,0.182
167996,1997,530,287,243,429,185,244,85.02,0.85,0.809,0.761
168005,1997,525,299,226,198,70,128,42.81,0.428,0.377,0.31
168148,1997,1270,659,611,1063,498,565,85.74,0.857,0.837,0.815
168254,1997,526,220,306,210,98,112,50.91,0.509,0.399,0.32
168281,1997,438,277,161,298,97,201,72.56,0.726,0.68,0.602
168342,1997,544,266,278,499,253,246,92.48,0.925,0.917,0.91
168546,1997,474,260,214,301,114,187,71.92,0.719,0.635,0.533
168786,1997,329,204,125,79,30,49,24.02,0.24,0.24,0.24
169080,1997,1053,614,439,595,243,352,57.33,0.573,0.565,0.554
169798,1997,2314,1372,942,260,80,180,13.12,0.131,0.112,0.085
169910,1997,1906,763,1143,46,21,25,3.28,0.033,0.024,0.018
170082,1997,2406,1494,912,410,120,290,19.41,0.194,0.17,0.132
170301,1997,721,432,289,450,164,286,66.2,0.662,0.624,0.567
170532,1997,290,170,120,201,78,123,72.35,0.723,0.693,0.65
170639,1997,522,239,283,71,34,37,15.48,0.155,0.136,0.12
170976,1997,5535,2763,2772,3619,1656,1963,71.05,0.711,0.654,0.597
171100,1997,6804,3723,3081,2232,751,1481,39.78,0.398,0.328,0.244
171128,1997,1251,295,956,329,224,105,35.59,0.356,0.263,0.234
171137,1997,696,378,318,96,29,67,17.72,0.177,0.138,0.091
171146,1997,552,337,215,30,10,20,5.93,0.059,0.054,0.047
171599,1997,228,73,155,2,0,2,2.74,0.027,0.009,0
172051,1997,818,461,357,55,12,43,9.33,0.093,0.067,0.034
172699,1997,3213,1835,1378,592,211,381,20.76,0.208,0.184,0.153
173160,1997,447,281,166,279,98,181,64.41,0.644,0.624,0.59
173258,1997,484,255,229,412,195,217,85.1,0.851,0.851,0.852
173328,1997,222,132,90,86,32,54,40.91,0.409,0.387,0.356
173647,1997,625,353,272,438,174,264,74.79,0.748,0.701,0.64
173902,1997,450,251,199,339,140,199,79.28,0.793,0.753,0.704
174066,1997,4371,2282,2089,1208,467,741,32.47,0.325,0.276,0.224
174233,1997,1679,843,836,363,140,223,26.45,0.264,0.216,0.167
174251,1997,461,271,190,161,53,108,39.85,0.398,0.349,0.279
174491,1997,372,231,141,162,61,101,43.72,0.437,0.435,0.433
174792,1997,450,0,450,335,335,0,NA,NA,0.744,0.744
174844,1997,722,416,306,539,227,312,75,0.75,0.747,0.742
174899,1997,244,180,64,141,32,109,60.56,0.606,0.578,0.5
174914,1997,955,514,441,595,237,358,69.65,0.697,0.623,0.537
175342,1997,532,299,233,138,42,96,32.11,0.321,0.259,0.18
175421,1997,86,42,44,28,11,17,40.48,0.405,0.326,0.25
175616,1997,521,338,183,136,40,96,28.4,0.284,0.261,0.219
175856,1997,808,463,345,124,28,96,20.73,0.207,0.153,0.081
175980,1997,299,159,140,188,84,104,65.41,0.654,0.629,0.6
176017,1997,1770,948,822,578,209,369,38.92,0.389,0.327,0.254
176035,1997,231,193,38,71,6,65,33.68,0.337,0.307,0.158
176044,1997,343,198,145,73,23,50,25.25,0.252,0.213,0.159
176080,1997,2016,965,1051,462,162,300,31.09,0.311,0.229,0.154
176406,1997,206,146,60,66,11,55,37.67,0.377,0.32,0.183
176628,1997,96,57,39,29,6,23,40.35,0.404,0.302,0.154
176947,1997,233,115,118,72,25,47,40.87,0.409,0.309,0.212
176965,1997,1323,718,605,298,88,210,29.25,0.292,0.225,0.145
177418,1997,171,124,47,50,10,40,32.26,0.323,0.292,0.213
178059,1997,223,173,50,114,26,88,50.87,0.509,0.511,0.52
178341,1997,675,368,307,61,19,42,11.41,0.114,0.09,0.062
178387,1997,985,572,413,135,42,93,16.26,0.163,0.137,0.102
178396,1997,3512,1935,1577,1290,461,829,42.84,0.428,0.367,0.292
178402,1997,588,321,267,79,27,52,16.2,0.162,0.134,0.101
178411,1997,692,168,524,99,76,23,13.69,0.137,0.143,0.145
178420,1997,458,242,216,60,12,48,19.83,0.198,0.131,0.056
178615,1997,1654,1020,634,593,175,418,40.98,0.41,0.359,0.276
179043,1997,319,175,144,181,78,103,58.86,0.589,0.567,0.542
179159,1997,1084,609,475,601,246,355,58.29,0.583,0.554,0.518
179557,1997,1124,713,411,248,65,183,25.67,0.257,0.221,0.158
179566,1997,2704,1543,1161,522,180,342,22.16,0.222,0.193,0.155
179867,1997,1230,646,584,976,424,552,85.45,0.855,0.793,0.726
179894,1997,314,193,121,124,41,83,43.01,0.43,0.395,0.339
179946,1997,190,71,119,78,40,38,53.52,0.535,0.411,0.336
180179,1997,508,334,174,121,28,93,27.84,0.278,0.238,0.161
180461,1997,1819,784,1035,259,116,143,18.24,0.182,0.142,0.112
180522,1997,235,89,146,28,16,12,13.48,0.135,0.119,0.11
180984,1997,277,152,125,64,22,42,27.63,0.276,0.231,0.176
181002,1997,798,457,341,466,184,282,61.71,0.617,0.584,0.54
181020,1997,260,134,126,135,55,80,59.7,0.597,0.519,0.437
181127,1997,282,145,137,145,50,95,65.52,0.655,0.514,0.365
181215,1997,1005,570,435,174,60,114,20,0.2,0.173,0.138
181394,1997,1185,615,570,95,33,62,10.08,0.101,0.08,0.058
181446,1997,437,250,187,205,87,118,47.2,0.472,0.469,0.465
181464,1997,3195,1596,1599,681,259,422,26.44,0.264,0.213,0.162
181534,1997,258,107,151,38,16,22,20.56,0.206,0.147,0.106
181783,1997,707,407,300,161,42,119,29.24,0.292,0.228,0.14
182281,1997,1491,773,718,183,54,129,16.69,0.167,0.123,0.075
182290,1997,1165,654,511,171,54,117,17.89,0.179,0.147,0.106
182634,1997,240,172,68,111,29,82,47.67,0.477,0.462,0.426
182795,1997,489,257,232,178,69,109,42.41,0.424,0.364,0.297
183062,1997,845,501,344,193,71,122,24.35,0.244,0.228,0.206
183080,1997,844,396,448,163,75,88,22.22,0.222,0.193,0.167
183239,1997,508,283,225,350,134,216,76.33,0.763,0.689,0.596
183822,1997,312,213,99,26,8,18,8.45,0.084,0.083,0.081
183974,1997,104,65,39,24,8,16,24.62,0.246,0.231,0.205
184348,1997,418,243,175,294,117,177,72.84,0.728,0.703,0.669
184603,1997,519,265,254,83,27,56,21.13,0.211,0.16,0.106
184612,1997,112,94,18,9,0,9,9.57,0.096,0.08,0
184782,1997,1038,552,486,321,119,202,36.59,0.366,0.309,0.245
185129,1997,455,237,218,34,13,21,8.86,0.089,0.075,0.06
185572,1997,801,432,369,264,87,177,40.97,0.41,0.33,0.236
185590,1997,1148,709,439,230,62,168,23.7,0.237,0.2,0.141
185828,1997,568,105,463,88,73,15,14.29,0.143,0.155,0.158
186131,1997,1129,511,618,1033,562,471,92.17,0.922,0.915,0.909
186201,1997,453,228,225,125,53,72,31.58,0.316,0.276,0.236
186283,1997,751,435,316,340,135,205,47.13,0.471,0.453,0.427
186584,1997,1056,547,509,409,157,252,46.07,0.461,0.387,0.308
186876,1997,700,415,285,283,93,190,45.78,0.458,0.404,0.326
187134,1997,1396,847,549,870,305,565,66.71,0.667,0.623,0.556
187444,1997,1032,563,469,154,51,103,18.29,0.183,0.149,0.109
187985,1997,2047,1132,915,244,71,173,15.28,0.153,0.119,0.078
188030,1997,1694,901,793,201,70,131,14.54,0.145,0.119,0.088
188429,1997,289,174,115,130,49,81,46.55,0.465,0.45,0.426
188641,1997,467,205,262,204,99,105,51.22,0.512,0.437,0.378
190044,1997,612,136,476,378,297,81,59.56,0.596,0.618,0.624
190099,1997,711,364,347,599,276,323,88.74,0.887,0.842,0.795
190150,1997,1271,583,688,1036,547,489,83.88,0.839,0.815,0.795
190248,1997,113,71,42,41,13,28,39.44,0.394,0.363,0.31
190415,1997,2998,1405,1593,2551,1307,1244,88.54,0.885,0.851,0.82
190512,1997,1109,608,501,202,75,127,20.89,0.209,0.182,0.15
190549,1997,1344,774,570,194,75,119,15.37,0.154,0.144,0.132
190558,1997,1418,729,689,32,7,25,3.43,0.034,0.023,0.01
190567,1997,947,464,483,44,17,27,5.82,0.058,0.046,0.035
190594,1997,1630,1137,493,136,26,110,9.67,0.097,0.083,0.053
190637,1997,736,519,217,45,11,34,6.55,0.066,0.061,0.051
190664,1997,1153,675,478,227,65,162,24,0.24,0.197,0.136
190691,1997,500,323,177,38,12,26,8.05,0.08,0.076,0.068
190725,1997,416,313,103,87,22,65,20.77,0.208,0.209,0.214
191241,1997,1459,849,610,1075,445,630,74.2,0.742,0.737,0.73
191515,1997,457,239,218,381,172,209,87.45,0.875,0.834,0.789
191533,1997,388,197,191,209,94,115,58.38,0.584,0.539,0.492
191630,1997,549,284,265,354,174,180,63.38,0.634,0.645,0.657
191649,1997,1743,928,815,648,221,427,46.01,0.46,0.372,0.271
191676,1997,310,198,112,179,65,114,57.58,0.576,0.577,0.58
191931,1997,695,312,383,263,98,165,52.88,0.529,0.378,0.256
191968,1997,1417,801,616,909,362,547,68.29,0.683,0.641,0.588
192192,1997,141,112,29,69,12,57,50.89,0.509,0.489,0.414
192323,1997,453,292,161,299,101,198,67.81,0.678,0.66,0.627
192439,1997,915,595,320,33,13,20,3.36,0.034,0.036,0.041
192703,1997,527,235,292,269,134,135,57.45,0.575,0.51,0.459
192749,1997,294,202,92,148,40,108,53.47,0.535,0.503,0.435
192819,1997,973,532,441,570,232,338,63.53,0.635,0.586,0.526
192925,1997,164,102,62,19,6,13,12.75,0.128,0.116,0.097
193016,1997,1052,692,360,46,16,30,4.34,0.043,0.044,0.044
193292,1997,156,112,44,46,6,40,35.71,0.357,0.295,0.136
193353,1997,260,177,83,121,43,78,44.07,0.441,0.465,0.518
193399,1997,225,168,57,95,18,77,45.83,0.458,0.422,0.316
193584,1997,351,257,94,214,59,155,60.31,0.603,0.61,0.628
193645,1997,758,643,115,165,18,147,22.86,0.229,0.218,0.157
193654,1997,465,308,157,205,56,149,48.38,0.484,0.441,0.357
193900,1997,3557,2054,1503,1963,775,1188,57.84,0.578,0.552,0.516
193973,1997,705,417,288,299,102,197,47.24,0.472,0.424,0.354
194161,1997,208,114,94,46,17,29,25.44,0.254,0.221,0.181
194310,1997,1476,859,617,588,203,385,44.82,0.448,0.398,0.329
194824,1997,1069,267,802,584,414,170,63.67,0.637,0.546,0.516
195003,1997,1836,617,1219,727,446,281,45.54,0.455,0.396,0.366
195030,1997,892,404,488,592,301,291,72.03,0.72,0.664,0.617
195164,1997,542,274,268,309,144,165,60.22,0.602,0.57,0.537
195173,1997,410,253,157,95,26,69,27.27,0.273,0.232,0.166
195216,1997,476,232,244,328,148,180,77.59,0.776,0.689,0.607
195234,1997,311,223,88,146,29,117,52.47,0.525,0.469,0.33
195243,1997,300,179,121,106,34,72,40.22,0.402,0.353,0.281
195304,1997,283,222,61,174,33,141,63.51,0.635,0.615,0.541
195474,1997,583,301,282,400,181,219,72.76,0.728,0.686,0.642
195526,1997,605,372,233,452,175,277,74.46,0.745,0.747,0.751
195544,1997,107,74,33,60,18,42,56.76,0.568,0.561,0.545
195809,1997,2480,1358,1122,789,311,478,35.2,0.352,0.318,0.277
196413,1997,2562,1417,1145,1773,713,1060,74.81,0.748,0.692,0.623
196592,1997,2028,1457,571,85,27,58,3.98,0.04,0.042,0.047
197045,1997,320,216,104,130,44,86,39.81,0.398,0.406,0.423
197133,1997,646,409,237,529,186,343,83.86,0.839,0.819,0.785
197869,1997,2161,1177,984,711,235,476,40.44,0.404,0.329,0.239
197984,1997,159,68,91,61,27,34,50,0.5,0.384,0.297
198385,1997,470,230,240,417,206,211,91.74,0.917,0.887,0.858
198464,1997,2871,1718,1153,705,222,483,28.11,0.281,0.246,0.193
198507,1997,424,251,173,133,33,100,39.84,0.398,0.314,0.191
198516,1997,964,584,380,599,207,392,67.12,0.671,0.621,0.545
198835,1997,306,167,139,119,41,78,46.71,0.467,0.389,0.295
198969,1997,350,107,243,69,41,28,26.17,0.262,0.197,0.169
199102,1997,1383,727,656,363,118,245,33.7,0.337,0.262,0.18
199111,1997,470,264,206,138,49,89,33.71,0.337,0.294,0.238
199120,1997,3412,2118,1294,2371,816,1555,73.42,0.734,0.695,0.631
199139,1997,1904,1077,827,418,155,263,24.42,0.244,0.22,0.187
199148,1997,1577,1091,486,431,90,341,31.26,0.313,0.273,0.185
199157,1997,712,467,245,202,45,157,33.62,0.336,0.284,0.184
199193,1997,3756,1496,2260,961,427,534,35.7,0.357,0.256,0.189
199218,1997,1350,837,513,478,149,329,39.31,0.393,0.354,0.29
199281,1997,480,258,222,98,34,64,24.81,0.248,0.204,0.153
199306,1997,162,59,103,40,21,19,32.2,0.322,0.247,0.204
199412,1997,198,142,56,80,20,60,42.25,0.422,0.404,0.357
199582,1997,400,228,172,60,14,46,20.18,0.202,0.15,0.081
199643,1997,304,173,131,43,12,31,17.92,0.179,0.141,0.092
199847,1997,962,483,479,739,338,401,83.02,0.83,0.768,0.706
199962,1997,296,123,173,103,43,60,48.78,0.488,0.348,0.249
199999,1997,485,329,156,117,27,90,27.36,0.274,0.241,0.173
200004,1997,1224,629,595,310,100,210,33.39,0.334,0.253,0.168
200059,1997,408,233,175,39,15,24,10.3,0.103,0.096,0.086
200156,1997,232,134,98,100,36,64,47.76,0.478,0.431,0.367
200217,1997,381,242,139,131,32,99,40.91,0.409,0.344,0.23
200226,1997,129,73,56,20,6,14,19.18,0.192,0.155,0.107
200253,1997,442,270,172,38,9,29,10.74,0.107,0.086,0.052
200280,1997,1516,742,774,222,94,128,17.25,0.173,0.146,0.121
200332,1997,1199,497,702,194,83,111,22.33,0.223,0.162,0.118
200572,1997,177,100,77,37,8,29,29,0.29,0.209,0.104
201104,1997,531,302,229,220,76,144,47.68,0.477,0.414,0.332
201371,1997,254,149,105,124,37,87,58.39,0.584,0.488,0.352
201548,1997,478,290,188,239,82,157,54.14,0.541,0.5,0.436
201645,1997,736,269,467,408,235,173,64.31,0.643,0.554,0.503
201690,1997,88,47,41,4,0,4,8.51,0.085,0.045,0
202134,1997,924,464,460,89,36,53,11.42,0.114,0.096,0.078
202480,1997,1622,872,750,896,351,545,62.5,0.625,0.552,0.468
202523,1997,593,325,268,438,185,253,77.85,0.778,0.739,0.69
202763,1997,651,390,261,264,75,189,48.46,0.485,0.406,0.287
203085,1997,264,114,150,127,58,69,60.53,0.605,0.481,0.387
203128,1997,240,123,117,136,54,82,66.67,0.667,0.567,0.462
203368,1997,790,408,382,495,217,278,68.14,0.681,0.627,0.568
203517,1997,2573,1524,1049,508,173,335,21.98,0.22,0.197,0.165
203535,1997,441,255,186,349,143,206,80.78,0.808,0.791,0.769
203580,1997,70,47,23,29,13,16,34.04,0.34,0.414,0.565
203775,1997,464,293,171,208,73,135,46.08,0.461,0.448,0.427
203845,1997,331,163,168,157,72,85,52.15,0.521,0.474,0.429
204024,1997,3379,1914,1465,2180,855,1325,69.23,0.692,0.645,0.584
204185,1997,540,297,243,306,113,193,64.98,0.65,0.567,0.465
204194,1997,333,195,138,119,45,74,37.95,0.38,0.357,0.326
204617,1997,180,101,79,65,18,47,46.53,0.465,0.361,0.228
204796,1997,5897,3081,2816,1719,555,1164,37.78,0.378,0.292,0.197
204857,1997,3255,1913,1342,1401,427,974,50.91,0.509,0.43,0.318
206330,1997,96,40,56,12,4,8,20,0.2,0.125,0.071
206589,1997,538,289,249,328,130,198,68.51,0.685,0.61,0.522
206604,1997,2025,1103,922,336,126,210,19.04,0.19,0.166,0.137
206622,1997,757,439,318,512,220,292,66.51,0.665,0.676,0.692
206695,1997,1764,924,840,231,85,146,15.8,0.158,0.131,0.101
206914,1997,615,322,293,50,21,29,9.01,0.09,0.081,0.072
207209,1997,566,304,262,34,3,31,10.2,0.102,0.06,0.011
207306,1997,293,148,145,35,11,24,16.22,0.162,0.119,0.076
207324,1997,453,222,231,73,32,41,18.47,0.185,0.161,0.139
207388,1997,2321,1214,1107,565,194,371,30.56,0.306,0.243,0.175
207500,1997,2895,1523,1372,552,195,357,23.44,0.234,0.191,0.142
207722,1997,222,133,89,32,9,23,17.29,0.173,0.144,0.101
207847,1997,578,314,264,89,33,56,17.83,0.178,0.154,0.125
207865,1997,717,386,331,107,28,79,20.47,0.205,0.149,0.085
208822,1997,345,225,120,212,70,142,63.11,0.631,0.614,0.583
209056,1997,463,272,191,289,121,168,61.76,0.618,0.624,0.634
209065,1997,410,235,175,244,91,153,65.11,0.651,0.595,0.52
209542,1997,1869,860,1009,525,212,313,36.4,0.364,0.281,0.21
209551,1997,2384,1307,1077,856,314,542,41.47,0.415,0.359,0.292
209612,1997,261,175,86,129,39,90,51.43,0.514,0.494,0.453
209807,1997,743,368,375,96,37,59,16.03,0.16,0.129,0.099
209922,1997,315,176,139,146,59,87,49.43,0.494,0.463,0.424
210146,1997,759,426,333,142,47,95,22.3,0.223,0.187,0.141
210401,1997,410,224,186,299,131,168,75,0.75,0.729,0.704
210429,1997,759,481,278,103,35,68,14.14,0.141,0.136,0.126
210571,1997,295,137,158,176,83,93,67.88,0.679,0.597,0.525
210669,1997,541,289,252,328,139,189,65.4,0.654,0.606,0.552
210775,1997,155,95,60,64,26,38,40,0.4,0.413,0.433
211088,1997,260,191,69,142,34,108,56.54,0.565,0.546,0.493
211158,1997,1355,893,462,459,125,334,37.4,0.374,0.339,0.271
211291,1997,898,426,472,752,380,372,87.32,0.873,0.837,0.805
211352,1997,339,231,108,160,39,121,52.38,0.524,0.472,0.361
211361,1997,942,446,496,163,64,99,22.2,0.222,0.173,0.129
211431,1997,142,139,3,50,1,49,35.25,0.352,0.352,0.333
211440,1997,1270,464,806,841,522,319,68.75,0.688,0.662,0.648
211468,1997,195,194,1,122,1,121,62.37,0.624,0.626,1
211556,1997,92,92,0,51,0,51,55.43,0.554,0.554,NA
211583,1997,92,92,0,51,0,51,55.43,0.554,0.554,NA
211608,1997,236,122,114,18,4,14,11.48,0.115,0.076,0.035
211644,1997,1220,751,469,294,84,210,27.96,0.28,0.241,0.179
211981,1997,407,185,222,149,58,91,49.19,0.492,0.366,0.261
212009,1997,563,354,209,429,148,281,79.38,0.794,0.762,0.708
212054,1997,1776,729,1047,231,73,158,21.67,0.217,0.13,0.07
212106,1997,1211,716,495,599,225,374,52.23,0.522,0.495,0.455
212115,1997,886,532,354,166,34,132,24.81,0.248,0.187,0.096
212133,1997,305,211,94,171,40,131,62.09,0.621,0.561,0.426
212160,1997,1251,729,522,234,63,171,23.46,0.235,0.187,0.121
212197,1997,438,298,140,265,74,191,64.09,0.641,0.605,0.529
212577,1997,504,251,253,402,202,200,79.68,0.797,0.798,0.798
212601,1997,533,318,215,244,74,170,53.46,0.535,0.458,0.344
212832,1997,65,54,11,26,4,22,40.74,0.407,0.4,0.364
212911,1997,298,150,148,264,127,137,91.33,0.913,0.886,0.858
213020,1997,2620,1479,1141,618,176,442,29.89,0.299,0.236,0.154
213251,1997,342,186,156,232,89,143,76.88,0.769,0.678,0.571
213321,1997,435,195,240,260,121,139,71.28,0.713,0.598,0.504
213349,1997,1497,837,660,252,72,180,21.51,0.215,0.168,0.109
213358,1997,184,101,83,91,44,47,46.53,0.465,0.495,0.53
213367,1997,834,479,355,476,184,292,60.96,0.61,0.571,0.518
213385,1997,568,263,305,456,230,226,85.93,0.859,0.803,0.754
213507,1997,303,174,129,185,71,114,65.52,0.655,0.611,0.55
213543,1997,1097,442,655,803,444,359,81.22,0.812,0.732,0.678
213613,1997,822,430,392,188,67,121,28.14,0.281,0.229,0.171
213668,1997,379,227,152,214,65,149,65.64,0.656,0.565,0.428
213783,1997,597,329,268,141,53,88,26.75,0.268,0.236,0.198
213826,1997,276,209,67,103,18,85,40.67,0.407,0.373,0.269
213996,1997,689,445,244,445,165,280,62.92,0.629,0.646,0.676
214041,1997,1068,627,441,409,132,277,44.18,0.442,0.383,0.299
214069,1997,240,174,66,162,32,130,74.71,0.747,0.675,0.485
214157,1997,325,190,135,219,86,133,70,0.7,0.674,0.637
214175,1997,493,293,200,352,135,217,74.06,0.741,0.714,0.675
214272,1997,187,126,61,59,15,44,34.92,0.349,0.316,0.246
214777,1997,5185,2686,2499,2497,980,1517,56.48,0.565,0.482,0.392
215062,1997,2324,1132,1192,1928,941,987,87.19,0.872,0.83,0.789
215743,1997,354,200,154,79,22,57,28.5,0.285,0.223,0.143
215798,1997,272,129,143,159,77,82,63.57,0.636,0.585,0.538
215929,1997,905,538,367,644,247,397,73.79,0.738,0.712,0.673
216010,1997,1292,741,551,476,178,298,40.22,0.402,0.368,0.323
216038,1997,1193,684,509,248,76,172,25.15,0.252,0.208,0.149
216287,1997,373,193,180,309,136,173,89.64,0.896,0.828,0.756
216339,1997,2149,1233,916,503,176,327,26.52,0.265,0.234,0.192
216524,1997,314,162,152,236,117,119,73.46,0.735,0.752,0.77
216694,1997,309,123,186,132,72,60,48.78,0.488,0.427,0.387
216764,1997,1581,1025,556,409,93,316,30.83,0.308,0.259,0.167
216807,1997,394,239,155,259,93,166,69.46,0.695,0.657,0.6
216852,1997,391,174,217,145,65,80,45.98,0.46,0.371,0.3
216931,1997,355,168,187,161,72,89,52.98,0.53,0.454,0.385
217059,1997,842,496,346,348,128,220,44.35,0.444,0.413,0.37
217156,1997,1368,722,646,1136,527,609,84.35,0.843,0.83,0.816
217402,1997,974,563,411,801,326,475,84.37,0.844,0.822,0.793
217536,1997,479,318,161,219,55,164,51.57,0.516,0.457,0.342
217776,1997,101,51,50,27,9,18,35.29,0.353,0.267,0.18
217819,1997,1568,1031,537,565,130,435,42.19,0.422,0.36,0.242
217882,1997,2579,1265,1314,997,341,656,51.86,0.519,0.387,0.26
217998,1997,132,78,54,85,31,54,69.23,0.692,0.644,0.574
218061,1997,582,336,246,99,34,65,19.35,0.194,0.17,0.138
218229,1997,434,288,146,94,23,71,24.65,0.246,0.217,0.158
218238,1997,193,92,101,4,3,1,1.09,0.011,0.021,0.03
218399,1997,262,180,82,68,15,53,29.44,0.294,0.26,0.183
218414,1997,161,52,109,41,22,19,36.54,0.365,0.255,0.202
218663,1997,2919,1596,1323,1065,393,672,42.11,0.421,0.365,0.297
218724,1997,826,443,383,121,43,78,17.61,0.176,0.146,0.112
218733,1997,601,320,281,169,52,117,36.56,0.366,0.281,0.185
218742,1997,539,327,212,81,18,63,19.27,0.193,0.15,0.085
218973,1997,296,139,157,210,102,108,77.7,0.777,0.709,0.65
219000,1997,326,209,117,171,53,118,56.46,0.565,0.525,0.453
219046,1997,451,227,224,38,8,30,13.22,0.132,0.084,0.036
219082,1997,249,135,114,1,1,0,0,0,0.004,0.009
219198,1997,129,96,33,47,12,35,36.46,0.365,0.364,0.364
219259,1997,539,321,218,83,22,61,19,0.19,0.154,0.101
219356,1997,1531,741,790,346,130,216,29.15,0.292,0.226,0.165
219471,1997,896,503,393,213,80,133,26.44,0.264,0.238,0.204
219602,1997,788,503,285,144,40,104,20.68,0.207,0.183,0.14
219709,1997,399,248,151,197,67,130,52.42,0.524,0.494,0.444
219718,1997,65,26,39,8,2,6,23.08,0.231,0.123,0.051
219949,1997,186,91,95,42,10,32,35.16,0.352,0.226,0.105
220075,1997,1487,853,634,192,70,122,14.3,0.143,0.129,0.11
220215,1997,294,181,113,100,40,60,33.15,0.332,0.34,0.354
220613,1997,655,379,276,149,50,99,26.12,0.261,0.227,0.181
220631,1997,134,88,46,39,15,24,27.27,0.273,0.291,0.326
220710,1997,245,117,128,99,44,55,47.01,0.47,0.404,0.344
221351,1997,422,239,183,301,128,173,72.38,0.724,0.713,0.699
221519,1997,364,195,169,285,130,155,79.49,0.795,0.783,0.769
221731,1997,96,61,35,35,12,23,37.7,0.377,0.365,0.343
221847,1997,1089,466,623,100,33,67,14.38,0.144,0.092,0.053
221892,1997,179,100,79,30,9,21,21,0.21,0.168,0.114
222178,1997,964,530,434,259,97,162,30.57,0.306,0.269,0.224
222983,1997,317,150,167,215,103,112,74.67,0.747,0.678,0.617
223232,1997,2404,1416,988,967,300,667,47.1,0.471,0.402,0.304
224004,1997,125,57,68,15,7,8,14.04,0.14,0.12,0.103
224323,1997,261,160,101,136,47,89,55.62,0.556,0.521,0.465
225432,1997,679,374,305,14,2,12,3.21,0.032,0.021,0.007
225548,1997,323,112,211,66,32,34,30.36,0.304,0.204,0.152
225627,1997,341,233,108,47,10,37,15.88,0.159,0.138,0.093
226231,1997,209,50,159,65,45,20,40,0.4,0.311,0.283
226833,1997,668,329,339,37,13,24,7.29,0.073,0.055,0.038
227216,1997,2292,1310,982,303,83,220,16.79,0.168,0.132,0.085
227331,1997,372,293,79,59,10,49,16.72,0.167,0.159,0.127
227526,1997,1183,670,513,127,34,93,13.88,0.139,0.107,0.066
227757,1997,703,334,369,516,248,268,80.24,0.802,0.734,0.672
227845,1997,359,216,143,98,38,60,27.78,0.278,0.273,0.266
227863,1997,235,155,80,58,19,39,25.16,0.252,0.247,0.238
228042,1997,194,116,78,40,16,24,20.69,0.207,0.206,0.205
228149,1997,507,311,196,170,50,120,38.59,0.386,0.335,0.255
228246,1997,1247,686,561,702,282,420,61.22,0.612,0.563,0.503
228343,1997,332,177,155,201,85,116,65.54,0.655,0.605,0.548
228431,1997,2360,1422,938,358,71,287,20.18,0.202,0.152,0.076
228459,1997,2331,1399,932,413,107,306,21.87,0.219,0.177,0.115
228501,1997,280,113,167,20,12,8,7.08,0.071,0.071,0.072
228529,1997,595,306,289,98,38,60,19.61,0.196,0.165,0.131
228705,1997,898,402,496,47,15,32,7.96,0.08,0.052,0.03
228723,1997,6169,3158,3011,1953,619,1334,42.24,0.422,0.317,0.206
228769,1997,1270,644,626,250,105,145,22.52,0.225,0.197,0.168
228778,1997,6945,3568,3377,2531,990,1541,43.19,0.432,0.364,0.293
228787,1997,444,183,261,143,77,66,36.07,0.361,0.322,0.295
228796,1997,1482,750,732,36,15,21,2.8,0.028,0.024,0.02
228875,1997,1463,885,578,563,167,396,44.75,0.448,0.385,0.289
228981,1997,312,186,126,118,38,80,43.01,0.43,0.378,0.302
229018,1997,113,60,53,17,2,15,25,0.25,0.15,0.038
229027,1997,1749,938,811,109,30,79,8.42,0.084,0.062,0.037
229115,1997,3221,1625,1596,764,302,462,28.43,0.284,0.237,0.189
229780,1997,241,132,109,58,21,37,28.03,0.28,0.241,0.193
229814,1997,854,414,440,105,33,72,17.39,0.174,0.123,0.075
230603,1997,717,530,187,113,18,95,17.92,0.179,0.158,0.096
230728,1997,1465,1029,436,304,60,244,23.71,0.237,0.208,0.138
230764,1997,1962,1039,923,407,133,274,26.37,0.264,0.207,0.144
230782,1997,1503,978,525,152,37,115,11.76,0.118,0.101,0.07
231059,1997,528,279,249,358,158,200,71.68,0.717,0.678,0.635
231174,1997,1823,1005,818,959,381,578,57.51,0.575,0.526,0.466
231420,1997,160,91,69,43,16,27,29.67,0.297,0.269,0.232
231554,1997,130,64,66,44,19,25,39.06,0.391,0.338,0.288
231624,1997,1327,802,525,1063,381,682,85.04,0.85,0.801,0.726
231712,1997,665,398,267,88,29,59,14.82,0.148,0.132,0.109
232025,1997,197,98,99,92,35,57,58.16,0.582,0.467,0.354
232043,1997,242,138,104,109,44,65,47.1,0.471,0.45,0.423
232089,1997,240,102,138,72,35,37,36.27,0.363,0.3,0.254
232186,1997,1930,1072,858,437,140,297,27.71,0.277,0.226,0.163
232265,1997,1218,765,453,459,119,340,44.44,0.444,0.377,0.263
232423,1997,3059,1791,1268,1855,643,1212,67.67,0.677,0.606,0.507
232557,1997,995,531,464,279,101,178,33.52,0.335,0.28,0.218
232566,1997,728,513,215,303,67,236,46,0.46,0.416,0.312
232609,1997,477,275,202,220,72,148,53.82,0.538,0.461,0.356
232681,1997,808,547,261,479,129,350,63.99,0.64,0.593,0.494
232706,1997,261,190,71,111,28,83,43.68,0.437,0.425,0.394
232937,1997,1132,700,432,104,30,74,10.57,0.106,0.092,0.069
232982,1997,1464,791,673,207,54,153,19.34,0.193,0.141,0.08
233277,1997,1619,1048,571,551,145,406,38.74,0.387,0.34,0.254
233374,1997,750,367,383,548,258,290,79.02,0.79,0.731,0.674
233426,1997,438,248,190,225,70,155,62.5,0.625,0.514,0.368
233541,1997,257,159,98,61,17,44,27.67,0.277,0.237,0.173
233897,1997,303,155,148,80,28,52,33.55,0.335,0.264,0.189
233921,1997,4522,1818,2704,1903,869,1034,56.88,0.569,0.421,0.321
234030,1997,2175,1301,874,337,106,231,17.76,0.178,0.155,0.121
234085,1997,394,20,374,201,188,13,65,0.65,0.51,0.503
234155,1997,865,493,372,170,48,122,24.75,0.248,0.197,0.129
234164,1997,304,155,149,3,1,2,1.29,0.013,0.01,0.007
235097,1997,624,367,257,86,21,65,17.71,0.177,0.138,0.082
235167,1997,494,271,223,186,71,115,42.44,0.424,0.377,0.318
236230,1997,660,394,266,303,87,216,54.82,0.548,0.459,0.327
236328,1997,642,390,252,430,155,275,70.51,0.705,0.67,0.615
236577,1997,584,392,192,233,63,170,43.37,0.434,0.399,0.328
236595,1997,499,288,211,220,78,142,49.31,0.493,0.441,0.37
236896,1997,283,142,141,62,29,33,23.24,0.232,0.219,0.206
236939,1997,2276,1191,1085,657,235,422,35.43,0.354,0.289,0.217
236948,1997,4346,2270,2076,1734,667,1067,47,0.47,0.399,0.321
237011,1997,2068,1266,802,601,176,425,33.57,0.336,0.291,0.219
237057,1997,370,223,147,277,97,180,80.72,0.807,0.749,0.66
237066,1997,398,212,186,226,103,123,58.02,0.58,0.568,0.554
237215,1997,423,237,186,6,0,6,2.53,0.025,0.014,0
237330,1997,726,390,336,121,49,72,18.46,0.185,0.167,0.146
237358,1997,95,54,41,6,3,3,5.56,0.056,0.063,0.073
237367,1997,540,300,240,115,45,70,23.33,0.233,0.213,0.188
237792,1997,643,341,302,111,43,68,19.94,0.199,0.173,0.142
237899,1997,581,288,293,33,13,20,6.94,0.069,0.057,0.044
237932,1997,491,257,234,77,21,56,21.79,0.218,0.157,0.09
237969,1997,480,260,220,201,72,129,49.62,0.496,0.419,0.327
238032,1997,3079,1431,1648,794,344,450,31.45,0.314,0.258,0.209
238333,1997,339,194,145,204,73,131,67.53,0.675,0.602,0.503
238430,1997,226,149,77,55,19,36,24.16,0.242,0.243,0.247
238458,1997,459,287,172,232,65,167,58.19,0.582,0.505,0.378
238476,1997,395,201,194,174,75,99,49.25,0.492,0.441,0.387
238616,1997,253,147,106,128,45,83,56.46,0.565,0.506,0.425
238661,1997,222,164,58,53,11,42,25.61,0.256,0.239,0.19
239080,1997,208,119,89,62,16,46,38.66,0.387,0.298,0.18
239105,1997,1573,830,743,876,351,525,63.25,0.633,0.557,0.472
239628,1997,135,62,73,71,35,36,58.06,0.581,0.526,0.479
239716,1997,480,288,192,324,121,203,70.49,0.705,0.675,0.63
240107,1997,331,240,91,96,18,78,32.5,0.325,0.29,0.198
240189,1997,1881,944,937,349,138,211,22.35,0.224,0.186,0.147
240277,1997,895,568,327,141,39,102,17.96,0.18,0.158,0.119
240329,1997,1700,1042,658,386,108,278,26.68,0.267,0.227,0.164
240338,1997,109,61,48,50,21,29,47.54,0.475,0.459,0.438
240365,1997,1719,994,725,242,69,173,17.4,0.174,0.141,0.095
240374,1997,726,440,286,87,24,63,14.32,0.143,0.12,0.084
240417,1997,1241,604,637,170,47,123,20.36,0.204,0.137,0.074
240426,1997,326,182,144,36,13,23,12.64,0.126,0.11,0.09
240444,1997,5828,3156,2672,2303,835,1468,46.51,0.465,0.395,0.312
240453,1997,2272,1263,1009,327,124,203,16.07,0.161,0.144,0.123
240462,1997,978,304,674,138,69,69,22.7,0.227,0.141,0.102
240471,1997,1144,698,446,269,79,190,27.22,0.272,0.235,0.177
240480,1997,1527,837,690,262,78,184,21.98,0.22,0.172,0.113
240727,1997,1119,562,557,276,97,179,31.85,0.318,0.247,0.174
243443,1997,723,471,252,50,6,44,9.34,0.093,0.069,0.024
243780,1997,6369,2806,3563,1994,953,1041,37.1,0.371,0.313,0.267
100654,1998,995,518,477,182,38,144,27.8,0.278,0.183,0.08
100663,1998,1076,646,430,164,48,116,17.96,0.18,0.152,0.112
100751,1998,2597,1437,1160,857,269,588,40.92,0.409,0.33,0.232
100858,1998,3654,1913,1741,1229,415,814,42.55,0.426,0.336,0.238
101435,1998,175,96,79,88,31,57,59.38,0.594,0.503,0.392
101480,1998,752,392,360,112,34,78,19.9,0.199,0.149,0.094
101675,1998,340,177,163,133,51,82,46.33,0.463,0.391,0.313
101879,1998,828,490,338,118,28,90,18.37,0.184,0.143,0.083
102049,1998,625,390,235,316,110,206,52.82,0.528,0.506,0.468
102094,1998,1044,618,426,143,36,107,17.31,0.173,0.137,0.085
102234,1998,242,119,123,120,61,59,49.58,0.496,0.496,0.496
102368,1998,768,437,331,251,75,176,40.27,0.403,0.327,0.227
102377,1998,683,412,271,154,37,117,28.4,0.284,0.225,0.137
104151,1998,4753,2561,2192,1270,480,790,30.85,0.308,0.267,0.219
104179,1998,5088,2773,2315,1595,590,1005,36.24,0.362,0.313,0.255
105330,1998,2073,1188,885,554,176,378,31.82,0.318,0.267,0.199
106245,1998,865,539,326,93,22,71,13.17,0.132,0.108,0.067
106342,1998,107,65,42,56,21,35,53.85,0.538,0.523,0.5
106397,1998,2456,1245,1211,665,246,419,33.65,0.336,0.271,0.203
106412,1998,721,372,349,70,22,48,12.9,0.129,0.097,0.063
106458,1998,1705,928,777,270,68,202,21.77,0.218,0.158,0.088
106467,1998,821,401,420,105,41,64,15.96,0.16,0.128,0.098
106485,1998,558,292,266,52,18,34,11.64,0.116,0.093,0.068
106704,1998,1575,944,631,249,58,191,20.23,0.202,0.158,0.092
107044,1998,908,535,373,285,101,184,34.39,0.344,0.314,0.271
107080,1998,320,166,154,196,89,107,64.46,0.645,0.613,0.578
107141,1998,250,138,112,112,44,68,49.28,0.493,0.448,0.393
107512,1998,362,220,142,120,36,84,38.18,0.382,0.331,0.254
107558,1998,137,69,68,43,18,25,36.23,0.362,0.314,0.265
110097,1998,469,313,156,227,75,152,48.56,0.486,0.484,0.481
110404,1998,254,79,175,195,136,59,74.68,0.747,0.768,0.777
110422,1998,2260,945,1315,367,136,231,24.44,0.244,0.162,0.103
110486,1998,471,298,173,54,9,45,15.1,0.151,0.115,0.052
110495,1998,444,297,147,84,16,68,22.9,0.229,0.189,0.109
110510,1998,1068,680,388,124,39,85,12.5,0.125,0.116,0.101
110529,1998,2033,855,1178,191,80,111,12.98,0.13,0.094,0.068
110538,1998,1850,1069,781,299,65,234,21.89,0.219,0.162,0.083
110547,1998,465,330,135,21,3,18,5.45,0.054,0.045,0.022
110556,1998,1566,933,633,215,44,171,18.33,0.183,0.137,0.07
110565,1998,2146,1240,906,274,65,209,16.85,0.168,0.128,0.072
110574,1998,732,470,262,106,24,82,17.45,0.174,0.145,0.092
110583,1998,2652,1707,945,285,61,224,13.12,0.131,0.107,0.065
110592,1998,1255,789,466,103,22,81,10.27,0.103,0.082,0.047
110617,1998,1467,828,639,136,30,106,12.8,0.128,0.093,0.047
113698,1998,72,58,14,30,6,24,41.38,0.414,0.417,0.429
115755,1998,731,405,326,71,24,47,11.6,0.116,0.097,0.074
119173,1998,295,293,2,62,0,62,21.16,0.212,0.21,0
120184,1998,130,80,50,52,14,38,47.5,0.475,0.4,0.28
121309,1998,598,375,223,261,87,174,46.4,0.464,0.436,0.39
121345,1998,396,182,214,321,168,153,84.07,0.841,0.811,0.785
122409,1998,3128,1815,1313,308,79,229,12.62,0.126,0.098,0.06
122436,1998,1028,614,414,610,222,388,63.19,0.632,0.593,0.536
122597,1998,1805,1143,662,134,23,111,9.71,0.097,0.074,0.035
122612,1998,640,436,204,296,80,216,49.54,0.495,0.462,0.392
122931,1998,1032,570,462,783,331,452,79.3,0.793,0.759,0.716
123554,1998,573,343,230,352,125,227,66.18,0.662,0.614,0.543
123572,1998,823,557,266,177,37,140,25.13,0.251,0.215,0.139
126562,1998,394,223,171,58,17,41,18.39,0.184,0.147,0.099
126580,1998,635,372,263,154,53,101,27.15,0.272,0.243,0.202
126614,1998,4263,2037,2226,1545,647,898,44.08,0.441,0.362,0.291
126818,1998,3028,1772,1256,1028,301,727,41.03,0.41,0.339,0.24
127060,1998,768,393,375,414,185,229,58.27,0.583,0.539,0.493
127185,1998,970,405,565,108,46,62,15.31,0.153,0.111,0.081
127565,1998,1382,759,623,81,29,52,6.85,0.068,0.059,0.047
127741,1998,2165,1314,851,515,123,392,29.83,0.298,0.238,0.145
128106,1998,611,345,266,80,30,50,14.49,0.145,0.131,0.113
128744,1998,233,94,139,80,48,32,34.04,0.34,0.343,0.345
128771,1998,1317,675,642,163,46,117,17.33,0.173,0.124,0.072
129020,1998,2536,1358,1178,1135,431,704,51.84,0.518,0.448,0.366
129242,1998,875,478,397,679,299,380,79.5,0.795,0.776,0.753
129941,1998,370,141,229,95,51,44,31.21,0.312,0.257,0.223
130253,1998,702,409,293,308,112,196,47.92,0.479,0.439,0.382
130314,1998,142,142,0,66,0,66,46.48,0.465,0.465,NA
130493,1998,1077,647,430,140,24,116,17.93,0.179,0.13,0.056
130590,1998,509,263,246,390,176,214,81.37,0.814,0.766,0.715
130697,1998,716,382,334,593,264,329,86.13,0.861,0.828,0.79
130776,1998,655,315,340,91,33,58,18.41,0.184,0.139,0.097
130794,1998,1295,646,649,1146,573,573,88.7,0.887,0.885,0.883
130934,1998,578,339,239,118,39,79,23.3,0.233,0.204,0.163
130943,1998,3545,2149,1396,2078,696,1382,64.31,0.643,0.586,0.499
131159,1998,1232,774,458,802,262,540,69.77,0.698,0.651,0.572
131283,1998,597,338,259,378,149,229,67.75,0.677,0.633,0.575
131450,1998,230,112,118,17,7,10,8.93,0.089,0.074,0.059
131469,1998,1773,1057,716,1285,471,814,77.01,0.77,0.725,0.658
131496,1998,1470,810,660,1302,581,721,89.01,0.89,0.886,0.88
131520,1998,1244,831,413,469,103,366,44.04,0.44,0.377,0.249
132471,1998,393,249,144,82,20,62,24.9,0.249,0.209,0.139
132602,1998,623,316,307,97,24,73,23.1,0.231,0.156,0.078
132903,1998,3792,1932,1860,1097,387,710,36.75,0.368,0.289,0.208
133492,1998,407,227,180,234,99,135,59.47,0.595,0.575,0.55
133553,1998,934,128,806,279,230,49,38.28,0.383,0.299,0.285
133650,1998,2213,1294,919,385,120,265,20.48,0.205,0.174,0.131
133669,1998,1309,773,536,196,56,140,18.11,0.181,0.15,0.104
133711,1998,418,285,133,182,58,124,43.51,0.435,0.435,0.436
133881,1998,461,145,316,173,108,65,44.83,0.448,0.375,0.342
133951,1998,2227,1298,929,430,117,313,24.11,0.241,0.193,0.126
134079,1998,440,286,154,199,55,144,50.35,0.504,0.452,0.357
134097,1998,5066,2932,2134,2143,705,1438,49.05,0.49,0.423,0.33
134130,1998,5629,3171,2458,2886,1037,1849,58.31,0.583,0.513,0.422
134945,1998,307,112,195,75,40,35,31.25,0.312,0.244,0.205
135726,1998,1831,980,851,975,389,586,59.8,0.598,0.532,0.457
136172,1998,1371,842,529,353,105,248,29.45,0.294,0.257,0.198
136950,1998,458,278,180,232,80,152,54.68,0.547,0.507,0.444
137546,1998,539,311,228,279,113,166,53.38,0.534,0.518,0.496
138354,1998,647,365,282,136,40,96,26.3,0.263,0.21,0.142
138716,1998,493,313,180,30,10,20,6.39,0.064,0.061,0.056
138789,1998,550,378,172,26,8,18,4.76,0.048,0.047,0.047
139144,1998,525,336,189,297,106,191,56.85,0.569,0.566,0.561
139366,1998,723,450,273,63,17,46,10.22,0.102,0.087,0.062
139393,1998,211,134,77,112,36,76,56.72,0.567,0.531,0.468
139658,1998,1692,908,784,1227,548,679,74.78,0.748,0.725,0.699
139719,1998,432,240,192,40,11,29,12.08,0.121,0.093,0.057
139755,1998,2487,721,1766,644,371,273,37.86,0.379,0.259,0.21
139764,1998,335,215,120,41,5,36,16.74,0.167,0.122,0.042
139861,1998,750,470,280,127,22,105,22.34,0.223,0.169,0.079
139931,1998,2897,1549,1348,335,87,248,16.01,0.16,0.116,0.065
139940,1998,1491,924,567,208,63,145,15.69,0.157,0.14,0.111
139959,1998,4384,2588,1796,1771,535,1236,47.76,0.478,0.404,0.298
140447,1998,706,428,278,221,74,147,34.35,0.344,0.313,0.266
140960,1998,321,179,142,23,5,18,10.06,0.101,0.072,0.035
140988,1998,247,167,80,86,22,64,38.32,0.383,0.348,0.275
141185,1998,229,141,88,76,24,52,36.88,0.369,0.332,0.273
141264,1998,1301,755,546,158,44,114,15.1,0.151,0.121,0.081
141334,1998,1670,1042,628,166,34,132,12.67,0.127,0.099,0.054
141486,1998,186,122,64,40,12,28,22.95,0.23,0.215,0.188
141565,1998,351,194,157,24,11,13,6.7,0.067,0.068,0.07
141574,1998,1388,795,593,162,55,107,13.46,0.135,0.117,0.093
142276,1998,1442,787,655,52,15,37,4.7,0.047,0.036,0.023
142285,1998,1481,732,749,297,112,185,25.27,0.253,0.201,0.15
142461,1998,310,193,117,101,27,74,38.34,0.383,0.326,0.231
143084,1998,567,321,246,389,148,241,75.08,0.751,0.686,0.602
143288,1998,144,66,78,37,16,21,31.82,0.318,0.257,0.205
144005,1998,601,399,202,10,3,7,1.75,0.018,0.017,0.015
144281,1998,1210,588,622,229,108,121,20.58,0.206,0.189,0.174
144740,1998,1448,852,596,591,216,375,44.01,0.44,0.408,0.362
144892,1998,1604,984,620,547,148,399,40.55,0.405,0.341,0.239
144962,1998,266,152,114,154,51,103,67.76,0.678,0.579,0.447
144971,1998,114,57,57,65,31,34,59.65,0.597,0.57,0.544
145600,1998,2880,1629,1251,465,166,299,18.35,0.184,0.161,0.133
145619,1998,299,160,139,93,35,58,36.25,0.362,0.311,0.252
145637,1998,6453,3174,3279,3729,1680,2049,64.56,0.646,0.578,0.512
145691,1998,238,133,105,107,37,70,52.63,0.526,0.45,0.352
145813,1998,2740,1728,1012,915,268,647,37.44,0.374,0.334,0.265
146481,1998,302,177,125,167,63,104,58.76,0.588,0.553,0.504
146612,1998,391,193,198,151,64,87,45.08,0.451,0.386,0.323
146719,1998,1340,868,472,641,208,433,49.88,0.499,0.478,0.441
146825,1998,163,79,84,59,22,37,46.84,0.468,0.362,0.262
147013,1998,247,139,108,91,24,67,48.2,0.482,0.368,0.222
147244,1998,594,331,263,291,91,200,60.42,0.604,0.49,0.346
147341,1998,320,146,174,170,84,86,58.9,0.589,0.531,0.483
147703,1998,2818,1513,1305,682,244,438,28.95,0.29,0.242,0.187
147767,1998,1912,1023,889,1601,706,895,87.49,0.875,0.837,0.794
147776,1998,961,594,367,15,3,12,2.02,0.02,0.016,0.008
147828,1998,428,227,201,159,59,100,44.05,0.44,0.371,0.294
148131,1998,232,122,110,109,43,66,54.1,0.541,0.47,0.391
148496,1998,207,137,70,102,36,66,48.18,0.482,0.493,0.514
148584,1998,176,88,88,64,21,43,48.86,0.489,0.364,0.239
148627,1998,271,180,91,87,21,66,36.67,0.367,0.321,0.231
149222,1998,2637,1131,1506,542,248,294,25.99,0.26,0.206,0.165
149231,1998,1408,853,555,257,70,187,21.92,0.219,0.183,0.126
149772,1998,1749,928,821,504,203,301,32.44,0.324,0.288,0.247
149781,1998,573,300,273,409,186,223,74.33,0.743,0.714,0.681
150066,1998,534,319,215,202,78,124,38.87,0.389,0.378,0.363
150136,1998,3512,1905,1607,896,311,585,30.71,0.307,0.255,0.194
150145,1998,273,173,100,104,36,68,39.31,0.393,0.381,0.36
150163,1998,912,557,355,452,145,307,55.12,0.551,0.496,0.408
150400,1998,593,344,249,423,164,259,75.29,0.753,0.713,0.659
150534,1998,665,423,242,293,92,201,47.52,0.475,0.441,0.38
150668,1998,207,121,86,99,39,60,49.59,0.496,0.478,0.453
150941,1998,227,151,76,115,34,81,53.64,0.536,0.507,0.447
151102,1998,1303,673,630,38,16,22,3.27,0.033,0.029,0.025
151111,1998,2570,1387,1183,110,41,69,4.97,0.05,0.043,0.035
151306,1998,1552,945,607,197,56,141,14.92,0.149,0.127,0.092
151324,1998,1994,1062,932,368,123,245,23.07,0.231,0.185,0.132
151333,1998,333,230,103,25,2,23,10,0.1,0.075,0.019
151342,1998,732,427,305,31,14,17,3.98,0.04,0.042,0.046
151351,1998,6735,3810,2925,2747,1088,1659,43.54,0.435,0.408,0.372
151360,1998,535,347,188,31,8,23,6.63,0.066,0.058,0.043
151379,1998,727,407,320,28,6,22,5.41,0.054,0.039,0.019
151388,1998,230,146,84,7,2,5,3.42,0.034,0.03,0.024
151777,1998,309,173,136,139,47,92,53.18,0.532,0.45,0.346
151786,1998,205,158,47,70,14,56,35.44,0.354,0.341,0.298
152080,1998,1937,895,1042,1706,891,815,91.06,0.911,0.881,0.855
152248,1998,1062,560,502,38,17,21,3.75,0.038,0.036,0.034
152363,1998,254,136,118,113,46,67,49.26,0.493,0.445,0.39
152530,1998,460,243,217,293,128,165,67.9,0.679,0.637,0.59
152600,1998,685,350,335,396,162,234,66.86,0.669,0.578,0.484
153001,1998,323,165,158,165,68,97,58.79,0.588,0.511,0.43
153108,1998,411,222,189,249,101,148,66.67,0.667,0.606,0.534
153269,1998,670,379,291,378,134,244,64.38,0.644,0.564,0.46
153384,1998,350,194,156,282,127,155,79.9,0.799,0.806,0.814
153603,1998,3800,1775,2025,1111,438,673,37.92,0.379,0.292,0.216
153834,1998,678,396,282,446,179,267,67.42,0.674,0.658,0.635
154095,1998,1982,1257,725,585,146,439,34.92,0.349,0.295,0.201
155089,1998,195,106,89,35,14,21,19.81,0.198,0.179,0.157
155317,1998,3698,2069,1629,974,322,652,31.51,0.315,0.263,0.198
155335,1998,110,65,45,28,8,20,30.77,0.308,0.255,0.178
155399,1998,2921,1388,1533,755,295,460,33.14,0.331,0.258,0.192
155520,1998,254,114,140,64,27,37,32.46,0.325,0.252,0.193
155627,1998,117,43,74,24,10,14,32.56,0.326,0.205,0.135
155937,1998,161,81,80,52,18,34,41.98,0.42,0.323,0.225
156213,1998,333,204,129,211,82,129,63.24,0.632,0.634,0.636
156286,1998,362,212,150,165,61,104,49.06,0.491,0.456,0.407
156295,1998,414,237,177,161,70,91,38.4,0.384,0.389,0.395
156365,1998,359,194,165,82,25,57,29.38,0.294,0.228,0.152
156541,1998,412,177,235,87,30,57,32.2,0.322,0.211,0.128
156745,1998,408,224,184,194,61,133,59.38,0.594,0.475,0.332
157058,1998,379,215,164,34,9,25,11.63,0.116,0.09,0.055
157076,1998,152,95,57,53,18,35,36.84,0.368,0.349,0.316
157085,1998,2931,1548,1383,815,331,484,31.27,0.313,0.278,0.239
157289,1998,2032,1011,1021,222,81,141,13.95,0.139,0.109,0.079
157386,1998,1369,739,630,157,48,109,14.75,0.148,0.115,0.076
157401,1998,1275,707,568,341,122,219,30.98,0.31,0.267,0.215
157447,1998,1627,956,671,118,32,86,9,0.09,0.073,0.048
157535,1998,169,110,59,30,12,18,16.36,0.164,0.178,0.203
157951,1998,2353,1347,1006,542,190,352,26.13,0.261,0.23,0.189
158477,1998,294,180,114,126,34,92,51.11,0.511,0.429,0.298
159009,1998,771,359,412,71,23,48,13.37,0.134,0.092,0.056
159391,1998,5066,2874,2192,1198,399,799,27.8,0.278,0.236,0.182
159647,1998,1621,794,827,449,178,271,34.13,0.341,0.277,0.215
159717,1998,1433,802,631,141,35,106,13.22,0.132,0.098,0.055
159966,1998,1351,781,570,117,22,95,12.16,0.122,0.087,0.039
160038,1998,1364,857,507,157,43,114,13.3,0.133,0.115,0.085
160612,1998,2588,1471,1117,156,50,106,7.21,0.072,0.06,0.045
160621,1998,1715,911,804,110,25,85,9.33,0.093,0.064,0.031
160658,1998,2931,1621,1310,249,69,180,11.1,0.111,0.085,0.053
161004,1998,433,213,220,361,181,180,84.51,0.845,0.834,0.823
161226,1998,484,333,151,155,41,114,34.23,0.342,0.32,0.272
161235,1998,93,40,53,9,1,8,20,0.2,0.097,0.019
161244,1998,148,95,53,8,2,6,6.32,0.063,0.054,0.038
161253,1998,1342,671,671,418,165,253,37.7,0.377,0.311,0.246
161554,1998,789,463,326,66,18,48,10.37,0.104,0.084,0.055
162007,1998,418,225,193,49,7,42,18.67,0.187,0.117,0.036
162210,1998,140,67,73,17,7,10,14.93,0.149,0.121,0.096
162283,1998,457,337,120,32,10,22,6.53,0.065,0.07,0.083
162584,1998,932,486,446,181,66,115,23.66,0.237,0.194,0.148
162654,1998,302,213,89,169,36,133,62.44,0.624,0.56,0.404
162760,1998,149,144,5,97,2,95,65.97,0.66,0.651,0.4
162928,1998,1077,467,610,864,469,395,84.58,0.846,0.802,0.769
163046,1998,854,485,369,668,276,392,80.82,0.808,0.782,0.748
163268,1998,1246,609,637,347,138,209,34.32,0.343,0.278,0.217
163286,1998,4039,2007,2032,1858,801,1057,52.67,0.527,0.46,0.394
163453,1998,1136,674,462,166,42,124,18.4,0.184,0.146,0.091
163462,1998,410,213,197,249,113,136,63.85,0.639,0.607,0.574
163851,1998,935,534,401,438,139,299,55.99,0.56,0.468,0.347
163912,1998,331,181,150,211,77,134,74.03,0.74,0.637,0.513
164076,1998,1923,1175,748,573,183,390,33.19,0.332,0.298,0.245
164173,1998,443,305,138,163,46,117,38.36,0.384,0.368,0.333
164216,1998,278,174,104,163,53,110,63.22,0.632,0.586,0.51
164270,1998,331,173,158,210,86,124,71.68,0.717,0.634,0.544
164447,1998,226,96,130,57,22,35,36.46,0.365,0.252,0.169
164492,1998,153,116,37,70,19,51,43.97,0.44,0.458,0.514
164562,1998,522,334,188,402,138,264,79.04,0.79,0.77,0.734
165015,1998,850,477,373,715,293,422,88.47,0.885,0.841,0.786
165024,1998,1128,695,433,260,75,185,26.62,0.266,0.23,0.173
165334,1998,501,305,196,323,119,204,66.89,0.669,0.645,0.607
165662,1998,612,368,244,377,150,227,61.68,0.617,0.616,0.615
165671,1998,151,151,0,80,0,80,52.98,0.53,0.53,NA
165820,1998,503,281,222,81,24,57,20.28,0.203,0.161,0.108
165866,1998,601,381,220,136,27,109,28.61,0.286,0.226,0.123
165936,1998,417,289,128,214,65,149,51.56,0.516,0.513,0.508
166027,1998,1650,772,878,1423,748,675,87.44,0.874,0.862,0.852
166124,1998,723,354,369,623,305,318,89.83,0.898,0.862,0.827
166513,1998,997,366,631,235,116,119,32.51,0.325,0.236,0.184
166629,1998,3953,2021,1932,1651,625,1026,50.77,0.508,0.418,0.323
166638,1998,579,307,272,69,29,40,13.03,0.13,0.119,0.107
166683,1998,1042,446,596,840,466,374,83.86,0.839,0.806,0.782
167288,1998,209,131,78,66,17,49,37.4,0.374,0.316,0.218
167987,1998,1086,535,551,284,102,182,34.02,0.34,0.262,0.185
167996,1998,531,313,218,421,168,253,80.83,0.808,0.793,0.771
168005,1998,620,355,265,208,75,133,37.46,0.375,0.335,0.283
168148,1998,1236,668,568,1040,466,574,85.93,0.859,0.841,0.82
168254,1998,535,238,297,231,119,112,47.06,0.471,0.432,0.401
168281,1998,435,294,141,291,79,212,72.11,0.721,0.669,0.56
168342,1998,537,265,272,492,252,240,90.57,0.906,0.916,0.926
168546,1998,448,248,200,298,126,172,69.35,0.694,0.665,0.63
168786,1998,346,213,133,75,23,52,24.41,0.244,0.217,0.173
169080,1998,974,536,438,559,236,323,60.26,0.603,0.574,0.539
169798,1998,2349,1426,923,244,79,165,11.57,0.116,0.104,0.086
169910,1998,1946,812,1134,53,25,28,3.45,0.034,0.027,0.022
170082,1998,2482,1544,938,469,153,316,20.47,0.205,0.189,0.163
170301,1998,747,462,285,446,148,298,64.5,0.645,0.597,0.519
170532,1998,442,256,186,322,126,196,76.56,0.766,0.729,0.677
170639,1998,575,250,325,67,27,40,16,0.16,0.117,0.083
170976,1998,5258,2654,2604,3531,1620,1911,72,0.72,0.672,0.622
171100,1998,6724,3767,2957,2343,757,1586,42.1,0.421,0.348,0.256
171128,1998,1194,328,866,323,202,121,36.89,0.369,0.271,0.233
171137,1998,741,373,368,99,41,58,15.55,0.156,0.134,0.111
171146,1998,613,372,241,60,20,40,10.75,0.108,0.098,0.083
171599,1998,198,85,113,42,21,21,24.71,0.247,0.212,0.186
172051,1998,895,492,403,59,20,39,7.93,0.079,0.066,0.05
172699,1998,3621,1981,1640,699,255,444,22.41,0.224,0.193,0.155
173160,1998,513,314,199,314,122,192,61.15,0.612,0.612,0.613
173258,1998,520,279,241,450,204,246,88.17,0.882,0.865,0.846
173328,1998,213,106,107,57,24,33,31.13,0.311,0.268,0.224
173647,1998,695,391,304,477,195,282,72.12,0.721,0.686,0.641
173902,1998,465,260,205,339,153,186,71.54,0.715,0.729,0.746
174066,1998,4992,2582,2410,1441,573,868,33.62,0.336,0.289,0.238
174233,1998,1746,911,835,362,138,224,24.59,0.246,0.207,0.165
174251,1998,522,330,192,198,62,136,41.21,0.412,0.379,0.323
174491,1998,393,242,151,155,55,100,41.32,0.413,0.394,0.364
174792,1998,427,0,427,317,317,0,NA,NA,0.742,0.742
174844,1998,756,431,325,594,256,338,78.42,0.784,0.786,0.788
174899,1998,277,213,64,163,30,133,62.44,0.624,0.588,0.469
174914,1998,1038,579,459,561,230,331,57.17,0.572,0.54,0.501
175342,1998,556,306,250,140,41,99,32.35,0.324,0.252,0.164
175421,1998,112,53,59,35,12,23,43.4,0.434,0.312,0.203
175616,1998,427,265,162,100,23,77,29.06,0.291,0.234,0.142
175856,1998,842,494,348,155,43,112,22.67,0.227,0.184,0.124
175980,1998,286,145,141,169,79,90,62.07,0.621,0.591,0.56
176017,1998,1794,920,874,602,213,389,42.28,0.423,0.336,0.244
176035,1998,210,180,30,47,4,43,23.89,0.239,0.224,0.133
176044,1998,321,182,139,68,16,52,28.57,0.286,0.212,0.115
176080,1998,1929,944,985,501,178,323,34.22,0.342,0.26,0.181
176406,1998,198,142,56,66,12,54,38.03,0.38,0.333,0.214
176628,1998,113,64,49,39,9,30,46.88,0.469,0.345,0.184
176947,1998,218,111,107,59,19,40,36.04,0.36,0.271,0.178
176965,1998,1408,730,678,317,107,210,28.77,0.288,0.225,0.158
177418,1998,156,111,45,59,11,48,43.24,0.432,0.378,0.244
178059,1998,225,158,67,100,26,74,46.84,0.468,0.444,0.388
178341,1998,857,469,388,95,30,65,13.86,0.139,0.111,0.077
178387,1998,983,577,406,127,27,100,17.33,0.173,0.129,0.067
178396,1998,3785,2077,1708,1425,500,925,44.54,0.445,0.376,0.293
178402,1998,618,336,282,114,39,75,22.32,0.223,0.184,0.138
178411,1998,717,151,566,106,81,25,16.56,0.166,0.148,0.143
178420,1998,528,274,254,114,46,68,24.82,0.248,0.216,0.181
178615,1998,1482,914,568,562,181,381,41.68,0.417,0.379,0.319
179043,1998,280,153,127,141,50,91,59.48,0.595,0.504,0.394
179159,1998,1239,694,545,684,251,433,62.39,0.624,0.552,0.461
179557,1998,1239,757,482,300,75,225,29.72,0.297,0.242,0.156
179566,1998,2739,1545,1194,607,192,415,26.86,0.269,0.222,0.161
179867,1998,1465,770,695,1221,570,651,84.55,0.846,0.833,0.82
179894,1998,339,198,141,123,50,73,36.87,0.369,0.363,0.355
179946,1998,205,94,111,78,40,38,40.43,0.404,0.38,0.36
180179,1998,539,325,214,52,10,42,12.92,0.129,0.096,0.047
180461,1998,1886,846,1040,299,140,159,18.79,0.188,0.159,0.135
180522,1998,253,107,146,25,15,10,9.35,0.094,0.099,0.103
180984,1998,294,172,122,90,25,65,37.79,0.378,0.306,0.205
181002,1998,794,462,332,481,195,286,61.9,0.619,0.606,0.587
181020,1998,266,123,143,156,70,86,69.92,0.699,0.586,0.49
181127,1998,309,168,141,160,57,103,61.31,0.613,0.518,0.404
181215,1998,1022,598,424,204,55,149,24.92,0.249,0.2,0.13
181394,1998,1296,701,595,120,42,78,11.13,0.111,0.093,0.071
181446,1998,429,246,183,200,76,124,50.41,0.504,0.466,0.415
181464,1998,3353,1619,1734,740,275,465,28.72,0.287,0.221,0.159
181534,1998,213,91,122,22,3,19,20.88,0.209,0.103,0.025
181783,1998,700,402,298,177,56,121,30.1,0.301,0.253,0.188
182281,1998,1546,885,661,186,58,128,14.46,0.145,0.12,0.088
182290,1998,1260,675,585,181,60,121,17.93,0.179,0.144,0.103
182634,1998,235,162,73,111,29,82,50.62,0.506,0.472,0.397
182795,1998,429,203,226,145,59,86,42.36,0.424,0.338,0.261
183062,1998,773,470,303,178,53,125,26.6,0.266,0.23,0.175
183080,1998,784,375,409,190,81,109,29.07,0.291,0.242,0.198
183239,1998,528,296,232,392,159,233,78.72,0.787,0.742,0.685
183822,1998,247,170,77,25,7,18,10.59,0.106,0.101,0.091
183974,1998,124,77,47,26,8,18,23.38,0.234,0.21,0.17
184348,1998,337,213,124,226,84,142,66.67,0.667,0.671,0.677
184603,1998,566,307,259,90,30,60,19.54,0.195,0.159,0.116
184612,1998,151,118,33,20,3,17,14.41,0.144,0.132,0.091
184782,1998,1118,624,494,414,160,254,40.71,0.407,0.37,0.324
185129,1998,549,305,244,40,13,27,8.85,0.088,0.073,0.053
185572,1998,834,429,405,253,98,155,36.13,0.361,0.303,0.242
185590,1998,1106,660,446,252,60,192,29.09,0.291,0.228,0.135
185828,1998,563,120,443,93,64,29,24.17,0.242,0.165,0.144
186131,1998,1167,560,607,1000,495,505,90.18,0.902,0.857,0.815
186201,1998,472,271,201,169,56,113,41.7,0.417,0.358,0.279
186283,1998,869,483,386,419,161,258,53.42,0.534,0.482,0.417
186584,1998,1221,657,564,486,173,313,47.64,0.476,0.398,0.307
186876,1998,744,420,324,321,116,205,48.81,0.488,0.431,0.358
187134,1998,1206,714,492,760,278,482,67.51,0.675,0.63,0.565
187444,1998,1133,663,470,145,39,106,15.99,0.16,0.128,0.083
187985,1998,2617,1475,1142,281,96,185,12.54,0.125,0.107,0.084
188030,1998,2077,1070,1007,254,77,177,16.54,0.165,0.122,0.076
188429,1998,525,343,182,214,67,147,42.86,0.429,0.408,0.368
188641,1998,554,275,279,272,118,154,56,0.56,0.491,0.423
190044,1998,616,138,478,292,216,76,55.07,0.551,0.474,0.452
190099,1998,751,407,344,641,283,358,87.96,0.88,0.854,0.823
190150,1998,1283,619,664,1061,545,516,83.36,0.834,0.827,0.821
190248,1998,114,68,46,40,17,23,33.82,0.338,0.351,0.37
190415,1998,3084,1452,1632,2633,1358,1275,87.81,0.878,0.854,0.832
190512,1998,946,493,453,231,83,148,30.02,0.3,0.244,0.183
190549,1998,1029,615,414,184,56,128,20.81,0.208,0.179,0.135
190558,1998,1510,786,724,36,14,22,2.8,0.028,0.024,0.019
190567,1998,901,462,439,31,11,20,4.33,0.043,0.034,0.025
190594,1998,1468,1026,442,134,29,105,10.23,0.102,0.091,0.066
190637,1998,581,398,183,28,8,20,5.03,0.05,0.048,0.044
190664,1998,1133,711,422,235,59,176,24.75,0.248,0.207,0.14
190691,1998,383,235,148,22,8,14,5.96,0.06,0.057,0.054
190725,1998,345,262,83,80,20,60,22.9,0.229,0.232,0.241
191241,1998,1532,912,620,1111,422,689,75.55,0.755,0.725,0.681
191515,1998,464,238,226,372,170,202,84.87,0.849,0.802,0.752
191533,1998,440,227,213,204,82,122,53.74,0.537,0.464,0.385
191630,1998,488,280,208,347,129,218,77.86,0.779,0.711,0.62
191649,1998,1749,907,842,593,217,376,41.46,0.415,0.339,0.258
191676,1998,309,204,105,180,50,130,63.73,0.637,0.583,0.476
191931,1998,696,302,394,279,117,162,53.64,0.536,0.401,0.297
191968,1998,1337,759,578,909,379,530,69.83,0.698,0.68,0.656
192192,1998,226,180,46,75,15,60,33.33,0.333,0.332,0.326
192323,1998,471,279,192,309,114,195,69.89,0.699,0.656,0.594
192439,1998,1061,689,372,44,8,36,5.22,0.052,0.041,0.022
192703,1998,547,274,273,328,159,169,61.68,0.617,0.6,0.582
192749,1998,338,225,113,126,35,91,40.44,0.404,0.373,0.31
192819,1998,834,430,404,547,240,307,71.4,0.714,0.656,0.594
192925,1998,153,113,40,45,15,30,26.55,0.266,0.294,0.375
193016,1998,907,582,325,53,14,39,6.7,0.067,0.058,0.043
193292,1998,180,117,63,72,21,51,43.59,0.436,0.4,0.333
193353,1998,304,230,74,122,27,95,41.3,0.413,0.401,0.365
193399,1998,266,200,66,124,26,98,49,0.49,0.466,0.394
193584,1998,321,246,75,199,38,161,65.45,0.655,0.62,0.507
193645,1998,852,738,114,161,11,150,20.33,0.203,0.189,0.096
193654,1998,581,394,187,240,51,189,47.97,0.48,0.413,0.273
193900,1998,3722,2224,1498,2028,805,1223,54.99,0.55,0.545,0.537
193973,1998,543,332,211,271,93,178,53.61,0.536,0.499,0.441
194161,1998,258,159,99,73,20,53,33.33,0.333,0.283,0.202
194310,1998,1536,911,625,602,220,382,41.93,0.419,0.392,0.352
194824,1998,1138,258,880,654,483,171,66.28,0.663,0.575,0.549
195003,1998,1980,609,1371,816,526,290,47.62,0.476,0.412,0.384
195030,1998,1062,481,581,730,372,358,74.43,0.744,0.687,0.64
195164,1998,568,284,284,290,126,164,57.75,0.578,0.511,0.444
195173,1998,440,259,181,146,40,106,40.93,0.409,0.332,0.221
195216,1998,479,255,224,339,155,184,72.16,0.722,0.708,0.692
195234,1998,345,262,83,175,29,146,55.73,0.557,0.507,0.349
195243,1998,306,179,127,97,34,63,35.2,0.352,0.317,0.268
195304,1998,306,227,79,202,57,145,63.88,0.639,0.66,0.722
195474,1998,619,311,308,436,202,234,75.24,0.752,0.704,0.656
195526,1998,596,366,230,482,193,289,78.96,0.79,0.809,0.839
195544,1998,100,82,18,69,9,60,73.17,0.732,0.69,0.5
195809,1998,2504,1417,1087,886,318,568,40.08,0.401,0.354,0.293
196413,1998,2566,1383,1183,1689,702,987,71.37,0.714,0.658,0.593
196592,1998,1651,1155,496,221,65,156,13.51,0.135,0.134,0.131
197045,1998,306,203,103,107,31,76,37.44,0.374,0.35,0.301
197133,1998,626,379,247,504,191,313,82.59,0.826,0.805,0.773
197869,1998,2312,1192,1120,687,239,448,37.58,0.376,0.297,0.213
197984,1998,198,94,104,87,41,46,48.94,0.489,0.439,0.394
198385,1998,472,253,219,423,198,225,88.93,0.889,0.896,0.904
198464,1998,2803,1714,1089,720,196,524,30.57,0.306,0.257,0.18
198507,1998,378,229,149,109,22,87,37.99,0.38,0.288,0.148
198516,1998,1013,632,381,660,234,426,67.41,0.674,0.652,0.614
198835,1998,267,138,129,112,38,74,53.62,0.536,0.419,0.295
198969,1998,437,117,320,88,55,33,28.21,0.282,0.201,0.172
199102,1998,1366,695,671,323,104,219,31.51,0.315,0.236,0.155
199111,1998,474,278,196,120,35,85,30.58,0.306,0.253,0.179
199120,1998,3425,2116,1309,2289,794,1495,70.65,0.707,0.668,0.607
199139,1998,2122,1178,944,456,169,287,24.36,0.244,0.215,0.179
199148,1998,1791,1257,534,472,94,378,30.07,0.301,0.264,0.176
199157,1998,673,409,264,184,41,143,34.96,0.35,0.273,0.155
199193,1998,3751,1513,2238,1075,492,583,38.53,0.385,0.287,0.22
199218,1998,1681,1030,651,628,180,448,43.5,0.435,0.374,0.276
199281,1998,464,244,220,99,36,63,25.82,0.258,0.213,0.164
199306,1998,148,67,81,45,17,28,41.79,0.418,0.304,0.21
199412,1998,147,111,36,67,15,52,46.85,0.469,0.456,0.417
199582,1998,299,164,135,57,13,44,26.83,0.268,0.191,0.096
199643,1998,382,220,162,73,20,53,24.09,0.241,0.191,0.123
199847,1998,993,505,488,746,334,412,81.58,0.816,0.751,0.684
199962,1998,273,127,146,89,34,55,43.31,0.433,0.326,0.233
199999,1998,524,364,160,114,23,91,25,0.25,0.218,0.144
200004,1998,1098,544,554,249,80,169,31.07,0.311,0.227,0.144
200059,1998,363,204,159,26,4,22,10.78,0.108,0.072,0.025
200156,1998,278,150,128,99,39,60,40,0.4,0.356,0.305
200217,1998,404,244,160,149,39,110,45.08,0.451,0.369,0.244
200226,1998,153,56,97,32,16,16,28.57,0.286,0.209,0.165
200253,1998,371,217,154,28,7,21,9.68,0.097,0.075,0.045
200280,1998,1465,722,743,326,141,185,25.62,0.256,0.223,0.19
200332,1998,1259,524,735,181,83,98,18.7,0.187,0.144,0.113
200572,1998,193,100,93,47,12,35,35,0.35,0.244,0.129
201104,1998,570,351,219,235,66,169,48.15,0.482,0.412,0.301
201371,1998,190,112,78,102,32,70,62.5,0.625,0.537,0.41
201548,1998,518,313,205,250,79,171,54.63,0.546,0.483,0.385
201645,1998,830,301,529,476,265,211,70.1,0.701,0.573,0.501
201690,1998,230,130,100,27,5,22,16.92,0.169,0.117,0.05
202134,1998,962,455,507,86,37,49,10.77,0.108,0.089,0.073
202480,1998,1792,919,873,991,385,606,65.94,0.659,0.553,0.441
202523,1998,631,364,267,456,173,283,77.75,0.777,0.723,0.648
202763,1998,585,384,201,228,64,164,42.71,0.427,0.39,0.318
203085,1998,290,138,152,130,54,76,55.07,0.551,0.448,0.355
203128,1998,231,106,125,137,63,74,69.81,0.698,0.593,0.504
203368,1998,854,433,421,532,241,291,67.21,0.672,0.623,0.572
203517,1998,3019,1867,1152,491,154,337,18.05,0.181,0.163,0.134
203535,1998,451,252,199,369,156,213,84.52,0.845,0.818,0.784
203580,1998,68,62,6,32,3,29,46.77,0.468,0.471,0.5
203775,1998,398,235,163,153,56,97,41.28,0.413,0.384,0.344
203845,1998,338,177,161,146,46,100,56.5,0.565,0.432,0.286
204024,1998,3332,1904,1428,2182,856,1326,69.64,0.696,0.655,0.599
204185,1998,568,289,279,318,116,202,69.9,0.699,0.56,0.416
204194,1998,345,205,140,141,44,97,47.32,0.473,0.409,0.314
204617,1998,184,118,66,73,18,55,46.61,0.466,0.397,0.273
204796,1998,6151,3177,2974,1886,610,1276,40.16,0.402,0.307,0.205
204857,1998,3369,1988,1381,1489,480,1009,50.75,0.508,0.442,0.348
206330,1998,143,68,75,37,13,24,35.29,0.353,0.259,0.173
206589,1998,504,259,245,335,147,188,72.59,0.726,0.665,0.6
206604,1998,2101,1178,923,354,109,245,20.8,0.208,0.168,0.118
206622,1998,831,483,348,541,227,314,65.01,0.65,0.651,0.652
206695,1998,1839,954,885,250,81,169,17.71,0.177,0.136,0.092
206914,1998,590,327,263,35,13,22,6.73,0.067,0.059,0.049
207209,1998,517,262,255,22,3,19,7.25,0.072,0.043,0.012
207306,1998,290,147,143,35,15,20,13.61,0.136,0.121,0.105
207324,1998,468,277,191,93,33,60,21.66,0.217,0.199,0.173
207388,1998,2584,1301,1283,624,226,398,30.59,0.306,0.241,0.176
207500,1998,3148,1618,1530,641,214,427,26.39,0.264,0.204,0.14
207722,1998,279,159,120,48,19,29,18.24,0.182,0.172,0.158
207847,1998,499,260,239,59,21,38,14.62,0.146,0.118,0.088
207865,1998,866,453,413,136,38,98,21.63,0.216,0.157,0.092
208822,1998,361,240,121,208,73,135,56.25,0.562,0.576,0.603
209056,1998,424,253,171,249,94,155,61.26,0.613,0.587,0.55
209065,1998,415,232,183,238,81,157,67.67,0.677,0.573,0.443
209542,1998,2229,1105,1124,615,210,405,36.65,0.366,0.276,0.187
209551,1998,2304,1289,1015,839,280,559,43.37,0.434,0.364,0.276
209612,1998,246,157,89,133,39,94,59.87,0.599,0.541,0.438
209807,1998,800,419,381,101,28,73,17.42,0.174,0.126,0.073
209922,1998,338,164,174,165,86,79,48.17,0.482,0.488,0.494
210146,1998,670,403,267,124,40,84,20.84,0.208,0.185,0.15
210401,1998,406,236,170,263,105,158,66.95,0.67,0.648,0.618
210429,1998,700,425,275,116,26,90,21.18,0.212,0.166,0.095
210571,1998,355,187,168,176,71,105,56.15,0.561,0.496,0.423
210669,1998,545,272,273,321,144,177,65.07,0.651,0.589,0.527
210775,1998,168,93,75,56,16,40,43.01,0.43,0.333,0.213
211088,1998,334,248,86,189,46,143,57.66,0.577,0.566,0.535
211158,1998,1377,890,487,465,102,363,40.79,0.408,0.338,0.209
211291,1998,954,468,486,840,427,413,88.25,0.883,0.881,0.879
211352,1998,304,209,95,152,35,117,55.98,0.56,0.5,0.368
211361,1998,931,480,451,180,68,112,23.33,0.233,0.193,0.151
211431,1998,163,157,6,43,3,40,25.48,0.255,0.264,0.5
211440,1998,1303,445,858,848,539,309,69.44,0.694,0.651,0.628
211468,1998,187,185,2,104,1,103,55.68,0.557,0.556,0.5
211556,1998,142,142,0,63,0,63,44.37,0.444,0.444,NA
211583,1998,95,93,2,42,0,42,45.16,0.452,0.442,0
211608,1998,235,147,88,23,3,20,13.61,0.136,0.098,0.034
211644,1998,1191,717,474,250,64,186,25.94,0.259,0.21,0.135
211981,1998,400,203,197,172,70,102,50.25,0.503,0.43,0.355
212009,1998,541,334,207,417,155,262,78.44,0.784,0.771,0.749
212054,1998,2087,792,1295,247,73,174,21.97,0.22,0.118,0.056
212106,1998,1253,771,482,615,210,405,52.53,0.525,0.491,0.436
212115,1998,856,475,381,182,53,129,27.16,0.272,0.213,0.139
212133,1998,317,220,97,168,48,120,54.55,0.545,0.53,0.495
212160,1998,1205,691,514,210,54,156,22.58,0.226,0.174,0.105
212197,1998,422,271,151,265,87,178,65.68,0.657,0.628,0.576
212577,1998,502,257,245,394,175,219,85.21,0.852,0.785,0.714
212601,1998,608,360,248,282,95,187,51.94,0.519,0.464,0.383
212832,1998,143,100,43,44,9,35,35,0.35,0.308,0.209
212911,1998,322,170,152,277,130,147,86.47,0.865,0.86,0.855
213020,1998,2757,1643,1114,661,161,500,30.43,0.304,0.24,0.145
213251,1998,337,192,145,227,88,139,72.4,0.724,0.674,0.607
213321,1998,396,189,207,240,113,127,67.2,0.672,0.606,0.546
213349,1998,1417,840,577,282,70,212,25.24,0.252,0.199,0.121
213358,1998,204,127,77,82,30,52,40.94,0.409,0.402,0.39
213367,1998,663,321,342,361,161,200,62.31,0.623,0.544,0.471
213385,1998,597,281,316,480,241,239,85.05,0.851,0.804,0.763
213507,1998,422,208,214,247,110,137,65.87,0.659,0.585,0.514
213543,1998,1112,478,634,789,397,392,82.01,0.82,0.71,0.626
213613,1998,813,463,350,159,50,109,23.54,0.235,0.196,0.143
213668,1998,380,195,185,222,85,137,70.26,0.703,0.584,0.459
213783,1998,619,346,273,143,64,79,22.83,0.228,0.231,0.234
213826,1998,241,186,55,102,16,86,46.24,0.462,0.423,0.291
213996,1998,763,480,283,536,205,331,68.96,0.69,0.702,0.724
214041,1998,1110,651,459,383,132,251,38.56,0.386,0.345,0.288
214069,1998,187,142,45,126,31,95,66.9,0.669,0.674,0.689
214157,1998,292,172,120,183,69,114,66.28,0.663,0.627,0.575
214175,1998,577,344,233,438,162,276,80.23,0.802,0.759,0.695
214272,1998,314,206,108,131,42,89,43.2,0.432,0.417,0.389
214777,1998,5117,2590,2527,2448,959,1489,57.49,0.575,0.478,0.38
215062,1998,2301,1128,1173,1975,969,1006,89.18,0.892,0.858,0.826
215743,1998,335,182,153,90,47,43,23.63,0.236,0.269,0.307
215798,1998,262,135,127,153,73,80,59.26,0.593,0.584,0.575
215929,1998,873,527,346,607,217,390,74,0.74,0.695,0.627
216010,1998,1211,654,557,480,181,299,45.72,0.457,0.396,0.325
216038,1998,1260,713,547,297,95,202,28.33,0.283,0.236,0.174
216287,1998,361,193,168,297,132,165,85.49,0.855,0.823,0.786
216339,1998,2150,1279,871,521,171,350,27.37,0.274,0.242,0.196
216524,1998,336,189,147,249,93,156,82.54,0.825,0.741,0.633
216694,1998,290,113,177,116,60,56,49.56,0.496,0.4,0.339
216764,1998,1629,1031,598,474,124,350,33.95,0.34,0.291,0.207
216807,1998,372,236,136,252,79,173,73.31,0.733,0.677,0.581
216852,1998,490,207,283,204,111,93,44.93,0.449,0.416,0.392
216931,1998,376,160,216,148,70,78,48.75,0.488,0.394,0.324
217059,1998,853,462,391,370,145,225,48.7,0.487,0.434,0.371
217156,1998,1417,772,645,1180,520,660,85.49,0.855,0.833,0.806
217402,1998,994,599,395,813,323,490,81.8,0.818,0.818,0.818
217536,1998,443,296,147,241,69,172,58.11,0.581,0.544,0.469
217776,1998,91,51,40,25,11,14,27.45,0.274,0.275,0.275
217819,1998,1937,1248,689,712,179,533,42.71,0.427,0.368,0.26
217882,1998,2699,1273,1426,1091,396,695,54.6,0.546,0.404,0.278
217998,1998,136,84,52,89,28,61,72.62,0.726,0.654,0.538
218061,1998,649,372,277,188,57,131,35.22,0.352,0.29,0.206
218229,1998,488,322,166,92,19,73,22.67,0.227,0.189,0.114
218238,1998,112,58,54,26,8,18,31.03,0.31,0.232,0.148
218399,1998,204,123,81,37,10,27,21.95,0.22,0.181,0.123
218414,1998,206,92,114,74,27,47,51.09,0.511,0.359,0.237
218663,1998,2756,1553,1203,1098,398,700,45.07,0.451,0.398,0.331
218724,1998,855,468,387,150,53,97,20.73,0.207,0.175,0.137
218733,1998,739,428,311,186,50,136,31.78,0.318,0.252,0.161
218742,1998,547,362,185,106,18,88,24.31,0.243,0.194,0.097
218973,1998,298,145,153,224,113,111,76.55,0.765,0.752,0.739
219000,1998,403,257,146,213,61,152,59.14,0.591,0.529,0.418
219046,1998,632,381,251,48,13,35,9.19,0.092,0.076,0.052
219082,1998,231,110,121,45,17,28,25.45,0.254,0.195,0.14
219198,1998,126,85,41,44,13,31,36.47,0.365,0.349,0.317
219259,1998,480,276,204,66,16,50,18.12,0.181,0.138,0.078
219356,1998,1510,766,744,384,147,237,30.94,0.309,0.254,0.198
219471,1998,894,500,394,180,58,122,24.4,0.244,0.201,0.147
219602,1998,846,518,328,76,20,56,10.81,0.108,0.09,0.061
219709,1998,413,254,159,201,73,128,50.39,0.504,0.487,0.459
219718,1998,82,29,53,16,6,10,34.48,0.345,0.195,0.113
219949,1998,236,111,125,44,8,36,32.43,0.324,0.186,0.064
220075,1998,1507,880,627,204,64,140,15.91,0.159,0.135,0.102
220215,1998,358,199,159,116,53,63,31.66,0.317,0.324,0.333
220613,1998,722,417,305,193,62,131,31.41,0.314,0.267,0.203
220631,1998,179,122,57,31,10,21,17.21,0.172,0.173,0.175
220710,1998,228,132,96,96,35,61,46.21,0.462,0.421,0.365
221351,1998,383,206,177,291,128,163,79.13,0.791,0.76,0.723
221519,1998,382,198,184,284,124,160,80.81,0.808,0.743,0.674
221731,1998,105,61,44,28,8,20,32.79,0.328,0.267,0.182
221847,1998,1044,460,584,124,38,86,18.7,0.187,0.119,0.065
221892,1998,187,111,76,40,16,24,21.62,0.216,0.214,0.211
222178,1998,988,541,447,280,110,170,31.42,0.314,0.283,0.246
222983,1998,347,190,157,242,97,145,76.32,0.763,0.697,0.618
223232,1998,2933,1712,1221,1261,405,856,50,0.5,0.43,0.332
224004,1998,127,75,52,23,8,15,20,0.2,0.181,0.154
224323,1998,291,188,103,207,67,140,74.47,0.745,0.711,0.65
225432,1998,696,406,290,8,3,5,1.23,0.012,0.011,0.01
225548,1998,315,143,172,66,25,41,28.67,0.287,0.21,0.145
225627,1998,375,265,110,59,10,49,18.49,0.185,0.157,0.091
226231,1998,257,55,202,72,48,24,43.64,0.436,0.28,0.238
226833,1998,685,350,335,74,26,48,13.71,0.137,0.108,0.078
227216,1998,2449,1400,1049,363,105,258,18.43,0.184,0.148,0.1
227331,1998,310,251,59,50,2,48,19.12,0.191,0.161,0.034
227526,1998,1197,626,571,132,42,90,14.38,0.144,0.11,0.074
227757,1998,642,320,322,489,228,261,81.56,0.816,0.762,0.708
227845,1998,367,212,155,95,34,61,28.77,0.288,0.259,0.219
227863,1998,231,153,78,65,12,53,34.64,0.346,0.281,0.154
228042,1998,198,118,80,39,17,22,18.64,0.186,0.197,0.212
228149,1998,499,313,186,147,49,98,31.31,0.313,0.295,0.263
228246,1998,1306,720,586,689,249,440,61.11,0.611,0.528,0.425
228343,1998,378,218,160,227,74,153,70.18,0.702,0.601,0.462
228431,1998,2348,1432,916,388,69,319,22.28,0.223,0.165,0.075
228459,1998,2592,1546,1046,458,127,331,21.41,0.214,0.177,0.121
228501,1998,316,113,203,26,10,16,14.16,0.142,0.082,0.049
228529,1998,605,296,309,102,44,58,19.59,0.196,0.169,0.142
228705,1998,872,375,497,73,34,39,10.4,0.104,0.084,0.068
228723,1998,7322,3701,3621,2350,782,1568,42.37,0.424,0.321,0.216
228769,1998,1241,568,673,155,64,91,16.02,0.16,0.125,0.095
228778,1998,6598,3388,3210,2590,1036,1554,45.87,0.459,0.393,0.323
228787,1998,494,213,281,187,98,89,41.78,0.418,0.379,0.349
228796,1998,1639,847,792,58,21,37,4.37,0.044,0.035,0.027
228875,1998,1397,839,558,587,177,410,48.87,0.489,0.42,0.317
228981,1998,366,180,186,101,34,67,37.22,0.372,0.276,0.183
229018,1998,112,69,43,19,7,12,17.39,0.174,0.17,0.163
229027,1998,2067,1099,968,152,38,114,10.37,0.104,0.074,0.039
229115,1998,3149,1581,1568,804,283,521,32.95,0.33,0.255,0.18
229780,1998,244,120,124,37,9,28,23.33,0.233,0.152,0.073
229814,1998,884,465,419,140,42,98,21.08,0.211,0.158,0.1
230603,1998,667,487,180,113,7,106,21.77,0.218,0.169,0.039
230728,1998,1764,1229,535,328,43,285,23.19,0.232,0.186,0.08
230764,1998,1702,991,711,363,116,247,24.92,0.249,0.213,0.163
230782,1998,1453,935,518,147,36,111,11.87,0.119,0.101,0.069
231059,1998,518,278,240,378,166,212,76.26,0.763,0.73,0.692
231174,1998,1758,994,764,872,336,536,53.92,0.539,0.496,0.44
231420,1998,145,78,67,31,18,13,16.67,0.167,0.214,0.269
231554,1998,129,69,60,4,1,3,4.35,0.044,0.031,0.017
231624,1998,1290,701,589,1007,412,595,84.88,0.849,0.781,0.699
231712,1998,693,414,279,121,35,86,20.77,0.208,0.175,0.125
232025,1998,290,144,146,120,43,77,53.47,0.535,0.414,0.295
232043,1998,229,130,99,107,43,64,49.23,0.492,0.467,0.434
232089,1998,305,128,177,60,29,31,24.22,0.242,0.197,0.164
232186,1998,2022,1112,910,540,164,376,33.81,0.338,0.267,0.18
232265,1998,1153,715,438,461,105,356,49.79,0.498,0.4,0.24
232423,1998,2971,1788,1183,1830,546,1284,71.81,0.718,0.616,0.462
232557,1998,1020,479,541,327,126,201,41.96,0.42,0.321,0.233
232566,1998,812,539,273,362,91,271,50.28,0.503,0.446,0.333
232609,1998,433,267,166,218,65,153,57.3,0.573,0.503,0.392
232681,1998,812,557,255,530,156,374,67.15,0.672,0.653,0.612
232706,1998,262,177,85,100,24,76,42.94,0.429,0.382,0.282
232937,1998,1092,680,412,95,26,69,10.15,0.102,0.087,0.063
232982,1998,1561,904,657,324,82,242,26.77,0.268,0.208,0.125
233277,1998,1518,1011,507,569,154,415,41.05,0.41,0.375,0.304
233374,1998,739,358,381,576,281,295,82.4,0.824,0.779,0.738
233426,1998,426,272,154,222,68,154,56.62,0.566,0.521,0.442
233541,1998,288,178,110,80,19,61,34.27,0.343,0.278,0.173
233897,1998,297,146,151,57,18,39,26.71,0.267,0.192,0.119
233921,1998,4638,1941,2697,1999,855,1144,58.94,0.589,0.431,0.317
234030,1998,2141,1257,884,364,117,247,19.65,0.196,0.17,0.132
234085,1998,375,23,352,180,174,6,26.09,0.261,0.48,0.494
234155,1998,871,526,345,192,48,144,27.38,0.274,0.22,0.139
234164,1998,313,191,122,61,15,46,24.08,0.241,0.195,0.123
235097,1998,816,486,330,148,34,114,23.46,0.235,0.181,0.103
235167,1998,475,280,195,185,65,120,42.86,0.429,0.389,0.333
236230,1998,652,414,238,272,77,195,47.1,0.471,0.417,0.324
236328,1998,680,417,263,446,151,295,70.74,0.707,0.656,0.574
236577,1998,582,376,206,232,75,157,41.76,0.418,0.399,0.364
236595,1998,626,369,257,287,114,173,46.88,0.469,0.458,0.444
236896,1998,305,165,140,60,27,33,20,0.2,0.197,0.193
236939,1998,2934,1526,1408,888,335,553,36.24,0.362,0.303,0.238
236948,1998,4038,2076,1962,1716,718,998,48.07,0.481,0.425,0.366
237011,1998,2104,1221,883,623,202,421,34.48,0.345,0.296,0.229
237057,1998,386,204,182,286,132,154,75.49,0.755,0.741,0.725
237066,1998,373,224,149,197,74,123,54.91,0.549,0.528,0.497
237215,1998,426,215,211,7,4,3,1.4,0.014,0.016,0.019
237330,1998,545,293,252,74,30,44,15.02,0.15,0.136,0.119
237358,1998,152,87,65,66,29,37,42.53,0.425,0.434,0.446
237367,1998,555,311,244,93,27,66,21.22,0.212,0.168,0.111
237792,1998,610,356,254,93,23,70,19.66,0.197,0.152,0.091
237899,1998,551,282,269,31,13,18,6.38,0.064,0.056,0.048
237932,1998,498,268,230,96,35,61,22.76,0.228,0.193,0.152
237969,1998,472,247,225,204,74,130,52.63,0.526,0.432,0.329
238032,1998,3335,1571,1764,818,348,470,29.92,0.299,0.245,0.197
238333,1998,302,180,122,166,58,108,60,0.6,0.55,0.475
238430,1998,224,140,84,71,28,43,30.71,0.307,0.317,0.333
238458,1998,414,296,118,156,31,125,42.23,0.422,0.377,0.263
238476,1998,432,216,216,190,86,104,48.15,0.482,0.44,0.398
238616,1998,337,187,150,126,46,80,42.78,0.428,0.374,0.307
238661,1998,213,157,56,55,13,42,26.75,0.268,0.258,0.232
239080,1998,204,137,67,64,20,44,32.12,0.321,0.314,0.299
239105,1998,1730,952,778,960,355,605,63.55,0.635,0.555,0.456
239628,1998,162,66,96,99,55,44,66.67,0.667,0.611,0.573
239716,1998,460,247,213,282,106,176,71.26,0.713,0.613,0.498
240107,1998,318,220,98,88,21,67,30.45,0.304,0.277,0.214
240189,1998,1901,965,936,354,122,232,24.04,0.24,0.186,0.13
240277,1998,946,612,334,155,53,102,16.67,0.167,0.164,0.159
240329,1998,1740,1123,617,450,128,322,28.67,0.287,0.259,0.207
240338,1998,124,80,44,60,20,40,50,0.5,0.484,0.455
240365,1998,1894,1095,799,252,67,185,16.89,0.169,0.133,0.084
240374,1998,790,441,349,83,24,59,13.38,0.134,0.105,0.069
240417,1998,1333,614,719,209,74,135,21.99,0.22,0.157,0.103
240426,1998,376,218,158,55,16,39,17.89,0.179,0.146,0.101
240444,1998,5548,3038,2510,2190,844,1346,44.31,0.443,0.395,0.336
240453,1998,2513,1367,1146,273,102,171,12.51,0.125,0.109,0.089
240462,1998,1118,369,749,134,63,71,19.24,0.192,0.12,0.084
240471,1998,1199,773,426,287,87,200,25.87,0.259,0.239,0.204
240480,1998,1503,868,635,310,85,225,25.92,0.259,0.206,0.134
240727,1998,1225,660,565,306,104,202,30.61,0.306,0.25,0.184
243443,1998,885,567,318,76,10,66,11.64,0.116,0.086,0.031
243780,1998,6625,2825,3800,2040,998,1042,36.88,0.369,0.308,0.263
100654,1999,1111,550,561,97,16,81,14.73,0.147,0.087,0.029
100663,1999,1143,678,465,163,59,104,15.34,0.153,0.143,0.127
100751,1999,2687,1499,1188,948,309,639,42.63,0.426,0.353,0.26
100858,1999,3693,1875,1818,1189,393,796,42.45,0.425,0.322,0.216
101435,1999,163,103,60,58,14,44,42.72,0.427,0.356,0.233
101480,1999,805,455,350,142,44,98,21.54,0.215,0.176,0.126
101675,1999,319,170,149,113,21,92,54.12,0.541,0.354,0.141
101879,1999,809,473,336,127,28,99,20.93,0.209,0.157,0.083
102049,1999,674,420,254,353,120,233,55.48,0.555,0.524,0.472
102094,1999,882,521,361,122,22,100,19.19,0.192,0.138,0.061
102234,1999,299,182,117,147,43,104,57.14,0.571,0.492,0.368
102368,1999,845,510,335,271,85,186,36.47,0.365,0.321,0.254
102377,1999,679,400,279,119,27,92,23,0.23,0.175,0.097
104151,1999,5625,3096,2529,1505,522,983,31.75,0.318,0.268,0.206
104179,1999,5126,2745,2381,1626,623,1003,36.54,0.365,0.317,0.262
105330,1999,2162,1278,884,562,166,396,30.99,0.31,0.26,0.188
106245,1999,826,518,308,51,12,39,7.53,0.075,0.062,0.039
106342,1999,141,79,62,82,33,49,62.03,0.62,0.582,0.532
106397,1999,2189,1123,1066,666,235,431,38.38,0.384,0.304,0.22
106412,1999,656,341,315,76,20,56,16.42,0.164,0.116,0.063
106458,1999,1654,937,717,303,92,211,22.52,0.225,0.183,0.128
106467,1999,1055,508,547,146,55,91,17.91,0.179,0.138,0.101
106485,1999,685,370,315,53,15,38,10.27,0.103,0.077,0.048
106704,1999,1729,1030,699,272,86,186,18.06,0.181,0.157,0.123
107044,1999,941,488,453,313,130,183,37.5,0.375,0.333,0.287
107080,1999,330,181,149,183,74,109,60.22,0.602,0.555,0.497
107141,1999,267,149,118,113,39,74,49.66,0.497,0.423,0.331
107512,1999,443,256,187,197,72,125,48.83,0.488,0.445,0.385
107558,1999,164,93,71,53,17,36,38.71,0.387,0.323,0.239
110097,1999,563,373,190,370,123,247,66.22,0.662,0.657,0.647
110404,1999,234,83,151,195,126,69,83.13,0.831,0.833,0.834
110422,1999,2673,1277,1396,557,167,390,30.54,0.305,0.208,0.12
110486,1999,517,319,198,69,14,55,17.24,0.172,0.133,0.071
110495,1999,470,310,160,101,16,85,27.42,0.274,0.215,0.1
110510,1999,1049,679,370,105,30,75,11.05,0.111,0.1,0.081
110529,1999,2489,1008,1481,226,90,136,13.49,0.135,0.091,0.061
110538,1999,2007,1139,868,304,67,237,20.81,0.208,0.151,0.077
110547,1999,453,319,134,26,5,21,6.58,0.066,0.057,0.037
110556,1999,1703,1002,701,225,56,169,16.87,0.169,0.132,0.08
110565,1999,2544,1543,1001,349,63,286,18.54,0.185,0.137,0.063
110574,1999,714,466,248,119,26,93,19.96,0.2,0.167,0.105
110583,1999,3309,2128,1181,361,75,286,13.44,0.134,0.109,0.064
110592,1999,1186,750,436,111,32,79,10.53,0.105,0.094,0.073
110617,1999,1753,1013,740,159,39,120,11.85,0.118,0.091,0.053
113698,1999,111,88,23,50,10,40,45.45,0.454,0.45,0.435
115755,1999,751,436,315,89,25,64,14.68,0.147,0.119,0.079
119173,1999,294,293,1,57,0,57,19.45,0.194,0.194,0
120184,1999,129,85,44,50,17,33,38.82,0.388,0.388,0.386
121309,1999,613,392,221,332,117,215,54.85,0.548,0.542,0.529
121345,1999,390,194,196,338,167,171,88.14,0.881,0.867,0.852
122409,1999,2834,1574,1260,394,119,275,17.47,0.175,0.139,0.094
122436,1999,990,621,369,611,204,407,65.54,0.655,0.617,0.553
122597,1999,1898,1158,740,178,54,124,10.71,0.107,0.094,0.073
122612,1999,757,500,257,379,109,270,54,0.54,0.501,0.424
122931,1999,1101,619,482,854,358,496,80.13,0.801,0.776,0.743
123554,1999,629,363,266,369,142,227,62.53,0.625,0.587,0.534
123572,1999,844,555,289,161,24,137,24.68,0.247,0.191,0.083
126562,1999,478,259,219,76,30,46,17.76,0.178,0.159,0.137
126580,1999,682,395,287,104,35,69,17.47,0.175,0.152,0.122
126614,1999,4545,2303,2242,1728,700,1028,44.64,0.446,0.38,0.312
126818,1999,3076,1702,1374,1054,371,683,40.13,0.401,0.343,0.27
127060,1999,812,410,402,420,181,239,58.29,0.583,0.517,0.45
127185,1999,1019,429,590,102,37,65,15.15,0.152,0.1,0.063
127565,1999,1440,764,676,86,40,46,6.02,0.06,0.06,0.059
127741,1999,2291,1401,890,589,129,460,32.83,0.328,0.257,0.145
128106,1999,611,326,285,76,27,49,15.03,0.15,0.124,0.095
128744,1999,190,96,94,39,15,24,25,0.25,0.205,0.16
128771,1999,1280,559,721,143,47,96,17.17,0.172,0.112,0.065
129020,1999,2940,1596,1344,1454,523,931,58.33,0.583,0.495,0.389
129242,1999,837,446,391,662,287,375,84.08,0.841,0.791,0.734
129941,1999,322,117,205,66,32,34,29.06,0.291,0.205,0.156
130253,1999,718,416,302,401,141,260,62.5,0.625,0.558,0.467
130314,1999,144,144,0,61,0,61,42.36,0.424,0.424,NA
130493,1999,1238,702,536,148,50,98,13.96,0.14,0.12,0.093
130590,1999,565,286,279,442,206,236,82.52,0.825,0.782,0.738
130697,1999,732,375,357,609,283,326,86.93,0.869,0.832,0.793
130776,1999,697,359,338,70,22,48,13.37,0.134,0.1,0.065
130794,1999,1358,682,676,1219,594,625,91.64,0.916,0.898,0.879
130934,1999,632,375,257,132,37,95,25.33,0.253,0.209,0.144
130943,1999,3513,2146,1367,2193,764,1429,66.59,0.666,0.624,0.559
131159,1999,1146,744,402,723,231,492,66.13,0.661,0.631,0.575
131283,1999,762,381,381,457,204,253,66.4,0.664,0.6,0.535
131450,1999,254,135,119,14,6,8,5.93,0.059,0.055,0.05
131469,1999,2109,1282,827,1515,556,959,74.8,0.748,0.718,0.672
131496,1999,1474,802,672,1299,587,712,88.78,0.888,0.881,0.874
131520,1999,937,632,305,405,99,306,48.42,0.484,0.432,0.325
132471,1999,398,251,147,9,1,8,3.19,0.032,0.023,0.007
132602,1999,677,360,317,134,36,98,27.22,0.272,0.198,0.114
132903,1999,4267,2256,2011,1298,425,873,38.7,0.387,0.304,0.211
133492,1999,403,210,193,232,101,131,62.38,0.624,0.576,0.523
133553,1999,939,151,788,305,245,60,39.74,0.397,0.325,0.311
133650,1999,2205,1277,928,360,86,274,21.46,0.215,0.163,0.093
133669,1999,1423,860,563,201,56,145,16.86,0.169,0.141,0.099
133711,1999,419,267,152,186,61,125,46.82,0.468,0.444,0.401
133881,1999,402,116,286,139,95,44,37.93,0.379,0.346,0.332
133951,1999,2482,1460,1022,525,141,384,26.3,0.263,0.212,0.138
134079,1999,425,267,158,173,55,118,44.19,0.442,0.407,0.348
134097,1999,5078,2934,2144,2244,793,1451,49.45,0.495,0.442,0.37
134130,1999,6065,3388,2677,3191,1111,2080,61.39,0.614,0.526,0.415
134945,1999,309,122,187,98,49,49,40.16,0.402,0.317,0.262
135726,1999,1845,998,847,1031,439,592,59.32,0.593,0.559,0.518
136172,1999,1501,886,615,375,97,278,31.38,0.314,0.25,0.158
136950,1999,448,267,181,220,87,133,49.81,0.498,0.491,0.481
137546,1999,548,325,223,312,119,193,59.38,0.594,0.569,0.534
138354,1999,637,335,302,132,54,78,23.28,0.233,0.207,0.179
138716,1999,648,424,224,92,23,69,16.27,0.163,0.142,0.103
138789,1999,602,386,216,35,10,25,6.48,0.065,0.058,0.046
139144,1999,401,243,158,197,69,128,52.67,0.527,0.491,0.437
139366,1999,672,412,260,54,13,41,9.95,0.099,0.08,0.05
139393,1999,228,144,84,124,45,79,54.86,0.549,0.544,0.536
139658,1999,1515,870,645,1148,486,662,76.09,0.761,0.758,0.753
139719,1999,406,206,200,36,9,27,13.11,0.131,0.089,0.045
139755,1999,2293,654,1639,657,431,226,34.56,0.346,0.287,0.263
139764,1999,259,161,98,42,14,28,17.39,0.174,0.162,0.143
139861,1999,786,486,300,164,36,128,26.34,0.263,0.209,0.12
139931,1999,3266,1729,1537,384,98,286,16.54,0.165,0.118,0.064
139940,1999,1772,1082,690,242,69,173,15.99,0.16,0.137,0.1
139959,1999,4375,2586,1789,1860,592,1268,49.03,0.49,0.425,0.331
140447,1999,730,449,281,254,79,175,38.98,0.39,0.348,0.281
140960,1999,281,150,131,18,4,14,9.33,0.093,0.064,0.031
140988,1999,259,171,88,103,32,71,41.52,0.415,0.398,0.364
141185,1999,216,135,81,65,19,46,34.07,0.341,0.301,0.235
141264,1999,1177,735,442,211,52,159,21.63,0.216,0.179,0.118
141334,1999,1604,1005,599,144,34,110,10.95,0.11,0.09,0.057
141486,1999,231,159,72,49,12,37,23.27,0.233,0.212,0.167
141565,1999,366,207,159,39,11,28,13.53,0.135,0.107,0.069
141574,1999,1421,793,628,164,56,108,13.62,0.136,0.115,0.089
142276,1999,1345,740,605,45,10,35,4.73,0.047,0.033,0.017
142285,1999,1457,736,721,318,123,195,26.49,0.265,0.218,0.171
142461,1999,295,165,130,88,31,57,34.55,0.346,0.298,0.238
143084,1999,565,338,227,402,161,241,71.3,0.713,0.712,0.709
143288,1999,145,76,69,44,21,23,30.26,0.303,0.303,0.304
144005,1999,461,329,132,9,3,6,1.82,0.018,0.02,0.023
144281,1999,1134,560,574,225,103,122,21.79,0.218,0.198,0.179
144740,1999,1700,997,703,771,299,472,47.34,0.473,0.454,0.425
144892,1999,1478,929,549,482,131,351,37.78,0.378,0.326,0.239
144962,1999,269,156,113,158,58,100,64.1,0.641,0.587,0.513
144971,1999,130,76,54,60,19,41,53.95,0.54,0.462,0.352
145600,1999,2552,1381,1171,506,215,291,21.07,0.211,0.198,0.184
145619,1999,259,127,132,74,30,44,34.65,0.346,0.286,0.227
145637,1999,6458,3131,3327,3849,1733,2116,67.58,0.676,0.596,0.521
145691,1999,241,131,110,97,34,63,48.09,0.481,0.402,0.309
145813,1999,3067,1907,1160,1072,301,771,40.43,0.404,0.35,0.259
146481,1999,341,208,133,216,80,136,65.38,0.654,0.633,0.602
146612,1999,425,194,231,171,82,89,45.88,0.459,0.402,0.355
146719,1999,1067,717,350,541,169,372,51.88,0.519,0.507,0.483
146825,1999,187,80,107,55,25,30,37.5,0.375,0.294,0.234
147013,1999,246,164,82,101,27,74,45.12,0.451,0.411,0.329
147244,1999,595,324,271,323,130,193,59.57,0.596,0.543,0.48
147341,1999,259,155,104,132,44,88,56.77,0.568,0.51,0.423
147703,1999,2924,1587,1337,742,285,457,28.8,0.288,0.254,0.213
147767,1999,1951,1039,912,1657,746,911,87.68,0.877,0.849,0.818
147776,1999,943,573,370,22,7,15,2.62,0.026,0.023,0.019
147828,1999,410,224,186,169,61,108,48.21,0.482,0.412,0.328
148131,1999,273,148,125,98,36,62,41.89,0.419,0.359,0.288
148496,1999,195,144,51,112,28,84,58.33,0.583,0.574,0.549
148584,1999,170,101,69,54,14,40,39.6,0.396,0.318,0.203
148627,1999,325,196,129,96,33,63,32.14,0.321,0.295,0.256
149222,1999,2547,1094,1453,483,234,249,22.76,0.228,0.19,0.161
149231,1999,1357,800,557,253,66,187,23.38,0.234,0.186,0.118
149772,1999,1690,856,834,542,215,327,38.2,0.382,0.321,0.258
149781,1999,583,311,272,450,204,246,79.1,0.791,0.772,0.75
150066,1999,498,304,194,206,61,145,47.7,0.477,0.414,0.314
150136,1999,3602,1931,1671,943,348,595,30.81,0.308,0.262,0.208
150145,1999,265,156,109,98,30,68,43.59,0.436,0.37,0.275
150163,1999,861,529,332,470,168,302,57.09,0.571,0.546,0.506
150400,1999,579,327,252,436,194,242,74.01,0.74,0.753,0.77
150534,1999,594,367,227,276,97,179,48.77,0.488,0.465,0.427
150668,1999,220,135,85,90,30,60,44.44,0.444,0.409,0.353
150941,1999,221,140,81,127,43,84,60,0.6,0.575,0.531
151102,1999,1303,688,615,48,16,32,4.65,0.047,0.037,0.026
151111,1999,2552,1409,1143,166,67,99,7.03,0.07,0.065,0.059
151306,1999,1674,1003,671,200,49,151,15.05,0.151,0.119,0.073
151324,1999,2014,998,1016,352,132,220,22.04,0.22,0.175,0.13
151333,1999,295,213,82,27,7,20,9.39,0.094,0.092,0.085
151342,1999,637,382,255,37,10,27,7.07,0.071,0.058,0.039
151351,1999,6503,3828,2675,3137,1138,1999,52.22,0.522,0.482,0.425
151360,1999,540,345,195,45,16,29,8.41,0.084,0.083,0.082
151379,1999,719,448,271,54,13,41,9.15,0.092,0.075,0.048
151388,1999,255,161,94,10,1,9,5.59,0.056,0.039,0.011
151777,1999,328,166,162,132,41,91,54.82,0.548,0.402,0.253
151786,1999,251,181,70,88,19,69,38.12,0.381,0.351,0.271
152080,1999,1967,932,1035,1739,880,859,92.17,0.922,0.884,0.85
152248,1999,1112,593,519,42,13,29,4.89,0.049,0.038,0.025
152363,1999,290,122,168,114,56,58,47.54,0.475,0.393,0.333
152530,1999,473,256,217,341,142,199,77.73,0.777,0.721,0.654
152600,1999,730,376,354,429,192,237,63.03,0.63,0.588,0.542
153001,1999,322,144,178,146,69,77,53.47,0.535,0.453,0.388
153108,1999,403,219,184,7,0,7,3.2,0.032,0.017,0
153269,1999,670,364,306,371,151,220,60.44,0.604,0.554,0.493
153384,1999,325,168,157,271,126,145,86.31,0.863,0.834,0.803
153603,1999,4020,1830,2190,1261,520,741,40.49,0.405,0.314,0.237
153834,1999,606,354,252,393,155,238,67.23,0.672,0.649,0.615
154095,1999,2122,1303,819,713,211,502,38.53,0.385,0.336,0.258
155089,1999,226,125,101,36,13,23,18.4,0.184,0.159,0.129
155317,1999,3784,2099,1685,1155,374,781,37.21,0.372,0.305,0.222
155335,1999,148,87,61,50,18,32,36.78,0.368,0.338,0.295
155399,1999,3280,1574,1706,723,288,435,27.64,0.276,0.22,0.169
155520,1999,205,111,94,71,28,43,38.74,0.387,0.346,0.298
155627,1999,136,50,86,22,10,12,24,0.24,0.162,0.116
155937,1999,110,63,47,61,20,41,65.08,0.651,0.555,0.426
156213,1999,326,198,128,200,76,124,62.63,0.626,0.613,0.594
156286,1999,324,223,101,182,54,128,57.4,0.574,0.562,0.535
156295,1999,423,233,190,150,57,93,39.91,0.399,0.355,0.3
156365,1999,290,155,135,77,31,46,29.68,0.297,0.266,0.23
156541,1999,403,201,202,114,41,73,36.32,0.363,0.283,0.203
156745,1999,340,205,135,158,51,107,52.2,0.522,0.465,0.378
157058,1999,366,186,180,40,8,32,17.2,0.172,0.109,0.044
157076,1999,191,102,89,51,18,33,32.35,0.324,0.267,0.202
157085,1999,2742,1499,1243,792,293,499,33.29,0.333,0.289,0.236
157289,1999,2297,1232,1065,289,90,199,16.15,0.161,0.126,0.085
157386,1999,1325,756,569,156,55,101,13.36,0.134,0.118,0.097
157401,1999,1177,666,511,345,114,231,34.68,0.347,0.293,0.223
157447,1999,1696,969,727,35,13,22,2.27,0.023,0.021,0.018
157535,1999,206,140,66,41,10,31,22.14,0.221,0.199,0.152
157951,1999,2480,1447,1033,568,204,364,25.16,0.252,0.229,0.197
158477,1999,270,162,108,112,34,78,48.15,0.482,0.415,0.315
159009,1999,690,367,323,88,24,64,17.44,0.174,0.128,0.074
159391,1999,5173,2956,2217,1262,398,864,29.23,0.292,0.244,0.18
159647,1999,1753,840,913,478,199,279,33.21,0.332,0.273,0.218
159717,1999,1275,636,639,127,34,93,14.62,0.146,0.1,0.053
159966,1999,1445,860,585,129,30,99,11.51,0.115,0.089,0.051
160038,1999,1656,988,668,184,71,113,11.44,0.114,0.111,0.106
160612,1999,2315,1361,954,170,44,126,9.26,0.093,0.073,0.046
160621,1999,1287,693,594,86,19,67,9.67,0.097,0.067,0.032
160658,1999,2402,1300,1102,298,94,204,15.69,0.157,0.124,0.085
161004,1999,464,259,205,418,183,235,90.73,0.907,0.901,0.893
161226,1999,470,344,126,197,48,149,43.31,0.433,0.419,0.381
161235,1999,109,64,45,17,3,14,21.88,0.219,0.156,0.067
161244,1999,121,83,38,15,4,11,13.25,0.132,0.124,0.105
161253,1999,1521,718,803,430,176,254,35.38,0.354,0.283,0.219
161554,1999,815,477,338,96,24,72,15.09,0.151,0.118,0.071
162007,1999,343,189,154,45,12,33,17.46,0.175,0.131,0.078
162210,1999,175,115,60,25,6,19,16.52,0.165,0.143,0.1
162283,1999,441,306,135,39,12,27,8.82,0.088,0.088,0.089
162584,1999,932,508,424,165,52,113,22.24,0.222,0.177,0.123
162654,1999,322,224,98,176,54,122,54.46,0.545,0.547,0.551
162760,1999,156,152,4,100,1,99,65.13,0.651,0.641,0.25
162928,1999,1098,441,657,868,503,365,82.77,0.828,0.791,0.766
163046,1999,941,530,411,734,292,442,83.4,0.834,0.78,0.71
163268,1999,1396,638,758,417,188,229,35.89,0.359,0.299,0.248
163286,1999,3871,1796,2075,1943,884,1059,58.96,0.59,0.502,0.426
163453,1999,1152,661,491,208,41,167,25.26,0.253,0.181,0.084
163462,1999,369,221,148,238,94,144,65.16,0.652,0.645,0.635
163851,1999,877,537,340,458,149,309,57.54,0.575,0.522,0.438
163912,1999,276,157,119,176,70,106,67.52,0.675,0.638,0.588
164076,1999,2103,1277,826,610,170,440,34.46,0.345,0.29,0.206
164173,1999,421,288,133,211,60,151,52.43,0.524,0.501,0.451
164216,1999,282,175,107,175,54,121,69.14,0.691,0.621,0.505
164270,1999,412,204,208,261,107,154,75.49,0.755,0.633,0.514
164447,1999,240,92,148,77,33,44,47.83,0.478,0.321,0.223
164492,1999,134,90,44,64,23,41,45.56,0.456,0.478,0.523
164562,1999,592,361,231,404,150,254,70.36,0.704,0.682,0.649
165015,1999,793,446,347,663,275,388,87,0.87,0.836,0.793
165024,1999,1079,657,422,208,43,165,25.11,0.251,0.193,0.102
165334,1999,486,304,182,308,112,196,64.47,0.645,0.634,0.615
165662,1999,653,361,292,433,192,241,66.76,0.668,0.663,0.658
165671,1999,133,133,0,60,0,60,45.11,0.451,0.451,NA
165820,1999,345,202,143,73,23,50,24.75,0.248,0.212,0.161
165866,1999,559,402,157,130,27,103,25.62,0.256,0.233,0.172
165936,1999,382,243,139,205,61,144,59.26,0.593,0.537,0.439
166027,1999,1647,775,872,1429,757,672,86.71,0.867,0.868,0.868
166124,1999,722,383,339,645,298,347,90.6,0.906,0.893,0.879
166513,1999,935,368,567,230,91,139,37.77,0.378,0.246,0.16
166629,1999,4144,2199,1945,1824,701,1123,51.07,0.511,0.44,0.36
166638,1999,671,368,303,102,33,69,18.75,0.188,0.152,0.109
166683,1999,1049,448,601,863,473,390,87.05,0.87,0.823,0.787
167288,1999,220,135,85,78,27,51,37.78,0.378,0.355,0.318
167987,1999,1131,556,575,316,126,190,34.17,0.342,0.279,0.219
167996,1999,572,333,239,458,185,273,81.98,0.82,0.801,0.774
168005,1999,672,381,291,240,72,168,44.09,0.441,0.357,0.247
168148,1999,1345,741,604,1134,497,637,85.96,0.86,0.843,0.823
168254,1999,618,271,347,268,145,123,45.39,0.454,0.434,0.418
168281,1999,427,281,146,298,85,213,75.8,0.758,0.698,0.582
168342,1999,544,264,280,487,244,243,92.05,0.92,0.895,0.871
168546,1999,411,219,192,275,110,165,75.34,0.753,0.669,0.573
168786,1999,347,227,120,93,32,61,26.87,0.269,0.268,0.267
169080,1999,1059,591,468,574,225,349,59.05,0.591,0.542,0.481
169798,1999,2767,1627,1140,298,93,205,12.6,0.126,0.108,0.082
169910,1999,1916,798,1118,78,44,34,4.26,0.043,0.041,0.039
170082,1999,2528,1553,975,512,163,349,22.47,0.225,0.203,0.167
170301,1999,755,455,300,485,184,301,66.15,0.662,0.642,0.613
170532,1999,369,187,182,270,128,142,75.94,0.759,0.732,0.703
170639,1999,505,242,263,71,30,41,16.94,0.169,0.141,0.114
170976,1999,5563,2853,2710,3879,1779,2100,73.61,0.736,0.697,0.656
171100,1999,6499,3674,2825,2580,833,1747,47.55,0.476,0.397,0.295
171128,1999,1137,276,861,259,183,76,27.54,0.275,0.228,0.213
171137,1999,690,334,356,88,30,58,17.37,0.174,0.128,0.084
171146,1999,492,289,203,49,15,34,11.76,0.118,0.1,0.074
171599,1999,181,74,107,63,32,31,41.89,0.419,0.348,0.299
172051,1999,1015,549,466,81,36,45,8.2,0.082,0.08,0.077
172699,1999,4302,2288,2014,864,306,558,24.39,0.244,0.201,0.152
173160,1999,479,315,164,295,98,197,62.54,0.625,0.616,0.598
173258,1999,507,257,250,410,199,211,82.1,0.821,0.809,0.796
173328,1999,258,142,116,76,32,44,30.99,0.31,0.295,0.276
173647,1999,654,365,289,473,207,266,72.88,0.729,0.723,0.716
173902,1999,460,271,189,360,147,213,78.6,0.786,0.783,0.778
174066,1999,5025,2636,2389,1604,655,949,36,0.36,0.319,0.274
174233,1999,2000,1032,968,416,168,248,24.03,0.24,0.208,0.174
174251,1999,453,270,183,174,70,104,38.52,0.385,0.384,0.383
174491,1999,392,262,130,160,42,118,45.04,0.45,0.408,0.323
174792,1999,475,0,475,335,335,0,NA,NA,0.705,0.705
174844,1999,761,451,310,594,225,369,81.82,0.818,0.781,0.726
174899,1999,305,230,75,156,36,120,52.17,0.522,0.511,0.48
174914,1999,1087,603,484,642,255,387,64.18,0.642,0.591,0.527
175342,1999,553,309,244,130,41,89,28.8,0.288,0.235,0.168
175421,1999,144,71,73,46,25,21,29.58,0.296,0.319,0.342
175616,1999,458,275,183,107,38,69,25.09,0.251,0.234,0.208
175856,1999,845,527,318,128,34,94,17.84,0.178,0.151,0.107
175980,1999,284,158,126,177,67,110,69.62,0.696,0.623,0.532
176017,1999,1810,944,866,621,218,403,42.69,0.427,0.343,0.252
176035,1999,202,177,25,59,3,56,31.64,0.316,0.292,0.12
176044,1999,248,138,110,48,18,30,21.74,0.217,0.194,0.164
176080,1999,2033,1003,1030,507,177,330,32.9,0.329,0.249,0.172
176406,1999,252,196,56,73,11,62,31.63,0.316,0.29,0.196
176628,1999,113,81,32,45,7,38,46.91,0.469,0.398,0.219
176947,1999,228,108,120,62,25,37,34.26,0.343,0.272,0.208
176965,1999,1329,725,604,300,94,206,28.41,0.284,0.226,0.156
177418,1999,144,94,50,60,14,46,48.94,0.489,0.417,0.28
178059,1999,198,133,65,101,26,75,56.39,0.564,0.51,0.4
178341,1999,804,434,370,104,40,64,14.75,0.148,0.129,0.108
178387,1999,980,575,405,113,35,78,13.57,0.136,0.115,0.086
178396,1999,3871,2138,1733,1468,525,943,44.11,0.441,0.379,0.303
178402,1999,639,356,283,105,46,59,16.57,0.166,0.164,0.163
178411,1999,679,140,539,112,77,35,25,0.25,0.165,0.143
178420,1999,539,274,265,122,43,79,28.83,0.288,0.226,0.162
178615,1999,1446,884,562,594,201,393,44.46,0.445,0.411,0.358
179043,1999,303,177,126,152,61,91,51.41,0.514,0.502,0.484
179159,1999,1252,695,557,764,314,450,64.75,0.647,0.61,0.564
179557,1999,1391,816,575,320,87,233,28.55,0.286,0.23,0.151
179566,1999,2581,1439,1142,605,223,382,26.55,0.266,0.234,0.195
179867,1999,1369,684,685,1125,548,577,84.36,0.844,0.822,0.8
179894,1999,369,214,155,156,52,104,48.6,0.486,0.423,0.335
179946,1999,201,90,111,94,41,53,58.89,0.589,0.468,0.369
180179,1999,629,384,245,56,15,41,10.68,0.107,0.089,0.061
180461,1999,1894,891,1003,354,164,190,21.32,0.213,0.187,0.164
180522,1999,261,112,149,30,16,14,12.5,0.125,0.115,0.107
180984,1999,324,149,175,86,41,45,30.2,0.302,0.265,0.234
181002,1999,822,499,323,516,209,307,61.52,0.615,0.628,0.647
181020,1999,278,141,137,174,79,95,67.38,0.674,0.626,0.577
181127,1999,286,141,145,146,54,92,65.25,0.652,0.51,0.372
181215,1999,1035,579,456,212,71,141,24.35,0.244,0.205,0.156
181394,1999,1477,762,715,151,45,106,13.91,0.139,0.102,0.063
181446,1999,358,204,154,197,84,113,55.39,0.554,0.55,0.545
181464,1999,3592,1778,1814,807,317,490,27.56,0.276,0.225,0.175
181534,1999,192,87,105,65,31,34,39.08,0.391,0.339,0.295
181783,1999,659,387,272,150,41,109,28.17,0.282,0.228,0.151
182281,1999,1486,805,681,204,73,131,16.27,0.163,0.137,0.107
182290,1999,1466,792,674,241,78,163,20.58,0.206,0.164,0.116
182634,1999,236,151,85,115,47,68,45.03,0.45,0.487,0.553
182795,1999,429,184,245,189,103,86,46.74,0.467,0.441,0.42
183062,1999,1014,649,365,262,70,192,29.58,0.296,0.258,0.192
183080,1999,772,377,395,204,75,129,34.22,0.342,0.264,0.19
183239,1999,534,280,254,376,160,216,77.14,0.771,0.704,0.63
183822,1999,242,155,87,13,4,9,5.81,0.058,0.054,0.046
183974,1999,136,98,38,58,17,41,41.84,0.418,0.426,0.447
184348,1999,407,225,182,279,118,161,71.56,0.716,0.686,0.648
184603,1999,526,281,245,96,31,65,23.13,0.231,0.183,0.127
184612,1999,224,140,84,7,7,0,0,0,0.031,0.083
184782,1999,1119,587,532,436,183,253,43.1,0.431,0.39,0.344
185129,1999,603,331,272,54,18,36,10.88,0.109,0.09,0.066
185572,1999,833,457,376,295,99,196,42.89,0.429,0.354,0.263
185590,1999,1319,823,496,308,81,227,27.58,0.276,0.234,0.163
185828,1999,649,114,535,116,88,28,24.56,0.246,0.179,0.164
186131,1999,1148,556,592,1030,530,500,89.93,0.899,0.897,0.895
186201,1999,527,293,234,201,66,135,46.08,0.461,0.381,0.282
186283,1999,735,386,349,310,128,182,47.15,0.472,0.422,0.367
186584,1999,1063,533,530,437,190,247,46.34,0.463,0.411,0.358
186876,1999,705,409,296,254,86,168,41.08,0.411,0.36,0.291
187134,1999,1207,697,510,776,281,495,71.02,0.71,0.643,0.551
187444,1999,1105,614,491,177,56,121,19.71,0.197,0.16,0.114
187985,1999,2715,1517,1198,276,85,191,12.59,0.126,0.102,0.071
188030,1999,2210,1223,987,272,88,184,15.04,0.15,0.123,0.089
188429,1999,532,366,166,233,64,169,46.17,0.462,0.438,0.386
188641,1999,549,277,272,242,98,144,51.99,0.52,0.441,0.36
190044,1999,706,225,481,407,264,143,63.56,0.636,0.576,0.549
190099,1999,750,397,353,662,306,356,89.67,0.897,0.883,0.867
190150,1999,1298,573,725,1068,586,482,84.12,0.841,0.823,0.808
190248,1999,111,72,39,33,6,27,37.5,0.375,0.297,0.154
190415,1999,3158,1497,1661,2660,1341,1319,88.11,0.881,0.842,0.807
190512,1999,1133,593,540,312,124,188,31.7,0.317,0.275,0.23
190549,1999,982,591,391,166,55,111,18.78,0.188,0.169,0.141
190558,1999,1532,782,750,63,21,42,5.37,0.054,0.041,0.028
190567,1999,773,341,432,45,16,29,8.5,0.085,0.058,0.037
190594,1999,1806,1281,525,176,36,140,10.93,0.109,0.097,0.069
190637,1999,604,416,188,44,19,25,6.01,0.06,0.073,0.101
190664,1999,876,528,348,200,50,150,28.41,0.284,0.228,0.144
190691,1999,425,261,164,31,11,20,7.66,0.077,0.073,0.067
190725,1999,293,230,63,70,17,53,23.04,0.23,0.239,0.27
191241,1999,1538,891,647,1105,443,662,74.3,0.743,0.718,0.685
191515,1999,500,254,246,408,190,218,85.83,0.858,0.816,0.772
191533,1999,407,210,197,192,75,117,55.71,0.557,0.472,0.381
191630,1999,502,255,247,307,133,174,68.24,0.682,0.612,0.538
191649,1999,1876,1015,861,675,242,433,42.66,0.427,0.36,0.281
191676,1999,294,186,108,166,56,110,59.14,0.591,0.565,0.519
191931,1999,790,349,441,335,147,188,53.87,0.539,0.424,0.333
191968,1999,1586,885,701,1022,418,604,68.25,0.682,0.644,0.596
192192,1999,268,192,76,90,23,67,34.9,0.349,0.336,0.303
192323,1999,471,264,207,304,121,183,69.32,0.693,0.645,0.585
192439,1999,1010,719,291,38,12,26,3.62,0.036,0.038,0.041
192703,1999,645,289,356,386,195,191,66.09,0.661,0.598,0.548
192749,1999,387,266,121,195,57,138,51.88,0.519,0.504,0.471
192819,1999,975,548,427,665,260,405,73.91,0.739,0.682,0.609
192925,1999,143,104,39,31,6,25,24.04,0.24,0.217,0.154
193016,1999,953,630,323,68,18,50,7.94,0.079,0.071,0.056
193292,1999,209,156,53,84,11,73,46.79,0.468,0.402,0.208
193353,1999,323,247,76,156,25,131,53.04,0.53,0.483,0.329
193399,1999,240,167,73,76,18,58,34.73,0.347,0.317,0.247
193584,1999,334,244,90,205,51,154,63.11,0.631,0.614,0.567
193645,1999,814,670,144,152,16,136,20.3,0.203,0.187,0.111
193654,1999,573,399,174,234,55,179,44.86,0.449,0.408,0.316
193900,1999,3845,2323,1522,2245,868,1377,59.28,0.593,0.584,0.57
193973,1999,575,345,230,315,127,188,54.49,0.545,0.548,0.552
194161,1999,322,182,140,107,39,68,37.36,0.374,0.332,0.279
194310,1999,1500,895,605,604,205,399,44.58,0.446,0.403,0.339
194824,1999,1323,295,1028,812,611,201,68.14,0.681,0.614,0.594
195003,1999,2107,602,1505,366,187,179,29.73,0.297,0.174,0.124
195030,1999,1211,525,686,828,429,399,76,0.76,0.684,0.625
195164,1999,520,294,226,273,100,173,58.84,0.588,0.525,0.442
195173,1999,474,284,190,130,54,76,26.76,0.268,0.274,0.284
195216,1999,575,301,274,410,182,228,75.75,0.758,0.713,0.664
195234,1999,401,297,104,202,39,163,54.88,0.549,0.504,0.375
195243,1999,304,168,136,103,33,70,41.67,0.417,0.339,0.243
195304,1999,278,215,63,180,44,136,63.26,0.633,0.647,0.698
195474,1999,677,381,296,491,197,294,77.17,0.772,0.725,0.666
195526,1999,642,367,275,470,189,281,76.57,0.766,0.732,0.687
195544,1999,77,55,22,51,8,43,78.18,0.782,0.662,0.364
195809,1999,2650,1500,1150,954,357,597,39.8,0.398,0.36,0.31
196413,1999,2724,1534,1190,1841,748,1093,71.25,0.713,0.676,0.629
196592,1999,1756,1210,546,152,50,102,8.43,0.084,0.087,0.092
197045,1999,365,221,144,158,49,109,49.32,0.493,0.433,0.34
197133,1999,633,381,252,543,209,334,87.66,0.877,0.858,0.829
197869,1999,2199,1186,1013,778,266,512,43.17,0.432,0.354,0.263
197984,1999,195,90,105,57,27,30,33.33,0.333,0.292,0.257
198385,1999,456,226,230,380,187,193,85.4,0.854,0.833,0.813
198464,1999,3255,1931,1324,822,266,556,28.79,0.288,0.253,0.201
198507,1999,402,247,155,109,22,87,35.22,0.352,0.271,0.142
198516,1999,999,637,362,701,232,469,73.63,0.736,0.702,0.641
198835,1999,288,168,120,117,37,80,47.62,0.476,0.406,0.308
198969,1999,378,123,255,53,23,30,24.39,0.244,0.14,0.09
199102,1999,1530,850,680,348,112,236,27.76,0.278,0.227,0.165
199111,1999,456,267,189,128,48,80,29.96,0.3,0.281,0.254
199120,1999,3388,2099,1289,2389,797,1592,75.85,0.758,0.705,0.618
199139,1999,2078,1111,967,489,181,308,27.72,0.277,0.235,0.187
199148,1999,1908,1346,562,540,107,433,32.17,0.322,0.283,0.19
199157,1999,625,345,280,143,31,112,32.46,0.325,0.229,0.111
199193,1999,3636,1499,2137,1253,559,694,46.3,0.463,0.345,0.262
199218,1999,1649,1011,638,672,213,459,45.4,0.454,0.408,0.334
199281,1999,475,241,234,89,33,56,23.24,0.232,0.187,0.141
199306,1999,159,80,79,52,15,37,46.25,0.462,0.327,0.19
199412,1999,123,85,38,67,15,52,61.18,0.612,0.545,0.395
199582,1999,331,173,158,57,16,41,23.7,0.237,0.172,0.101
199643,1999,440,258,182,61,21,40,15.5,0.155,0.139,0.115
199847,1999,969,498,471,760,327,433,86.95,0.87,0.784,0.694
199962,1999,301,144,157,102,32,70,48.61,0.486,0.339,0.204
199999,1999,476,316,160,103,19,84,26.58,0.266,0.216,0.119
200004,1999,1151,569,582,261,103,158,27.77,0.278,0.227,0.177
200059,1999,359,179,180,39,15,24,13.41,0.134,0.109,0.083
200156,1999,284,165,119,84,31,53,32.12,0.321,0.296,0.261
200217,1999,373,242,131,155,42,113,46.69,0.467,0.416,0.321
200226,1999,140,71,69,41,15,26,36.62,0.366,0.293,0.217
200253,1999,433,251,182,40,11,29,11.55,0.116,0.092,0.06
200280,1999,1742,846,896,394,179,215,25.41,0.254,0.226,0.2
200332,1999,1268,514,754,240,111,129,25.1,0.251,0.189,0.147
200572,1999,158,76,82,35,8,27,35.53,0.355,0.222,0.098
201104,1999,541,313,228,246,80,166,53.04,0.53,0.455,0.351
201371,1999,248,156,92,114,32,82,52.56,0.526,0.46,0.348
201548,1999,532,301,231,255,101,154,51.16,0.512,0.479,0.437
201645,1999,762,292,470,432,245,187,64.04,0.64,0.567,0.521
201690,1999,294,164,130,46,12,34,20.73,0.207,0.156,0.092
202134,1999,1048,494,554,114,50,64,12.96,0.13,0.109,0.09
202480,1999,1744,921,823,1041,412,629,68.3,0.683,0.597,0.501
202523,1999,587,335,252,444,171,273,81.49,0.815,0.756,0.679
202763,1999,522,337,185,212,52,160,47.48,0.475,0.406,0.281
203085,1999,259,98,161,124,61,63,64.29,0.643,0.479,0.379
203128,1999,279,143,136,153,64,89,62.24,0.622,0.548,0.471
203368,1999,833,451,382,539,204,335,74.28,0.743,0.647,0.534
203517,1999,3476,2160,1316,668,187,481,22.27,0.223,0.192,0.142
203535,1999,459,255,204,367,166,201,78.82,0.788,0.8,0.814
203580,1999,103,70,33,36,8,28,40,0.4,0.35,0.242
203775,1999,406,248,158,160,47,113,45.56,0.456,0.394,0.297
203845,1999,302,136,166,149,70,79,58.09,0.581,0.493,0.422
204024,1999,3588,2030,1558,2351,922,1429,70.39,0.704,0.655,0.592
204185,1999,601,323,278,292,86,206,63.78,0.638,0.486,0.309
204194,1999,393,231,162,145,49,96,41.56,0.416,0.369,0.302
204617,1999,186,120,66,68,16,52,43.33,0.433,0.366,0.242
204796,1999,6067,3029,3038,2120,777,1343,44.34,0.443,0.349,0.256
204857,1999,3389,1977,1412,1553,490,1063,53.77,0.538,0.458,0.347
206330,1999,121,40,81,45,20,25,62.5,0.625,0.372,0.247
206589,1999,513,265,248,372,164,208,78.49,0.785,0.725,0.661
206604,1999,2127,1202,925,352,99,253,21.05,0.211,0.165,0.107
206622,1999,771,464,307,540,213,327,70.47,0.705,0.7,0.694
206695,1999,1911,954,957,241,89,152,15.93,0.159,0.126,0.093
206914,1999,673,355,318,54,16,38,10.7,0.107,0.08,0.05
207209,1999,446,232,214,17,4,13,5.6,0.056,0.038,0.019
207306,1999,310,138,172,36,16,20,14.49,0.145,0.116,0.093
207324,1999,391,219,172,123,44,79,36.07,0.361,0.315,0.256
207388,1999,2795,1491,1304,705,206,499,33.47,0.335,0.252,0.158
207500,1999,3206,1603,1603,619,237,382,23.83,0.238,0.193,0.148
207722,1999,229,133,96,32,12,20,15.04,0.15,0.14,0.125
207847,1999,572,307,265,67,26,41,13.36,0.134,0.117,0.098
207865,1999,779,448,331,116,35,81,18.08,0.181,0.149,0.106
208822,1999,282,163,119,145,48,97,59.51,0.595,0.514,0.403
209056,1999,510,307,203,330,127,203,66.12,0.661,0.647,0.626
209065,1999,397,227,170,227,74,153,67.4,0.674,0.572,0.435
209542,1999,2772,1319,1453,847,333,514,38.97,0.39,0.306,0.229
209551,1999,2453,1393,1060,931,314,617,44.29,0.443,0.38,0.296
209612,1999,292,175,117,164,70,94,53.71,0.537,0.562,0.598
209807,1999,896,496,400,118,39,79,15.93,0.159,0.132,0.098
209922,1999,331,182,149,172,78,94,51.65,0.516,0.52,0.523
210146,1999,754,431,323,136,46,90,20.88,0.209,0.18,0.142
210401,1999,363,190,173,242,100,142,74.74,0.747,0.667,0.578
210429,1999,770,460,310,141,45,96,20.87,0.209,0.183,0.145
210571,1999,392,242,150,203,61,142,58.68,0.587,0.518,0.407
210669,1999,562,284,278,374,167,207,72.89,0.729,0.665,0.601
210775,1999,204,101,103,79,34,45,44.55,0.446,0.387,0.33
211088,1999,307,238,69,154,28,126,52.94,0.529,0.502,0.406
211158,1999,1402,891,511,527,164,363,40.74,0.407,0.376,0.321
211291,1999,886,425,461,764,396,368,86.59,0.866,0.862,0.859
211352,1999,248,163,85,124,30,94,57.67,0.577,0.5,0.353
211361,1999,924,484,440,162,48,114,23.55,0.236,0.175,0.109
211431,1999,130,128,2,47,0,47,36.72,0.367,0.362,0
211440,1999,1255,487,768,833,491,342,70.23,0.702,0.664,0.639
211468,1999,218,218,0,115,0,115,52.75,0.527,0.528,NA
211556,1999,126,126,0,62,0,62,49.21,0.492,0.492,NA
211583,1999,102,101,1,45,1,44,43.56,0.436,0.441,1
211608,1999,254,152,102,37,9,28,18.42,0.184,0.146,0.088
211644,1999,1286,806,480,295,80,215,26.67,0.267,0.229,0.167
211981,1999,327,172,155,109,41,68,39.53,0.395,0.333,0.265
212009,1999,620,399,221,505,178,327,81.95,0.82,0.815,0.805
212054,1999,1898,725,1173,269,94,175,24.14,0.241,0.142,0.08
212106,1999,1211,686,525,590,216,374,54.52,0.545,0.487,0.411
212115,1999,843,522,321,163,42,121,23.18,0.232,0.193,0.131
212133,1999,379,274,105,190,41,149,54.38,0.544,0.501,0.39
212160,1999,1256,749,507,227,48,179,23.9,0.239,0.181,0.095
212197,1999,477,298,179,277,102,175,58.72,0.587,0.581,0.57
212577,1999,515,253,262,387,181,206,81.42,0.814,0.751,0.691
212601,1999,503,314,189,246,67,179,57.01,0.57,0.489,0.354
212832,1999,146,114,32,56,13,43,37.72,0.377,0.384,0.406
212911,1999,301,160,141,244,113,131,81.88,0.819,0.811,0.801
213020,1999,2552,1468,1084,561,165,396,26.98,0.27,0.22,0.152
213251,1999,324,184,140,217,81,136,73.91,0.739,0.67,0.579
213321,1999,420,218,202,268,112,156,71.56,0.716,0.638,0.554
213349,1999,1550,922,628,374,89,285,30.91,0.309,0.241,0.142
213358,1999,306,170,136,133,58,75,44.12,0.441,0.435,0.426
213367,1999,801,426,375,446,188,258,60.56,0.606,0.557,0.501
213385,1999,583,316,267,505,218,287,90.82,0.908,0.866,0.816
213507,1999,407,238,169,279,102,177,74.37,0.744,0.686,0.604
213543,1999,1077,455,622,799,437,362,79.56,0.796,0.742,0.703
213613,1999,887,502,385,212,65,147,29.28,0.293,0.239,0.169
213668,1999,392,209,183,242,99,143,68.42,0.684,0.617,0.541
213783,1999,611,364,247,178,53,125,34.34,0.343,0.291,0.215
213826,1999,282,207,75,118,25,93,44.93,0.449,0.418,0.333
213996,1999,678,413,265,468,168,300,72.64,0.726,0.69,0.634
214041,1999,1239,746,493,424,134,290,38.87,0.389,0.342,0.272
214069,1999,249,173,76,165,42,123,71.1,0.711,0.663,0.553
214157,1999,318,162,156,213,102,111,68.52,0.685,0.67,0.654
214175,1999,551,321,230,446,179,267,83.18,0.832,0.809,0.778
214272,1999,324,179,145,108,38,70,39.11,0.391,0.333,0.262
214777,1999,5058,2535,2523,2738,1142,1596,62.96,0.63,0.541,0.453
215062,1999,2402,1155,1247,2079,1056,1023,88.57,0.886,0.866,0.847
215743,1999,333,215,118,147,34,113,52.56,0.526,0.441,0.288
215798,1999,272,138,134,162,74,88,63.77,0.638,0.596,0.552
215929,1999,958,550,408,675,268,407,74,0.74,0.705,0.657
216010,1999,1377,734,643,574,231,343,46.73,0.467,0.417,0.359
216038,1999,1302,742,560,334,103,231,31.13,0.311,0.257,0.184
216287,1999,368,192,176,315,142,173,90.1,0.901,0.856,0.807
216339,1999,2747,1628,1119,721,228,493,30.28,0.303,0.262,0.204
216524,1999,337,173,164,241,106,135,78.03,0.78,0.715,0.646
216694,1999,277,126,151,121,64,57,45.24,0.452,0.437,0.424
216764,1999,1710,1069,641,444,122,322,30.12,0.301,0.26,0.19
216807,1999,351,224,127,228,69,159,70.98,0.71,0.65,0.543
216852,1999,548,250,298,213,100,113,45.2,0.452,0.389,0.336
216931,1999,377,161,216,166,88,78,48.45,0.485,0.44,0.407
217059,1999,909,511,398,372,122,250,48.92,0.489,0.409,0.307
217156,1999,1376,729,647,1146,539,607,83.26,0.833,0.833,0.833
217402,1999,973,556,417,838,351,487,87.59,0.876,0.861,0.842
217536,1999,528,352,176,277,69,208,59.09,0.591,0.525,0.392
217776,1999,99,47,52,35,12,23,48.94,0.489,0.354,0.231
217819,1999,2067,1399,668,850,206,644,46.03,0.46,0.411,0.308
217882,1999,2886,1354,1532,1267,490,777,57.39,0.574,0.439,0.32
217998,1999,156,91,65,100,33,67,73.63,0.736,0.641,0.508
218061,1999,570,332,238,104,27,77,23.19,0.232,0.182,0.113
218229,1999,494,313,181,107,22,85,27.16,0.272,0.217,0.122
218238,1999,136,58,78,27,13,14,24.14,0.241,0.199,0.167
218399,1999,263,173,90,53,10,43,24.86,0.249,0.202,0.111
218414,1999,179,70,109,59,18,41,58.57,0.586,0.33,0.165
218663,1999,2596,1511,1085,1073,367,706,46.72,0.467,0.413,0.338
218724,1999,757,405,352,161,60,101,24.94,0.249,0.213,0.17
218733,1999,680,351,329,143,37,106,30.2,0.302,0.21,0.112
218742,1999,540,334,206,87,24,63,18.86,0.189,0.161,0.117
218973,1999,307,154,153,226,112,114,74.03,0.74,0.736,0.732
219000,1999,469,314,155,231,65,166,52.87,0.529,0.493,0.419
219046,1999,630,360,270,71,17,54,15,0.15,0.113,0.063
219082,1999,306,124,182,45,21,24,19.35,0.194,0.147,0.115
219198,1999,121,84,37,34,8,26,30.95,0.31,0.281,0.216
219259,1999,523,303,220,69,15,54,17.82,0.178,0.132,0.068
219356,1999,1457,714,743,342,127,215,30.11,0.301,0.235,0.171
219471,1999,868,493,375,176,53,123,24.95,0.25,0.203,0.141
219602,1999,715,432,283,66,22,44,10.19,0.102,0.092,0.078
219709,1999,487,300,187,266,91,175,58.33,0.583,0.546,0.487
219718,1999,142,42,100,17,10,7,16.67,0.167,0.12,0.1
219949,1999,174,67,107,36,19,17,25.37,0.254,0.207,0.178
220075,1999,1466,821,645,217,62,155,18.88,0.189,0.148,0.096
220215,1999,322,187,135,125,59,66,35.29,0.353,0.388,0.437
220613,1999,690,400,290,213,80,133,33.25,0.332,0.309,0.276
220631,1999,113,80,33,35,9,26,32.5,0.325,0.31,0.273
220710,1999,313,174,139,141,50,91,52.3,0.523,0.45,0.36
221351,1999,438,251,187,338,143,195,77.69,0.777,0.772,0.765
221519,1999,391,227,164,308,123,185,81.5,0.815,0.788,0.75
221731,1999,140,93,47,22,3,19,20.43,0.204,0.157,0.064
221847,1999,1175,524,651,67,63,4,0.76,0.008,0.057,0.097
221892,1999,192,119,73,43,14,29,24.37,0.244,0.224,0.192
222178,1999,924,533,391,335,120,215,40.34,0.403,0.363,0.307
222983,1999,324,188,136,222,74,148,78.72,0.787,0.685,0.544
223232,1999,2766,1668,1098,1272,379,893,53.54,0.535,0.46,0.345
224004,1999,134,66,68,15,10,5,7.58,0.076,0.112,0.147
224323,1999,309,191,118,188,67,121,63.35,0.634,0.608,0.568
225432,1999,729,418,311,10,3,7,1.67,0.017,0.014,0.01
225548,1999,286,137,149,10,3,7,5.11,0.051,0.035,0.02
225627,1999,380,253,127,51,9,42,16.6,0.166,0.134,0.071
226231,1999,259,58,201,75,52,23,39.66,0.397,0.29,0.259
226833,1999,732,409,323,67,21,46,11.25,0.112,0.092,0.065
227216,1999,2687,1550,1137,410,111,299,19.29,0.193,0.153,0.098
227331,1999,308,241,67,44,10,34,14.11,0.141,0.143,0.149
227526,1999,967,504,463,113,33,80,15.87,0.159,0.117,0.071
227757,1999,670,325,345,512,251,261,80.31,0.803,0.764,0.728
227845,1999,357,184,173,101,35,66,35.87,0.359,0.283,0.202
227863,1999,215,128,87,50,16,34,26.56,0.266,0.233,0.184
228042,1999,225,148,77,44,7,37,25,0.25,0.196,0.091
228149,1999,485,277,208,165,54,111,40.07,0.401,0.34,0.26
228246,1999,1331,688,643,656,262,394,57.27,0.573,0.493,0.407
228343,1999,354,210,144,236,83,153,72.86,0.729,0.667,0.576
228431,1999,2255,1353,902,339,92,247,18.26,0.183,0.15,0.102
228459,1999,2447,1479,968,504,130,374,25.29,0.253,0.206,0.134
228501,1999,227,95,132,25,11,14,14.74,0.147,0.11,0.083
228529,1999,585,303,282,109,45,64,21.12,0.211,0.186,0.16
228705,1999,736,293,443,53,24,29,9.9,0.099,0.072,0.054
228723,1999,6659,3419,3240,2359,722,1637,47.88,0.479,0.354,0.223
228769,1999,1402,714,688,214,95,119,16.67,0.167,0.153,0.138
228778,1999,6925,3508,3417,2888,1186,1702,48.52,0.485,0.417,0.347
228787,1999,603,242,361,180,88,92,38.02,0.38,0.299,0.244
228796,1999,1662,874,788,79,22,57,6.52,0.065,0.048,0.028
228875,1999,1427,869,558,678,208,470,54.09,0.541,0.475,0.373
228981,1999,383,170,213,112,45,67,39.41,0.394,0.292,0.211
229018,1999,97,65,32,15,5,10,15.38,0.154,0.155,0.156
229027,1999,1665,882,783,105,32,73,8.28,0.083,0.063,0.041
229115,1999,3403,1725,1678,785,248,537,31.13,0.311,0.231,0.148
229780,1999,210,108,102,39,15,24,22.22,0.222,0.186,0.147
229814,1999,986,506,480,126,34,92,18.18,0.182,0.128,0.071
230603,1999,629,456,173,103,9,94,20.61,0.206,0.164,0.052
230728,1999,1521,1047,474,320,67,253,24.16,0.242,0.21,0.141
230764,1999,1921,921,1000,295,109,186,20.2,0.202,0.154,0.109
230782,1999,1619,1001,618,158,47,111,11.09,0.111,0.098,0.076
231059,1999,501,269,232,342,145,197,73.23,0.732,0.683,0.625
231174,1999,1808,984,824,875,351,524,53.25,0.532,0.484,0.426
231420,1999,204,123,81,72,22,50,40.65,0.406,0.353,0.272
231554,1999,144,79,65,43,18,25,31.65,0.316,0.299,0.277
231624,1999,1298,736,562,1052,418,634,86.14,0.861,0.81,0.744
231712,1999,808,485,323,148,44,104,21.44,0.214,0.183,0.136
232025,1999,271,129,142,117,50,67,51.94,0.519,0.432,0.352
232043,1999,218,131,87,111,36,75,57.25,0.573,0.509,0.414
232089,1999,309,104,205,56,26,30,28.85,0.289,0.181,0.127
232186,1999,2030,1129,901,534,161,373,33.04,0.33,0.263,0.179
232265,1999,1190,728,462,422,102,320,43.96,0.44,0.355,0.221
232423,1999,3040,1855,1185,1887,610,1277,68.84,0.688,0.621,0.515
232557,1999,1074,557,517,268,103,165,29.62,0.296,0.25,0.199
232566,1999,815,534,281,391,101,290,54.31,0.543,0.48,0.359
232609,1999,473,277,196,222,73,149,53.79,0.538,0.469,0.372
232681,1999,834,619,215,583,142,441,71.24,0.712,0.699,0.66
232706,1999,302,220,82,116,26,90,40.91,0.409,0.384,0.317
232937,1999,1111,687,424,118,27,91,13.25,0.132,0.106,0.064
232982,1999,1500,833,667,327,103,224,26.89,0.269,0.218,0.154
233277,1999,1655,1075,580,610,164,446,41.49,0.415,0.369,0.283
233374,1999,854,465,389,647,273,374,80.43,0.804,0.758,0.702
233426,1999,450,274,176,257,88,169,61.68,0.617,0.571,0.5
233541,1999,292,163,129,87,36,51,31.29,0.313,0.298,0.279
233897,1999,299,151,148,76,36,40,26.49,0.265,0.254,0.243
233921,1999,4653,1957,2696,2177,996,1181,60.35,0.604,0.468,0.369
234030,1999,2408,1427,981,499,164,335,23.48,0.235,0.207,0.167
234085,1999,369,24,345,194,180,14,58.33,0.583,0.526,0.522
234155,1999,937,543,394,185,48,137,25.23,0.252,0.197,0.122
234164,1999,268,167,101,50,8,42,25.15,0.252,0.187,0.079
235097,1999,1072,652,420,164,45,119,18.25,0.182,0.153,0.107
235167,1999,456,256,200,190,69,121,47.27,0.473,0.417,0.345
236230,1999,562,370,192,241,77,164,44.32,0.443,0.429,0.401
236328,1999,682,413,269,443,170,273,66.1,0.661,0.65,0.632
236577,1999,567,392,175,272,79,193,49.23,0.492,0.48,0.451
236595,1999,578,351,227,256,92,164,46.72,0.467,0.443,0.405
236896,1999,323,158,165,64,28,36,22.78,0.228,0.198,0.17
236939,1999,2456,1276,1180,791,306,485,38.01,0.38,0.322,0.259
236948,1999,4319,2279,2040,1977,790,1187,52.08,0.521,0.458,0.387
237011,1999,2074,1264,810,623,172,451,35.68,0.357,0.3,0.212
237057,1999,361,209,152,294,120,174,83.25,0.833,0.814,0.789
237066,1999,406,266,140,233,74,159,59.77,0.598,0.574,0.529
237215,1999,370,225,145,8,3,5,2.22,0.022,0.022,0.021
237330,1999,612,317,295,92,37,55,17.35,0.174,0.15,0.125
237358,1999,129,72,57,34,15,19,26.39,0.264,0.264,0.263
237367,1999,534,286,248,77,28,49,17.13,0.171,0.144,0.113
237792,1999,674,367,307,91,25,66,17.98,0.18,0.135,0.081
237899,1999,555,260,295,31,13,18,6.92,0.069,0.056,0.044
237932,1999,494,245,249,96,31,65,26.53,0.265,0.194,0.124
237969,1999,472,261,211,211,89,122,46.74,0.467,0.447,0.422
238032,1999,3523,1641,1882,885,363,522,31.81,0.318,0.251,0.193
238333,1999,303,173,130,196,75,121,69.94,0.699,0.647,0.577
238430,1999,203,132,71,28,10,18,13.64,0.136,0.138,0.141
238458,1999,482,327,155,219,63,156,47.71,0.477,0.454,0.406
238476,1999,427,216,211,190,78,112,51.85,0.519,0.445,0.37
238616,1999,321,197,124,104,38,66,33.5,0.335,0.324,0.306
238661,1999,196,132,64,49,9,40,30.3,0.303,0.25,0.141
239080,1999,224,156,68,71,17,54,34.62,0.346,0.317,0.25
239105,1999,1715,963,752,1064,414,650,67.5,0.675,0.62,0.551
239628,1999,283,156,127,174,73,101,64.74,0.647,0.615,0.575
239716,1999,519,296,223,332,136,196,66.22,0.662,0.64,0.61
240107,1999,311,235,76,111,22,89,37.87,0.379,0.357,0.289
240189,1999,1877,1017,860,357,119,238,23.4,0.234,0.19,0.138
240277,1999,879,578,301,164,45,119,20.59,0.206,0.187,0.15
240329,1999,1631,1035,596,395,128,267,25.8,0.258,0.242,0.215
240338,1999,161,92,69,79,23,56,60.87,0.609,0.491,0.333
240365,1999,1834,1084,750,284,85,199,18.36,0.184,0.155,0.113
240374,1999,811,419,392,78,30,48,11.46,0.115,0.096,0.077
240417,1999,1317,661,656,185,57,128,19.36,0.194,0.14,0.087
240426,1999,406,241,165,38,6,32,13.28,0.133,0.094,0.036
240444,1999,5520,2985,2535,2263,847,1416,47.44,0.474,0.41,0.334
240453,1999,2694,1523,1171,356,127,229,15.04,0.15,0.132,0.108
240462,1999,1093,377,716,148,61,87,23.08,0.231,0.135,0.085
240471,1999,1104,684,420,277,95,182,26.61,0.266,0.251,0.226
240480,1999,1490,849,641,285,99,186,21.91,0.219,0.191,0.154
240727,1999,1194,654,540,352,124,228,34.86,0.349,0.295,0.23
243443,1999,799,506,293,63,13,50,9.88,0.099,0.079,0.044
243780,1999,6895,2945,3950,2083,974,1109,37.66,0.377,0.302,0.247
100654,2000,1020,504,516,118,24,94,18.65,0.186,0.116,0.047
100663,2000,1234,748,486,173,51,122,16.31,0.163,0.14,0.105
100751,2000,2886,1653,1233,1038,303,735,44.46,0.445,0.36,0.246
100858,2000,3861,1990,1871,1277,451,826,41.51,0.415,0.331,0.241
101435,2000,151,95,56,67,21,46,48.42,0.484,0.444,0.375
101480,2000,850,443,407,127,39,88,19.86,0.199,0.149,0.096
101675,2000,425,220,205,85,19,66,30,0.3,0.2,0.093
101879,2000,824,481,343,143,35,108,22.45,0.224,0.174,0.102
102049,2000,657,427,230,359,122,237,55.5,0.555,0.546,0.53
102094,2000,1064,679,385,167,46,121,17.82,0.178,0.157,0.119
102234,2000,284,186,98,158,47,111,59.68,0.597,0.556,0.48
102368,2000,941,513,428,271,105,166,32.36,0.324,0.288,0.245
102377,2000,591,354,237,149,37,112,31.64,0.316,0.252,0.156
104151,2000,5763,3058,2705,1615,596,1019,33.32,0.333,0.28,0.22
104179,2000,5443,2924,2519,1613,618,995,34.03,0.34,0.296,0.245
105330,2000,2273,1384,889,613,174,439,31.72,0.317,0.27,0.196
106245,2000,836,484,352,73,28,45,9.3,0.093,0.087,0.08
106342,2000,127,71,56,74,30,44,61.97,0.62,0.583,0.536
106397,2000,2179,1092,1087,645,246,399,36.54,0.365,0.296,0.226
106412,2000,629,330,299,43,13,30,9.09,0.091,0.068,0.043
106458,2000,1591,893,698,307,97,210,23.52,0.235,0.193,0.139
106467,2000,1124,593,531,205,70,135,22.77,0.228,0.182,0.132
106485,2000,628,346,282,51,17,34,9.83,0.098,0.081,0.06
106704,2000,1627,982,645,325,80,245,24.95,0.25,0.2,0.124
107044,2000,975,557,418,365,137,228,40.93,0.409,0.374,0.328
107080,2000,326,173,153,194,85,109,63.01,0.63,0.595,0.556
107141,2000,276,164,112,140,51,89,54.27,0.543,0.507,0.455
107512,2000,440,247,193,187,69,118,47.77,0.478,0.425,0.358
107558,2000,166,100,66,52,17,35,35,0.35,0.313,0.258
110097,2000,608,409,199,326,88,238,58.19,0.582,0.536,0.442
110404,2000,205,74,131,166,107,59,79.73,0.797,0.81,0.817
110422,2000,3053,1332,1721,607,212,395,29.65,0.296,0.199,0.123
110486,2000,545,349,196,77,22,55,15.76,0.158,0.141,0.112
110495,2000,565,362,203,113,27,86,23.76,0.238,0.2,0.133
110510,2000,1146,750,396,142,33,109,14.53,0.145,0.124,0.083
110529,2000,2600,1121,1479,265,113,152,13.56,0.136,0.102,0.076
110538,2000,1931,1079,852,336,79,257,23.82,0.238,0.174,0.093
110547,2000,495,355,140,31,7,24,6.76,0.068,0.063,0.05
110556,2000,1885,1138,747,227,67,160,14.06,0.141,0.12,0.09
110565,2000,2655,1609,1046,381,83,298,18.52,0.185,0.144,0.079
110574,2000,669,452,217,109,26,83,18.36,0.184,0.163,0.12
110583,2000,3214,2038,1176,375,87,288,14.13,0.141,0.117,0.074
110592,2000,1184,755,429,126,24,102,13.51,0.135,0.106,0.056
110617,2000,2055,1198,857,178,36,142,11.85,0.118,0.087,0.042
113698,2000,113,86,27,48,13,35,40.7,0.407,0.425,0.481
115755,2000,769,460,309,94,32,62,13.48,0.135,0.122,0.104
119173,2000,297,296,1,67,1,66,22.3,0.223,0.226,1
120184,2000,137,99,38,54,15,39,39.39,0.394,0.394,0.395
121309,2000,539,312,227,274,101,173,55.45,0.554,0.508,0.445
121345,2000,398,208,190,346,163,183,87.98,0.88,0.869,0.858
122409,2000,2719,1598,1121,472,130,342,21.4,0.214,0.174,0.116
122436,2000,1024,642,382,656,225,431,67.13,0.671,0.641,0.589
122597,2000,1870,1212,658,205,54,151,12.46,0.125,0.11,0.082
122612,2000,757,518,239,363,100,263,50.77,0.508,0.48,0.418
122931,2000,1025,544,481,814,366,448,82.35,0.824,0.794,0.761
123554,2000,620,366,254,368,149,219,59.84,0.598,0.594,0.587
123572,2000,1064,714,350,236,46,190,26.61,0.266,0.222,0.131
126562,2000,515,296,219,71,23,48,16.22,0.162,0.138,0.105
126580,2000,718,457,261,162,38,124,27.13,0.271,0.226,0.146
126614,2000,5047,2445,2602,1937,829,1108,45.32,0.453,0.384,0.319
126818,2000,3240,1862,1378,1119,370,749,40.23,0.402,0.345,0.269
127060,2000,926,505,421,526,214,312,61.78,0.618,0.568,0.508
127185,2000,938,428,510,120,45,75,17.52,0.175,0.128,0.088
127565,2000,1435,778,657,79,27,52,6.68,0.067,0.055,0.041
127741,2000,2113,1240,873,605,162,443,35.73,0.357,0.286,0.186
128106,2000,641,331,310,101,41,60,18.13,0.181,0.158,0.132
128744,2000,161,80,81,53,21,32,40,0.4,0.329,0.259
128771,2000,1304,635,669,141,42,99,15.59,0.156,0.108,0.063
129020,2000,2802,1549,1253,1484,554,930,60.04,0.6,0.53,0.442
129242,2000,1008,610,398,797,291,506,82.95,0.83,0.791,0.731
129941,2000,457,195,262,101,48,53,27.18,0.272,0.221,0.183
130253,2000,834,498,336,477,168,309,62.05,0.62,0.572,0.5
130314,2000,187,187,0,86,0,86,45.99,0.46,0.46,NA
130493,2000,1350,775,575,142,38,104,13.42,0.134,0.105,0.066
130590,2000,489,253,236,389,181,208,82.21,0.822,0.796,0.767
130697,2000,720,371,349,607,281,326,87.87,0.879,0.843,0.805
130776,2000,822,404,418,104,42,62,15.35,0.154,0.127,0.1
130794,2000,1349,678,671,1189,582,607,89.53,0.895,0.881,0.867
130934,2000,684,405,279,155,36,119,29.38,0.294,0.227,0.129
130943,2000,3128,1926,1202,1884,620,1264,65.63,0.656,0.602,0.516
131159,2000,1272,821,451,818,260,558,67.97,0.68,0.643,0.576
131283,2000,530,298,232,315,126,189,63.42,0.634,0.594,0.543
131450,2000,241,123,118,16,3,13,10.57,0.106,0.066,0.025
131469,2000,2093,1241,852,1504,574,930,74.94,0.749,0.719,0.674
131496,2000,1469,789,680,1327,603,724,91.76,0.918,0.903,0.887
131520,2000,1355,909,446,624,145,479,52.7,0.527,0.461,0.325
132471,2000,401,258,143,70,18,52,20.16,0.202,0.175,0.126
132602,2000,833,478,355,105,26,79,16.53,0.165,0.126,0.073
132903,2000,4558,2436,2122,1384,436,948,38.92,0.389,0.304,0.205
133492,2000,408,223,185,215,95,120,53.81,0.538,0.527,0.514
133553,2000,797,124,673,280,225,55,44.35,0.444,0.351,0.334
133650,2000,2145,1263,882,415,99,316,25.02,0.25,0.193,0.112
133669,2000,1818,988,830,254,89,165,16.7,0.167,0.14,0.107
133711,2000,496,315,181,206,72,134,42.54,0.425,0.415,0.398
133881,2000,531,156,375,214,145,69,44.23,0.442,0.403,0.387
133951,2000,2582,1511,1071,507,148,359,23.76,0.238,0.196,0.138
134079,2000,506,306,200,209,62,147,48.04,0.48,0.413,0.31
134097,2000,5557,3294,2263,2481,811,1670,50.7,0.507,0.446,0.358
134130,2000,6864,3874,2990,3692,1285,2407,62.13,0.621,0.538,0.43
134945,2000,406,163,243,155,80,75,46.01,0.46,0.382,0.329
135726,2000,1964,1081,883,1140,469,671,62.07,0.621,0.58,0.531
136172,2000,1664,963,701,335,100,235,24.4,0.244,0.201,0.143
136950,2000,425,256,169,252,87,165,64.45,0.645,0.593,0.515
137546,2000,502,262,240,265,108,157,59.92,0.599,0.528,0.45
138354,2000,629,355,274,117,30,87,24.51,0.245,0.186,0.109
138716,2000,643,431,212,79,14,65,15.08,0.151,0.123,0.066
138789,2000,568,327,241,27,9,18,5.5,0.055,0.048,0.037
139144,2000,486,321,165,258,84,174,54.21,0.542,0.531,0.509
139366,2000,759,468,291,87,24,63,13.46,0.135,0.115,0.082
139393,2000,206,117,89,107,47,60,51.28,0.513,0.519,0.528
139658,2000,1532,831,701,936,420,516,62.09,0.621,0.611,0.599
139719,2000,360,195,165,48,14,34,17.44,0.174,0.133,0.085
139755,2000,2242,640,1602,760,470,290,45.31,0.453,0.339,0.293
139764,2000,308,202,106,44,15,29,14.36,0.144,0.143,0.142
139861,2000,820,506,314,189,41,148,29.25,0.292,0.23,0.131
139931,2000,2859,1481,1378,379,105,274,18.5,0.185,0.133,0.076
139940,2000,2061,1233,828,303,85,218,17.68,0.177,0.147,0.103
139959,2000,4207,2556,1651,1911,584,1327,51.92,0.519,0.454,0.354
140447,2000,733,438,295,223,71,152,34.7,0.347,0.304,0.241
140960,2000,370,195,175,35,7,28,14.36,0.144,0.095,0.04
140988,2000,299,205,94,105,23,82,40,0.4,0.351,0.245
141185,2000,192,105,87,51,13,38,36.19,0.362,0.266,0.149
141264,2000,788,512,276,141,49,92,17.97,0.18,0.179,0.178
141334,2000,1661,987,674,187,34,153,15.5,0.155,0.113,0.05
141486,2000,237,163,74,45,13,32,19.63,0.196,0.19,0.176
141565,2000,362,223,139,39,13,26,11.66,0.117,0.108,0.094
141574,2000,1499,846,653,168,48,120,14.18,0.142,0.112,0.074
142276,2000,1345,781,564,51,9,42,5.38,0.054,0.038,0.016
142285,2000,1560,722,838,311,127,184,25.48,0.255,0.199,0.152
142461,2000,240,137,103,74,24,50,36.5,0.365,0.308,0.233
143084,2000,610,359,251,443,172,271,75.49,0.755,0.726,0.685
143288,2000,191,107,84,56,18,38,35.51,0.355,0.293,0.214
144005,2000,345,232,113,10,5,5,2.16,0.022,0.029,0.044
144281,2000,1265,640,625,330,139,191,29.84,0.298,0.261,0.222
144740,2000,1897,1140,757,852,308,544,47.72,0.477,0.449,0.407
144892,2000,1495,870,625,471,151,320,36.78,0.368,0.315,0.242
144962,2000,301,185,116,183,50,133,71.89,0.719,0.608,0.431
144971,2000,121,72,49,49,17,32,44.44,0.444,0.405,0.347
145600,2000,2762,1557,1205,588,203,385,24.73,0.247,0.213,0.168
145619,2000,278,156,122,114,45,69,44.23,0.442,0.41,0.369
145637,2000,6167,2990,3177,3737,1692,2045,68.39,0.684,0.606,0.533
145691,2000,239,128,111,102,32,70,54.69,0.547,0.427,0.288
145813,2000,3254,1996,1258,1204,347,857,42.94,0.429,0.37,0.276
146481,2000,335,187,148,194,78,116,62.03,0.62,0.579,0.527
146612,2000,427,183,244,127,69,58,31.69,0.317,0.297,0.283
146719,2000,889,585,304,542,164,378,64.62,0.646,0.61,0.539
146825,2000,199,97,102,55,20,35,36.08,0.361,0.276,0.196
147013,2000,265,154,111,97,35,62,40.26,0.403,0.366,0.315
147244,2000,574,316,258,320,120,200,63.29,0.633,0.557,0.465
147341,2000,235,136,99,143,51,92,67.65,0.677,0.609,0.515
147703,2000,2765,1341,1424,634,273,361,26.92,0.269,0.229,0.192
147767,2000,1876,983,893,1612,731,881,89.62,0.896,0.859,0.819
147776,2000,948,570,378,27,7,20,3.51,0.035,0.028,0.019
147828,2000,468,278,190,187,61,126,45.32,0.453,0.4,0.321
148131,2000,235,137,98,81,25,56,40.88,0.409,0.345,0.255
148496,2000,165,108,57,94,30,64,59.26,0.593,0.57,0.526
148584,2000,190,109,81,73,25,48,44.04,0.44,0.384,0.309
148627,2000,352,222,130,112,36,76,34.23,0.342,0.318,0.277
149222,2000,2325,1036,1289,473,201,272,26.25,0.262,0.203,0.156
149231,2000,1495,848,647,324,103,221,26.06,0.261,0.217,0.159
149772,2000,1762,904,858,557,245,312,34.51,0.345,0.316,0.286
149781,2000,568,291,277,441,212,229,78.69,0.787,0.776,0.765
150066,2000,538,275,263,212,77,135,49.09,0.491,0.394,0.293
150136,2000,3694,2023,1671,1062,372,690,34.11,0.341,0.287,0.223
150145,2000,294,182,112,114,41,73,40.11,0.401,0.388,0.366
150163,2000,868,559,309,516,182,334,59.75,0.598,0.594,0.589
150400,2000,610,336,274,479,202,277,82.44,0.824,0.785,0.737
150534,2000,555,320,235,237,84,153,47.81,0.478,0.427,0.357
150668,2000,194,113,81,87,30,57,50.44,0.504,0.448,0.37
150941,2000,206,109,97,100,46,54,49.54,0.495,0.485,0.474
151102,2000,1337,723,614,48,22,26,3.6,0.036,0.036,0.036
151111,2000,2473,1414,1059,168,48,120,8.49,0.085,0.068,0.045
151306,2000,1729,1033,696,247,57,190,18.39,0.184,0.143,0.082
151324,2000,2124,1122,1002,404,126,278,24.78,0.248,0.19,0.126
151333,2000,347,223,124,28,9,19,8.52,0.085,0.081,0.073
151342,2000,637,349,288,22,6,16,4.58,0.046,0.035,0.021
151351,2000,6862,3839,3023,3421,1362,2059,53.63,0.536,0.499,0.451
151360,2000,517,318,199,33,16,17,5.35,0.054,0.064,0.08
151379,2000,700,413,287,57,18,39,9.44,0.094,0.081,0.063
151388,2000,249,161,88,10,1,9,5.59,0.056,0.04,0.011
151777,2000,333,178,155,142,46,96,53.93,0.539,0.426,0.297
151786,2000,208,126,82,58,12,46,36.51,0.365,0.279,0.146
152080,2000,1955,919,1036,1757,921,836,90.97,0.91,0.899,0.889
152248,2000,1043,577,466,37,14,23,3.99,0.04,0.035,0.03
152363,2000,246,132,114,109,50,59,44.7,0.447,0.443,0.439
152530,2000,482,242,240,332,149,183,75.62,0.756,0.689,0.621
152600,2000,707,388,319,450,188,262,67.53,0.675,0.636,0.589
153001,2000,326,182,144,153,62,91,50,0.5,0.469,0.431
153108,2000,369,214,155,226,84,142,66.36,0.664,0.612,0.542
153269,2000,760,475,285,353,127,226,47.58,0.476,0.464,0.446
153384,2000,363,209,154,312,127,185,88.52,0.885,0.86,0.825
153603,2000,4282,1928,2354,1340,515,825,42.79,0.428,0.313,0.219
153834,2000,662,396,266,420,161,259,65.4,0.654,0.634,0.605
154095,2000,2218,1337,881,751,243,508,38,0.38,0.339,0.276
155089,2000,231,127,104,49,18,31,24.41,0.244,0.212,0.173
155317,2000,4119,2268,1851,1282,455,827,36.46,0.365,0.311,0.246
155335,2000,171,112,59,49,14,35,31.25,0.312,0.287,0.237
155399,2000,3399,1711,1688,829,289,540,31.56,0.316,0.244,0.171
155520,2000,260,133,127,113,39,74,55.64,0.556,0.435,0.307
155627,2000,111,40,71,30,12,18,45,0.45,0.27,0.169
155937,2000,126,60,66,47,18,29,48.33,0.483,0.373,0.273
156213,2000,304,180,124,166,60,106,58.89,0.589,0.546,0.484
156286,2000,355,224,131,172,63,109,48.66,0.487,0.485,0.481
156295,2000,421,245,176,169,60,109,44.49,0.445,0.401,0.341
156365,2000,317,167,150,88,25,63,37.72,0.377,0.278,0.167
156541,2000,403,195,208,82,37,45,23.08,0.231,0.203,0.178
156745,2000,331,189,142,158,49,109,57.67,0.577,0.477,0.345
157058,2000,340,171,169,49,17,32,18.71,0.187,0.144,0.101
157076,2000,159,75,84,37,12,25,33.33,0.333,0.233,0.143
157085,2000,2971,1590,1381,884,333,551,34.65,0.346,0.298,0.241
157289,2000,2249,1162,1087,321,113,208,17.9,0.179,0.143,0.104
157386,2000,1473,849,624,181,59,122,14.37,0.144,0.123,0.095
157401,2000,1210,730,480,348,108,240,32.88,0.329,0.288,0.225
157447,2000,1682,974,708,114,37,77,7.91,0.079,0.068,0.052
157535,2000,282,137,145,45,7,38,27.74,0.277,0.16,0.048
157951,2000,2477,1444,1033,634,202,432,29.92,0.299,0.256,0.196
158477,2000,229,152,77,99,33,66,43.42,0.434,0.432,0.429
159009,2000,908,513,395,182,46,136,26.51,0.265,0.2,0.116
159391,2000,5072,2803,2269,1229,431,798,28.47,0.285,0.242,0.19
159647,2000,1795,819,976,480,222,258,31.5,0.315,0.267,0.227
159717,2000,1320,767,553,110,31,79,10.3,0.103,0.083,0.056
159966,2000,1460,882,578,118,26,92,10.43,0.104,0.081,0.045
160038,2000,1555,959,596,194,56,138,14.39,0.144,0.125,0.094
160612,2000,2220,1351,869,176,59,117,8.66,0.087,0.079,0.068
160621,2000,1766,996,770,2,2,0,0,0,0.001,0.003
160658,2000,2291,1302,989,314,103,211,16.21,0.162,0.137,0.104
161004,2000,452,221,231,379,188,191,86.43,0.864,0.838,0.814
161226,2000,475,329,146,176,40,136,41.34,0.413,0.371,0.274
161235,2000,82,38,44,4,1,3,7.89,0.079,0.049,0.023
161244,2000,127,85,42,13,4,9,10.59,0.106,0.102,0.095
161253,2000,1589,781,808,536,222,314,40.2,0.402,0.337,0.275
161554,2000,855,489,366,81,21,60,12.27,0.123,0.095,0.057
162007,2000,361,195,166,47,13,34,17.44,0.174,0.13,0.078
162210,2000,158,89,69,22,4,18,20.22,0.202,0.139,0.058
162283,2000,417,289,128,20,4,16,5.54,0.055,0.048,0.031
162584,2000,1028,499,529,199,64,135,27.05,0.27,0.194,0.121
162654,2000,365,258,107,227,57,170,65.89,0.659,0.622,0.533
162760,2000,131,128,3,90,3,87,67.97,0.68,0.687,1
162928,2000,1067,456,611,876,483,393,86.18,0.862,0.821,0.791
163046,2000,909,520,389,699,277,422,81.15,0.812,0.769,0.712
163268,2000,1307,601,706,362,150,212,35.27,0.353,0.277,0.212
163286,2000,3929,1896,2033,2141,933,1208,63.71,0.637,0.545,0.459
163453,2000,1107,689,418,204,60,144,20.9,0.209,0.184,0.144
163462,2000,383,223,160,255,109,146,65.47,0.655,0.666,0.681
163851,2000,939,546,393,488,163,325,59.52,0.595,0.52,0.415
163912,2000,375,220,155,262,94,168,76.36,0.764,0.699,0.606
164076,2000,1981,1198,783,630,190,440,36.73,0.367,0.318,0.243
164173,2000,425,313,112,220,51,169,53.99,0.54,0.518,0.455
164216,2000,374,236,138,255,80,175,74.15,0.742,0.682,0.58
164270,2000,442,247,195,293,109,184,74.49,0.745,0.663,0.559
164447,2000,239,123,116,112,63,49,39.84,0.398,0.469,0.543
164492,2000,149,110,39,81,18,63,57.27,0.573,0.544,0.462
164562,2000,593,367,226,409,114,295,80.38,0.804,0.69,0.504
165015,2000,858,475,383,714,301,413,86.95,0.87,0.832,0.786
165024,2000,1244,760,484,290,87,203,26.71,0.267,0.233,0.18
165334,2000,497,292,205,315,120,195,66.78,0.668,0.634,0.585
165662,2000,641,396,245,461,179,282,71.21,0.712,0.719,0.731
165671,2000,165,165,0,82,0,82,49.7,0.497,0.497,NA
165820,2000,448,275,173,119,30,89,32.36,0.324,0.266,0.173
165866,2000,612,434,178,153,30,123,28.34,0.283,0.25,0.169
165936,2000,411,274,137,233,71,162,59.12,0.591,0.567,0.518
166027,2000,1638,755,883,1431,757,674,89.27,0.893,0.874,0.857
166124,2000,706,376,330,626,284,342,90.96,0.91,0.887,0.861
166513,2000,996,373,623,299,140,159,42.63,0.426,0.3,0.225
166629,2000,3803,2086,1717,1768,667,1101,52.78,0.528,0.465,0.388
166638,2000,593,326,267,91,14,77,23.62,0.236,0.153,0.052
166683,2000,1010,425,585,825,468,357,84,0.84,0.817,0.8
167288,2000,224,126,98,80,32,48,38.1,0.381,0.357,0.327
167987,2000,1300,642,658,363,142,221,34.42,0.344,0.279,0.216
167996,2000,629,363,266,517,210,307,84.57,0.846,0.822,0.789
168005,2000,645,371,274,243,87,156,42.05,0.42,0.377,0.318
168148,2000,1181,637,544,1022,464,558,87.6,0.876,0.865,0.853
168254,2000,560,262,298,268,140,128,48.85,0.489,0.479,0.47
168281,2000,450,286,164,318,104,214,74.83,0.748,0.707,0.634
168342,2000,528,260,268,483,240,243,93.46,0.935,0.915,0.896
168546,2000,405,253,152,270,86,184,72.73,0.727,0.667,0.566
168786,2000,362,244,118,89,24,65,26.64,0.266,0.246,0.203
169080,2000,1050,594,456,585,241,344,57.91,0.579,0.557,0.529
169798,2000,2664,1619,1045,327,109,218,13.47,0.135,0.123,0.104
169910,2000,2147,883,1264,94,47,47,5.32,0.053,0.044,0.037
170082,2000,2831,1732,1099,548,166,382,22.06,0.221,0.194,0.151
170301,2000,754,468,286,480,170,310,66.24,0.662,0.637,0.594
170532,2000,324,180,144,246,103,143,79.44,0.794,0.759,0.715
170639,2000,555,262,293,76,35,41,15.65,0.156,0.137,0.119
170976,2000,5403,2860,2543,3803,1697,2106,73.64,0.736,0.704,0.667
171100,2000,6790,3756,3034,2908,1026,1882,50.11,0.501,0.428,0.338
171128,2000,1267,292,975,316,223,93,31.85,0.318,0.249,0.229
171137,2000,738,371,367,118,52,66,17.79,0.178,0.16,0.142
171146,2000,576,349,227,64,18,46,13.18,0.132,0.111,0.079
171599,2000,183,66,117,36,18,18,27.27,0.273,0.197,0.154
172051,2000,1049,559,490,68,24,44,7.87,0.079,0.065,0.049
172699,2000,4429,2349,2080,865,323,542,23.07,0.231,0.195,0.155
173160,2000,591,357,234,364,127,237,66.39,0.664,0.616,0.543
173258,2000,471,247,224,415,194,221,89.47,0.895,0.881,0.866
173328,2000,212,124,88,57,15,42,33.87,0.339,0.269,0.17
173647,2000,652,383,269,392,169,223,58.22,0.582,0.601,0.628
173902,2000,454,299,155,366,126,240,80.27,0.803,0.806,0.813
174066,2000,4865,2577,2288,1581,668,913,35.43,0.354,0.325,0.292
174233,2000,2088,1107,981,508,182,326,29.45,0.294,0.243,0.186
174251,2000,467,267,200,186,66,120,44.94,0.449,0.398,0.33
174491,2000,430,279,151,178,52,126,45.16,0.452,0.414,0.344
174792,2000,522,0,522,406,406,0,NA,NA,0.778,0.778
174844,2000,753,441,312,600,232,368,83.45,0.835,0.797,0.744
174899,2000,315,226,89,173,45,128,56.64,0.566,0.549,0.506
174914,2000,1082,578,504,597,244,353,61.07,0.611,0.552,0.484
175342,2000,489,248,241,107,28,79,31.85,0.318,0.219,0.116
175421,2000,182,95,87,50,19,31,32.63,0.326,0.275,0.218
175616,2000,461,273,188,111,24,87,31.87,0.319,0.241,0.128
175856,2000,936,547,389,134,40,94,17.18,0.172,0.143,0.103
175980,2000,292,152,140,176,82,94,61.84,0.618,0.603,0.586
176017,2000,1981,1019,962,655,248,407,39.94,0.399,0.331,0.258
176035,2000,205,190,15,57,0,57,30,0.3,0.278,0
176044,2000,297,173,124,41,13,28,16.18,0.162,0.138,0.105
176080,2000,2055,1057,998,556,204,352,33.3,0.333,0.271,0.204
176406,2000,224,168,56,66,15,51,30.36,0.304,0.295,0.268
176628,2000,162,91,71,36,5,31,34.07,0.341,0.222,0.07
176947,2000,216,102,114,68,17,51,50,0.5,0.315,0.149
176965,2000,1455,794,661,380,146,234,29.47,0.295,0.261,0.221
177418,2000,164,124,40,57,4,53,42.74,0.427,0.348,0.1
178059,2000,231,186,45,122,18,104,55.91,0.559,0.528,0.4
178341,2000,771,427,344,129,50,79,18.5,0.185,0.167,0.145
178387,2000,908,532,376,91,20,71,13.35,0.134,0.1,0.053
178396,2000,4170,2247,1923,1657,609,1048,46.64,0.466,0.397,0.317
178402,2000,688,391,297,120,44,76,19.44,0.194,0.174,0.148
178411,2000,672,146,526,143,98,45,30.82,0.308,0.213,0.186
178420,2000,497,279,218,100,35,65,23.3,0.233,0.201,0.161
178615,2000,1396,840,556,537,181,356,42.38,0.424,0.385,0.326
179043,2000,267,141,126,135,61,74,52.48,0.525,0.506,0.484
179159,2000,1405,748,657,886,397,489,65.37,0.654,0.631,0.604
179557,2000,1433,817,616,372,103,269,32.93,0.329,0.26,0.167
179566,2000,2496,1477,1019,613,204,409,27.69,0.277,0.246,0.2
179867,2000,1392,761,631,1158,498,660,86.73,0.867,0.832,0.789
179894,2000,412,242,170,168,60,108,44.63,0.446,0.408,0.353
179946,2000,173,75,98,82,37,45,60,0.6,0.474,0.378
180179,2000,538,352,186,48,10,38,10.8,0.108,0.089,0.054
180461,2000,1852,841,1011,357,160,197,23.42,0.234,0.193,0.158
180522,2000,187,85,102,28,17,11,12.94,0.129,0.15,0.167
180984,2000,329,173,156,84,42,42,24.28,0.243,0.255,0.269
181002,2000,881,535,346,537,197,340,63.55,0.635,0.61,0.569
181020,2000,300,160,140,174,75,99,61.88,0.619,0.58,0.536
181127,2000,271,119,152,129,61,68,57.14,0.571,0.476,0.401
181215,2000,996,550,446,159,48,111,20.18,0.202,0.16,0.108
181394,2000,1517,825,692,157,55,102,12.36,0.124,0.103,0.079
181446,2000,423,254,169,235,87,148,58.27,0.583,0.556,0.515
181464,2000,3598,1783,1815,823,326,497,27.87,0.279,0.229,0.18
181534,2000,201,93,108,26,7,19,20.43,0.204,0.129,0.065
181783,2000,623,366,257,168,49,119,32.51,0.325,0.27,0.191
182281,2000,2126,1182,944,240,70,170,14.38,0.144,0.113,0.074
182290,2000,1930,1090,840,293,95,198,18.17,0.182,0.152,0.113
182634,2000,274,180,94,148,47,101,56.11,0.561,0.54,0.5
182795,2000,530,262,268,227,101,126,48.09,0.481,0.428,0.377
183062,2000,935,576,359,243,69,174,30.21,0.302,0.26,0.192
183080,2000,902,454,448,241,97,144,31.72,0.317,0.267,0.217
183239,2000,518,280,238,349,142,207,73.93,0.739,0.674,0.597
183822,2000,236,135,101,13,8,5,3.7,0.037,0.055,0.079
183974,2000,145,114,31,56,7,49,42.98,0.43,0.386,0.226
184348,2000,419,265,154,291,98,193,72.83,0.728,0.695,0.636
184603,2000,535,300,235,79,32,47,15.67,0.157,0.148,0.136
184612,2000,219,173,46,46,7,39,22.54,0.225,0.21,0.152
184782,2000,1053,561,492,444,173,271,48.31,0.483,0.422,0.352
185129,2000,661,357,304,46,20,26,7.28,0.073,0.07,0.066
185572,2000,1033,529,504,377,142,235,44.42,0.444,0.365,0.282
185590,2000,1324,827,497,351,96,255,30.83,0.308,0.265,0.193
185828,2000,685,117,568,130,98,32,27.35,0.274,0.19,0.173
186131,2000,1159,569,590,1031,503,528,92.79,0.928,0.89,0.853
186201,2000,636,392,244,282,87,195,49.74,0.497,0.443,0.357
186283,2000,884,504,380,399,152,247,49.01,0.49,0.451,0.4
186584,2000,1121,581,540,464,186,278,47.85,0.479,0.414,0.344
186876,2000,728,431,297,296,96,200,46.4,0.464,0.407,0.323
187134,2000,1205,714,491,799,287,512,71.71,0.717,0.663,0.585
187444,2000,1160,610,550,188,73,115,18.85,0.189,0.162,0.133
187985,2000,2587,1474,1113,311,106,205,13.91,0.139,0.12,0.095
188030,2000,1959,1082,877,238,83,155,14.33,0.143,0.121,0.095
188429,2000,616,416,200,314,82,232,55.77,0.558,0.51,0.41
188641,2000,504,280,224,246,81,165,58.93,0.589,0.488,0.362
190044,2000,638,149,489,325,242,83,55.7,0.557,0.509,0.495
190099,2000,711,339,372,600,308,292,86.14,0.861,0.844,0.828
190150,2000,1339,610,729,1136,602,534,87.54,0.875,0.848,0.826
190248,2000,122,68,54,55,23,32,47.06,0.471,0.451,0.426
190415,2000,3047,1438,1609,2569,1308,1261,87.69,0.877,0.843,0.813
190512,2000,1295,701,594,351,137,214,30.53,0.305,0.271,0.231
190549,2000,1238,717,521,218,79,139,19.39,0.194,0.176,0.152
190558,2000,1488,796,692,44,10,34,4.27,0.043,0.03,0.014
190567,2000,852,399,453,27,8,19,4.76,0.048,0.032,0.018
190594,2000,1741,1227,514,188,43,145,11.82,0.118,0.108,0.084
190637,2000,542,367,175,45,11,34,9.26,0.093,0.083,0.063
190664,2000,1085,639,446,254,65,189,29.58,0.296,0.234,0.146
190691,2000,458,314,144,29,6,23,7.32,0.073,0.063,0.042
190725,2000,317,254,63,77,13,64,25.2,0.252,0.243,0.206
191241,2000,1632,975,657,1183,468,715,73.33,0.733,0.725,0.712
191515,2000,467,251,216,386,172,214,85.26,0.853,0.827,0.796
191533,2000,425,245,180,188,61,127,51.84,0.518,0.442,0.339
191630,2000,521,282,239,353,144,209,74.11,0.741,0.678,0.603
191649,2000,1937,1036,901,703,266,437,42.18,0.422,0.363,0.295
191676,2000,358,226,132,217,75,142,62.83,0.628,0.606,0.568
191931,2000,723,351,372,337,132,205,58.4,0.584,0.466,0.355
191968,2000,1675,940,735,1149,474,675,71.81,0.718,0.686,0.645
192192,2000,281,183,98,83,28,55,30.05,0.3,0.295,0.286
192323,2000,510,291,219,298,119,179,61.51,0.615,0.584,0.543
192439,2000,863,578,285,36,9,27,4.67,0.047,0.042,0.032
192703,2000,623,315,308,361,153,208,66.03,0.66,0.579,0.497
192749,2000,403,277,126,213,58,155,55.96,0.56,0.529,0.46
192819,2000,993,589,404,690,272,418,70.97,0.71,0.695,0.673
192925,2000,208,153,55,36,10,26,16.99,0.17,0.173,0.182
193016,2000,637,421,216,69,10,59,14.01,0.14,0.108,0.046
193292,2000,195,133,62,56,13,43,32.33,0.323,0.287,0.21
193353,2000,328,251,77,124,15,109,43.43,0.434,0.378,0.195
193399,2000,236,174,62,83,16,67,38.51,0.385,0.352,0.258
193584,2000,402,304,98,244,56,188,61.84,0.618,0.607,0.571
193645,2000,755,662,93,159,13,146,22.05,0.22,0.211,0.14
193654,2000,595,402,193,245,69,176,43.78,0.438,0.412,0.358
193900,2000,3966,2424,1542,2416,966,1450,59.82,0.598,0.609,0.626
193973,2000,628,371,257,350,122,228,61.46,0.615,0.557,0.475
194161,2000,373,233,140,105,35,70,30.04,0.3,0.282,0.25
194310,2000,1602,976,626,612,204,408,41.8,0.418,0.382,0.326
194824,2000,1303,334,969,833,603,230,68.86,0.689,0.639,0.622
195003,2000,2278,636,1642,453,244,209,32.86,0.329,0.199,0.149
195030,2000,1044,460,584,741,395,346,75.22,0.752,0.71,0.676
195164,2000,584,316,268,309,116,193,61.08,0.611,0.529,0.433
195173,2000,434,242,192,191,72,119,49.17,0.492,0.44,0.375
195216,2000,612,325,287,436,186,250,76.92,0.769,0.712,0.648
195234,2000,485,349,136,216,47,169,48.42,0.484,0.445,0.346
195243,2000,298,173,125,117,38,79,45.66,0.457,0.393,0.304
195304,2000,292,212,80,204,56,148,69.81,0.698,0.699,0.7
195474,2000,765,404,361,547,234,313,77.48,0.775,0.715,0.648
195526,2000,599,345,254,461,186,275,79.71,0.797,0.77,0.732
195544,2000,98,80,18,67,6,61,76.25,0.763,0.684,0.333
195809,2000,2853,1619,1234,997,387,610,37.68,0.377,0.349,0.314
196413,2000,2791,1569,1222,1981,805,1176,74.95,0.75,0.71,0.659
196592,2000,1272,919,353,121,46,75,8.16,0.082,0.095,0.13
197045,2000,445,260,185,139,41,98,37.69,0.377,0.312,0.222
197133,2000,639,389,250,544,211,333,85.6,0.856,0.851,0.844
197869,2000,2544,1370,1174,872,285,587,42.85,0.429,0.343,0.243
197984,2000,188,113,75,63,22,41,36.28,0.363,0.335,0.293
198385,2000,465,229,236,413,193,220,96.07,0.961,0.888,0.818
198464,2000,3105,1837,1268,856,248,608,33.1,0.331,0.276,0.196
198507,2000,441,248,193,133,32,101,40.73,0.407,0.302,0.166
198516,2000,1144,718,426,744,244,500,69.64,0.696,0.65,0.573
198835,2000,268,142,126,122,42,80,56.34,0.563,0.455,0.333
198969,2000,308,115,193,46,18,28,24.35,0.244,0.149,0.093
199102,2000,1661,884,777,321,97,224,25.34,0.253,0.193,0.125
199111,2000,496,284,212,154,54,100,35.21,0.352,0.31,0.255
199120,2000,3406,2121,1285,2426,829,1597,75.29,0.753,0.712,0.645
199139,2000,2142,1208,934,553,194,359,29.72,0.297,0.258,0.208
199148,2000,1867,1355,512,556,112,444,32.77,0.328,0.298,0.219
199157,2000,720,443,277,162,26,136,30.7,0.307,0.225,0.094
199193,2000,3816,1622,2194,1379,634,745,45.93,0.459,0.361,0.289
199218,2000,1661,1081,580,711,185,526,48.66,0.487,0.428,0.319
199281,2000,567,303,264,114,34,80,26.4,0.264,0.201,0.129
199306,2000,185,90,95,58,17,41,45.56,0.456,0.314,0.179
199412,2000,188,136,52,93,23,70,51.47,0.515,0.495,0.442
199582,2000,398,232,166,67,17,50,21.55,0.216,0.168,0.102
199643,2000,401,247,154,43,13,30,12.15,0.122,0.107,0.084
199847,2000,1020,530,490,804,355,449,84.72,0.847,0.788,0.724
199962,2000,380,181,199,142,54,88,48.62,0.486,0.374,0.271
199999,2000,499,359,140,97,19,78,21.73,0.217,0.194,0.136
200004,2000,1211,594,617,298,120,178,29.97,0.3,0.246,0.194
200059,2000,350,208,142,34,14,20,9.62,0.096,0.097,0.099
200156,2000,331,192,139,107,35,72,37.5,0.375,0.323,0.252
200217,2000,351,201,150,142,37,105,52.24,0.522,0.405,0.247
200226,2000,153,73,80,22,6,16,21.92,0.219,0.144,0.075
200253,2000,452,260,192,61,25,36,13.85,0.138,0.135,0.13
200280,2000,1832,858,974,394,192,202,23.54,0.235,0.215,0.197
200332,2000,1280,512,768,217,102,115,22.46,0.225,0.17,0.133
200572,2000,179,92,87,35,11,24,26.09,0.261,0.196,0.126
201104,2000,448,265,183,187,51,136,51.32,0.513,0.417,0.279
201371,2000,227,124,103,114,48,66,53.23,0.532,0.502,0.466
201548,2000,558,333,225,305,111,194,58.26,0.583,0.547,0.493
201645,2000,833,305,528,489,279,210,68.85,0.689,0.587,0.528
201690,2000,307,173,134,39,5,34,19.65,0.196,0.127,0.037
202134,2000,934,471,463,103,42,61,12.95,0.13,0.11,0.091
202480,2000,1764,932,832,1055,431,624,66.95,0.67,0.598,0.518
202523,2000,648,370,278,484,198,286,77.3,0.773,0.747,0.712
202763,2000,684,399,285,257,87,170,42.61,0.426,0.376,0.305
203085,2000,277,137,140,121,39,82,59.85,0.599,0.437,0.279
203128,2000,244,139,105,128,54,74,53.24,0.532,0.525,0.514
203368,2000,830,467,363,543,214,329,70.45,0.705,0.654,0.59
203517,2000,3556,2184,1372,748,226,522,23.9,0.239,0.21,0.165
203535,2000,436,227,209,371,168,203,89.43,0.894,0.851,0.804
203580,2000,86,63,23,26,6,20,31.75,0.318,0.302,0.261
203775,2000,388,240,148,157,49,108,45,0.45,0.405,0.331
203845,2000,303,141,162,154,75,79,56.03,0.56,0.508,0.463
204024,2000,3359,1947,1412,2271,870,1401,71.96,0.72,0.676,0.616
204185,2000,555,315,240,277,93,184,58.41,0.584,0.499,0.388
204194,2000,365,228,137,139,39,100,43.86,0.439,0.381,0.285
204617,2000,179,118,61,48,15,33,27.97,0.28,0.268,0.246
204796,2000,5831,3008,2823,2282,851,1431,47.57,0.476,0.391,0.301
204857,2000,3586,2041,1545,1693,588,1105,54.14,0.541,0.472,0.381
206330,2000,215,84,131,38,19,19,22.62,0.226,0.177,0.145
206589,2000,501,258,243,331,137,194,75.19,0.752,0.661,0.564
206604,2000,2124,1217,907,403,117,286,23.5,0.235,0.19,0.129
206622,2000,776,436,340,515,223,292,66.97,0.67,0.664,0.656
206695,2000,1853,943,910,220,95,125,13.26,0.133,0.119,0.104
206914,2000,620,339,281,68,24,44,12.98,0.13,0.11,0.085
207209,2000,690,328,362,40,14,26,7.93,0.079,0.058,0.039
207306,2000,329,159,170,46,15,31,19.5,0.195,0.14,0.088
207324,2000,449,226,223,100,45,55,24.34,0.243,0.223,0.202
207388,2000,2953,1615,1338,802,272,530,32.82,0.328,0.272,0.203
207500,2000,3326,1760,1566,791,268,523,29.72,0.297,0.238,0.171
207722,2000,206,135,71,29,6,23,17.04,0.17,0.141,0.085
207847,2000,509,261,248,54,21,33,12.64,0.126,0.106,0.085
207865,2000,815,464,351,135,27,108,23.28,0.233,0.166,0.077
208822,2000,352,205,147,209,81,128,62.44,0.624,0.594,0.551
209056,2000,426,263,163,251,91,160,60.84,0.608,0.589,0.558
209065,2000,434,228,206,281,113,168,73.68,0.737,0.647,0.549
209542,2000,2652,1250,1402,770,311,459,36.72,0.367,0.29,0.222
209551,2000,2809,1527,1282,1089,384,705,46.17,0.462,0.388,0.3
209612,2000,303,198,105,158,58,100,50.51,0.505,0.521,0.552
209807,2000,915,480,435,133,50,83,17.29,0.173,0.145,0.115
209922,2000,358,202,156,204,79,125,61.88,0.619,0.57,0.506
210146,2000,681,390,291,130,45,85,21.79,0.218,0.191,0.155
210401,2000,506,292,214,336,124,212,72.6,0.726,0.664,0.579
210429,2000,825,524,301,176,55,121,23.09,0.231,0.213,0.183
210571,2000,407,231,176,207,84,123,53.25,0.532,0.509,0.477
210669,2000,561,291,270,393,175,218,74.91,0.749,0.701,0.648
210775,2000,236,149,87,70,22,48,32.21,0.322,0.297,0.253
211088,2000,294,228,66,147,27,120,52.63,0.526,0.5,0.409
211158,2000,1414,912,502,587,153,434,47.59,0.476,0.415,0.305
211291,2000,914,454,460,773,376,397,87.44,0.874,0.846,0.817
211352,2000,359,221,138,161,50,111,50.23,0.502,0.448,0.362
211361,2000,840,398,442,187,83,104,26.13,0.261,0.223,0.188
211431,2000,180,178,2,85,0,85,47.75,0.478,0.472,0
211440,2000,1325,516,809,920,537,383,74.22,0.742,0.694,0.664
211468,2000,200,198,2,109,0,109,55.05,0.55,0.545,0
211556,2000,138,138,0,54,0,54,39.13,0.391,0.391,NA
211583,2000,104,98,6,51,1,50,51.02,0.51,0.49,0.167
211608,2000,291,151,140,34,9,25,16.56,0.166,0.117,0.064
211644,2000,1305,813,492,330,99,231,28.41,0.284,0.253,0.201
211981,2000,380,188,192,160,63,97,51.6,0.516,0.421,0.328
212009,2000,594,340,254,464,188,276,81.18,0.812,0.781,0.74
212054,2000,2125,810,1315,275,97,178,21.98,0.22,0.129,0.074
212106,2000,1257,733,524,650,243,407,55.53,0.555,0.517,0.464
212115,2000,878,522,356,193,57,136,26.05,0.26,0.22,0.16
212133,2000,400,279,121,229,60,169,60.57,0.606,0.573,0.496
212160,2000,1304,731,573,297,88,209,28.59,0.286,0.228,0.154
212197,2000,474,318,156,310,98,212,66.67,0.667,0.654,0.628
212577,2000,510,251,259,382,179,203,80.88,0.809,0.749,0.691
212601,2000,563,327,236,257,87,170,51.99,0.52,0.456,0.369
212832,2000,179,141,38,70,10,60,42.55,0.426,0.391,0.263
212911,2000,334,181,153,305,140,165,91.16,0.912,0.913,0.915
213020,2000,2776,1607,1169,605,167,438,27.26,0.273,0.218,0.143
213251,2000,359,207,152,265,105,160,77.29,0.773,0.738,0.691
213321,2000,457,199,258,285,133,152,76.38,0.764,0.624,0.516
213349,2000,1528,925,603,422,100,322,34.81,0.348,0.276,0.166
213358,2000,351,199,152,200,98,102,51.26,0.513,0.57,0.645
213367,2000,774,404,370,455,203,252,62.38,0.624,0.588,0.549
213385,2000,558,280,278,490,238,252,90,0.9,0.878,0.856
213507,2000,388,225,163,242,85,157,69.78,0.698,0.624,0.521
213543,2000,1127,464,663,845,473,372,80.17,0.802,0.75,0.713
213613,2000,890,522,368,250,68,182,34.87,0.349,0.281,0.185
213668,2000,337,177,160,199,90,109,61.58,0.616,0.591,0.562
213783,2000,639,363,276,183,79,104,28.65,0.286,0.286,0.286
213826,2000,257,188,69,100,29,71,37.77,0.378,0.389,0.42
213996,2000,741,451,290,500,184,316,70.07,0.701,0.675,0.634
214041,2000,1265,768,497,463,163,300,39.06,0.391,0.366,0.328
214069,2000,261,185,76,160,39,121,65.41,0.654,0.613,0.513
214157,2000,378,236,142,246,80,166,70.34,0.703,0.651,0.563
214175,2000,579,340,239,480,196,284,83.53,0.835,0.829,0.82
214272,2000,299,164,135,87,34,53,32.32,0.323,0.291,0.252
214777,2000,5621,2866,2755,3127,1277,1850,64.55,0.645,0.556,0.464
215062,2000,2270,1125,1145,1986,967,1019,90.58,0.906,0.875,0.845
215743,2000,355,210,145,159,58,101,48.1,0.481,0.448,0.4
215798,2000,302,141,161,192,99,93,65.96,0.66,0.636,0.615
215929,2000,833,472,361,625,259,366,77.54,0.775,0.75,0.717
216010,2000,1520,831,689,679,233,446,53.67,0.537,0.447,0.338
216038,2000,1346,794,552,372,105,267,33.63,0.336,0.276,0.19
216287,2000,366,195,171,316,141,175,89.74,0.897,0.863,0.825
216339,2000,3031,1767,1264,857,318,539,30.5,0.305,0.283,0.252
216524,2000,376,214,162,287,112,175,81.78,0.818,0.763,0.691
216694,2000,328,160,168,146,57,89,55.62,0.556,0.445,0.339
216764,2000,1715,1085,630,536,127,409,37.7,0.377,0.313,0.202
216807,2000,340,199,141,230,87,143,71.86,0.719,0.676,0.617
216852,2000,534,231,303,218,96,122,52.81,0.528,0.408,0.317
216931,2000,460,196,264,194,93,101,51.53,0.515,0.422,0.352
217059,2000,900,510,390,366,129,237,46.47,0.465,0.407,0.331
217156,2000,1415,767,648,1177,530,647,84.35,0.843,0.832,0.818
217402,2000,930,527,403,775,328,447,84.82,0.848,0.833,0.814
217536,2000,510,383,127,273,63,210,54.83,0.548,0.535,0.496
217776,2000,92,51,41,33,12,21,41.18,0.412,0.359,0.293
217819,2000,1985,1337,648,835,215,620,46.37,0.464,0.421,0.332
217882,2000,3028,1451,1577,1333,496,837,57.68,0.577,0.44,0.315
217998,2000,138,79,59,89,31,58,73.42,0.734,0.645,0.525
218061,2000,602,356,246,95,33,62,17.42,0.174,0.158,0.134
218229,2000,509,321,188,88,23,65,20.25,0.202,0.173,0.122
218238,2000,103,49,54,23,6,17,34.69,0.347,0.223,0.111
218399,2000,265,167,98,48,14,34,20.36,0.204,0.181,0.143
218414,2000,181,80,101,58,25,33,41.25,0.413,0.32,0.248
218663,2000,2475,1394,1081,988,351,637,45.7,0.457,0.399,0.325
218724,2000,784,434,350,157,57,100,23.04,0.23,0.2,0.163
218733,2000,571,307,264,170,48,122,39.74,0.397,0.298,0.182
218742,2000,546,358,188,94,24,70,19.55,0.196,0.172,0.128
218973,2000,308,150,158,222,104,118,78.67,0.787,0.721,0.658
219000,2000,460,286,174,222,76,146,51.05,0.51,0.483,0.437
219046,2000,586,361,225,48,11,37,10.25,0.103,0.082,0.049
219082,2000,351,149,202,51,25,26,17.45,0.174,0.145,0.124
219198,2000,154,97,57,46,21,25,25.77,0.258,0.299,0.368
219259,2000,446,257,189,61,10,51,19.84,0.198,0.137,0.053
219356,2000,1446,740,706,327,129,198,26.76,0.268,0.226,0.183
219471,2000,918,504,414,199,62,137,27.18,0.272,0.217,0.15
219602,2000,870,554,316,101,29,72,13,0.13,0.116,0.092
219709,2000,516,309,207,278,108,170,55.02,0.55,0.539,0.522
219718,2000,137,44,93,17,7,10,22.73,0.227,0.124,0.075
219949,2000,189,78,111,28,9,19,24.36,0.244,0.148,0.081
220075,2000,1483,824,659,244,73,171,20.75,0.208,0.165,0.111
220215,2000,357,198,159,132,60,72,36.36,0.364,0.37,0.377
220613,2000,711,435,276,204,72,132,30.34,0.303,0.287,0.261
220631,2000,168,104,64,50,21,29,27.88,0.279,0.298,0.328
220710,2000,269,132,137,135,54,81,61.36,0.614,0.502,0.394
221351,2000,396,227,169,296,125,171,75.33,0.753,0.747,0.74
221519,2000,385,203,182,276,126,150,73.89,0.739,0.717,0.692
221731,2000,134,72,62,35,9,26,36.11,0.361,0.261,0.145
221847,2000,1305,609,696,241,85,156,25.62,0.256,0.185,0.122
221892,2000,220,130,90,80,24,56,43.08,0.431,0.364,0.267
222178,2000,1023,565,458,355,139,216,38.23,0.382,0.347,0.303
222983,2000,347,186,161,249,106,143,76.88,0.769,0.718,0.658
223232,2000,2822,1666,1156,1388,442,946,56.78,0.568,0.492,0.382
224004,2000,130,73,57,24,8,16,21.92,0.219,0.185,0.14
224323,2000,279,168,111,167,59,108,64.29,0.643,0.599,0.532
225432,2000,794,437,357,16,6,10,2.29,0.023,0.02,0.017
225548,2000,355,175,180,82,28,54,30.86,0.309,0.231,0.156
225627,2000,388,253,135,77,20,57,22.53,0.225,0.198,0.148
226231,2000,286,79,207,96,58,38,48.1,0.481,0.336,0.28
226833,2000,696,355,341,64,33,31,8.73,0.087,0.092,0.097
227216,2000,2841,1664,1177,515,142,373,22.42,0.224,0.181,0.121
227331,2000,267,205,62,42,7,35,17.07,0.171,0.157,0.113
227526,2000,1230,657,573,163,46,117,17.81,0.178,0.133,0.08
227757,2000,628,290,338,498,249,249,85.86,0.859,0.793,0.737
227845,2000,397,207,190,118,42,76,36.71,0.367,0.297,0.221
227863,2000,303,207,96,72,19,53,25.6,0.256,0.238,0.198
228042,2000,207,124,83,40,16,24,19.35,0.194,0.193,0.193
228149,2000,656,399,257,201,60,141,35.34,0.353,0.306,0.233
228246,2000,1276,713,563,736,280,456,63.96,0.64,0.577,0.497
228343,2000,355,195,160,230,91,139,71.28,0.713,0.648,0.569
228431,2000,2210,1371,839,370,88,282,20.57,0.206,0.167,0.105
228459,2000,2531,1553,978,522,122,400,25.76,0.258,0.206,0.125
228501,2000,263,105,158,13,7,6,5.71,0.057,0.049,0.044
228529,2000,475,238,237,100,40,60,25.21,0.252,0.211,0.169
228705,2000,819,332,487,79,33,46,13.86,0.139,0.096,0.068
228723,2000,6591,3453,3138,2409,774,1635,47.35,0.474,0.365,0.247
228769,2000,1589,801,788,225,102,123,15.36,0.154,0.142,0.129
228778,2000,7551,3857,3694,3447,1403,2044,52.99,0.53,0.456,0.38
228787,2000,801,303,498,248,127,121,39.93,0.399,0.31,0.255
228796,2000,2018,1046,972,85,30,55,5.26,0.053,0.042,0.031
228875,2000,1493,902,591,671,210,461,51.11,0.511,0.449,0.355
228981,2000,330,175,155,125,48,77,44,0.44,0.379,0.31
229018,2000,144,86,58,23,8,15,17.44,0.174,0.16,0.138
229027,2000,1727,894,833,121,47,74,8.28,0.083,0.07,0.056
229115,2000,3998,1982,2016,1005,359,646,32.59,0.326,0.251,0.178
229780,2000,216,120,96,30,6,24,20,0.2,0.139,0.062
229814,2000,867,471,396,121,40,81,17.2,0.172,0.14,0.101
230603,2000,513,414,99,98,12,86,20.77,0.208,0.191,0.121
230728,2000,1632,1116,516,357,76,281,25.18,0.252,0.219,0.147
230764,2000,2067,1029,1038,441,155,286,27.79,0.278,0.213,0.149
230782,2000,1663,1000,663,135,39,96,9.6,0.096,0.081,0.059
231059,2000,521,283,238,366,149,217,76.68,0.767,0.702,0.626
231174,2000,1765,988,777,917,344,573,58,0.58,0.52,0.443
231420,2000,192,64,128,44,17,27,42.19,0.422,0.229,0.133
231554,2000,107,54,53,26,13,13,24.07,0.241,0.243,0.245
231624,2000,1347,782,565,1118,425,693,88.62,0.886,0.83,0.752
231712,2000,999,587,412,262,73,189,32.2,0.322,0.262,0.177
232025,2000,251,127,124,126,53,73,57.48,0.575,0.502,0.427
232043,2000,220,137,83,106,35,71,51.82,0.518,0.482,0.422
232089,2000,281,102,179,47,23,24,23.53,0.235,0.167,0.128
232186,2000,2097,1132,965,650,194,456,40.28,0.403,0.31,0.201
232265,2000,828,527,301,327,79,248,47.06,0.471,0.395,0.262
232423,2000,3223,1981,1242,2089,684,1405,70.92,0.709,0.648,0.551
232557,2000,1216,657,559,431,167,264,40.18,0.402,0.354,0.299
232566,2000,895,611,284,412,105,307,50.25,0.503,0.46,0.37
232609,2000,438,252,186,188,70,118,46.83,0.468,0.429,0.376
232681,2000,873,609,264,622,175,447,73.4,0.734,0.712,0.663
232706,2000,309,230,79,120,21,99,43.04,0.43,0.388,0.266
232937,2000,1262,808,454,141,52,89,11.01,0.11,0.112,0.115
232982,2000,1407,798,609,321,93,228,28.57,0.286,0.228,0.153
233277,2000,1753,1081,672,610,191,419,38.76,0.388,0.348,0.284
233374,2000,723,366,357,574,278,296,80.87,0.809,0.794,0.779
233426,2000,444,274,170,259,80,179,65.33,0.653,0.583,0.471
233541,2000,377,187,190,105,35,70,37.43,0.374,0.279,0.184
233897,2000,277,137,140,74,22,52,37.96,0.38,0.267,0.157
233921,2000,4586,2024,2562,2339,1047,1292,63.83,0.638,0.51,0.409
234030,2000,2670,1608,1062,522,161,361,22.45,0.224,0.196,0.152
234085,2000,349,22,327,204,189,15,68.18,0.682,0.585,0.578
234155,2000,885,498,387,187,45,142,28.51,0.285,0.211,0.116
234164,2000,456,265,191,69,16,53,20,0.2,0.151,0.084
235097,2000,1085,642,443,227,64,163,25.39,0.254,0.209,0.144
235167,2000,468,254,214,208,81,127,50,0.5,0.444,0.379
236230,2000,580,355,225,293,94,199,56.06,0.561,0.505,0.418
236328,2000,647,408,239,442,155,287,70.34,0.703,0.683,0.649
236577,2000,612,413,199,293,90,203,49.15,0.492,0.479,0.452
236595,2000,664,428,236,338,104,234,54.67,0.547,0.509,0.441
236896,2000,338,160,178,62,25,37,23.12,0.231,0.183,0.14
236939,2000,2440,1257,1183,794,277,517,41.13,0.411,0.325,0.234
236948,2000,4765,2495,2270,2271,926,1345,53.91,0.539,0.477,0.408
237011,2000,2351,1427,924,692,212,480,33.64,0.336,0.294,0.229
237057,2000,349,220,129,278,99,179,81.36,0.814,0.797,0.767
237066,2000,402,234,168,242,86,156,66.67,0.667,0.602,0.512
237215,2000,443,254,189,30,14,16,6.3,0.063,0.068,0.074
237330,2000,694,381,313,87,26,61,16.01,0.16,0.125,0.083
237358,2000,133,76,57,39,18,21,27.63,0.276,0.293,0.316
237367,2000,589,333,256,87,25,62,18.62,0.186,0.148,0.098
237792,2000,669,378,291,101,32,69,18.25,0.182,0.151,0.11
237899,2000,542,277,265,19,6,13,4.69,0.047,0.035,0.023
237932,2000,513,275,238,91,29,62,22.55,0.226,0.177,0.122
237969,2000,415,232,183,169,56,113,48.71,0.487,0.407,0.306
238032,2000,3480,1679,1801,889,346,543,32.34,0.323,0.255,0.192
238333,2000,306,177,129,168,79,89,50.28,0.503,0.549,0.612
238430,2000,207,122,85,129,53,76,62.3,0.623,0.623,0.624
238458,2000,500,334,166,220,58,162,48.5,0.485,0.44,0.349
238476,2000,532,295,237,232,91,141,47.8,0.478,0.436,0.384
238616,2000,285,169,116,106,43,63,37.28,0.373,0.372,0.371
238661,2000,274,203,71,81,13,68,33.5,0.335,0.296,0.183
239080,2000,245,180,65,85,18,67,37.22,0.372,0.347,0.277
239105,2000,1675,926,749,963,404,559,60.37,0.604,0.575,0.539
239628,2000,280,166,114,171,64,107,64.46,0.645,0.611,0.561
239716,2000,548,321,227,364,128,236,73.52,0.735,0.664,0.564
240107,2000,327,252,75,98,16,82,32.54,0.325,0.3,0.213
240189,2000,2052,1051,1001,423,155,268,25.5,0.255,0.206,0.155
240277,2000,929,631,298,216,55,161,25.52,0.255,0.233,0.185
240329,2000,1609,1009,600,420,131,289,28.64,0.286,0.261,0.218
240338,2000,194,125,69,91,33,58,46.4,0.464,0.469,0.478
240365,2000,1624,969,655,236,65,171,17.65,0.176,0.145,0.099
240374,2000,747,413,334,82,31,51,12.35,0.124,0.11,0.093
240417,2000,1307,668,639,195,58,137,20.51,0.205,0.149,0.091
240426,2000,395,234,161,57,21,36,15.38,0.154,0.144,0.13
240444,2000,5636,3120,2516,2500,963,1537,49.26,0.493,0.444,0.383
240453,2000,2663,1449,1214,395,142,253,17.46,0.175,0.148,0.117
240462,2000,958,340,618,129,53,76,22.35,0.224,0.135,0.086
240471,2000,1096,669,427,259,81,178,26.61,0.266,0.236,0.19
240480,2000,1518,925,593,333,107,226,24.43,0.244,0.219,0.18
240727,2000,1313,658,655,337,126,211,32.07,0.321,0.257,0.192
243443,2000,540,350,190,59,10,49,14,0.14,0.109,0.053
243780,2000,6403,2646,3757,2209,1046,1163,43.95,0.44,0.345,0.278
100654,2001,1038,541,497,138,34,104,19.22,0.192,0.133,0.068
100663,2001,1224,765,459,175,57,118,15.42,0.154,0.143,0.124
100751,2001,2384,1342,1042,920,313,607,45.23,0.452,0.386,0.3
100858,2001,3739,1949,1790,1284,468,816,41.87,0.419,0.343,0.261
101435,2001,146,96,50,58,13,45,46.88,0.469,0.397,0.26
101480,2001,877,480,397,146,40,106,22.08,0.221,0.166,0.101
101675,2001,423,213,210,29,9,20,9.39,0.094,0.069,0.043
101879,2001,816,465,351,147,36,111,23.87,0.239,0.18,0.103
102049,2001,658,434,224,354,109,245,56.45,0.565,0.538,0.487
102094,2001,1116,634,482,160,40,120,18.93,0.189,0.143,0.083
102234,2001,251,137,114,112,39,73,53.28,0.533,0.446,0.342
102368,2001,1054,572,482,211,71,140,24.48,0.245,0.2,0.147
102377,2001,645,375,270,108,41,67,17.87,0.179,0.167,0.152
104151,2001,5950,3157,2793,1649,599,1050,33.26,0.333,0.277,0.214
104179,2001,5727,3005,2722,1871,717,1154,38.4,0.384,0.327,0.263
105330,2001,2146,1299,847,609,169,440,33.87,0.339,0.284,0.2
106245,2001,703,410,293,57,19,38,9.27,0.093,0.081,0.065
106342,2001,129,80,49,68,20,48,60,0.6,0.527,0.408
106397,2001,2190,1126,1064,718,290,428,38.01,0.38,0.328,0.273
106412,2001,700,371,329,97,21,76,20.49,0.205,0.139,0.064
106458,2001,1594,921,673,309,86,223,24.21,0.242,0.194,0.128
106467,2001,1202,564,638,235,108,127,22.52,0.225,0.196,0.169
106485,2001,654,382,272,51,15,36,9.42,0.094,0.078,0.055
106704,2001,1668,1028,640,367,102,265,25.78,0.258,0.22,0.159
107044,2001,979,547,432,365,145,220,40.22,0.402,0.373,0.336
107080,2001,279,164,115,157,49,108,65.85,0.658,0.563,0.426
107141,2001,241,149,92,132,50,82,55.03,0.55,0.548,0.543
107512,2001,400,214,186,183,73,110,51.4,0.514,0.458,0.392
107558,2001,190,116,74,61,22,39,33.62,0.336,0.321,0.297
110097,2001,649,426,223,360,113,247,57.98,0.58,0.555,0.507
110404,2001,214,78,136,175,110,65,83.33,0.833,0.818,0.809
110422,2001,2957,1374,1583,629,220,409,29.77,0.298,0.213,0.139
110486,2001,610,393,217,86,20,66,16.79,0.168,0.141,0.092
110495,2001,516,352,164,96,24,72,20.45,0.204,0.186,0.146
110510,2001,1273,774,499,127,36,91,11.76,0.118,0.1,0.072
110529,2001,2412,961,1451,229,91,138,14.36,0.144,0.095,0.063
110538,2001,2092,1175,917,314,64,250,21.28,0.213,0.15,0.07
110547,2001,561,391,170,26,6,20,5.12,0.051,0.046,0.035
110556,2001,1946,1179,767,275,74,201,17.05,0.17,0.141,0.096
110565,2001,2772,1673,1099,416,86,330,19.73,0.197,0.15,0.078
110574,2001,692,435,257,75,17,58,13.33,0.133,0.108,0.066
110583,2001,4324,2751,1573,420,117,303,11.01,0.11,0.097,0.074
110592,2001,1223,767,456,117,26,91,11.86,0.119,0.096,0.057
110617,2001,2278,1387,891,221,49,172,12.4,0.124,0.097,0.055
113698,2001,127,90,37,51,13,38,42.22,0.422,0.402,0.351
115755,2001,725,416,309,81,18,63,15.14,0.151,0.112,0.058
119173,2001,328,325,3,47,1,46,14.15,0.142,0.143,0.333
120184,2001,111,85,26,55,10,45,52.94,0.529,0.495,0.385
121309,2001,545,346,199,327,106,221,63.87,0.639,0.6,0.533
121345,2001,393,192,201,339,173,166,86.46,0.865,0.863,0.861
122409,2001,3338,1986,1352,664,178,486,24.47,0.245,0.199,0.132
122436,2001,1003,646,357,635,217,418,64.71,0.647,0.633,0.608
122597,2001,1820,1157,663,209,58,151,13.05,0.13,0.115,0.087
122612,2001,840,572,268,411,114,297,51.92,0.519,0.489,0.425
122931,2001,1017,556,461,799,339,460,82.73,0.827,0.786,0.735
123554,2001,580,352,228,350,129,221,62.78,0.628,0.603,0.566
123572,2001,1018,673,345,258,53,205,30.46,0.305,0.253,0.154
126562,2001,492,288,204,63,27,36,12.5,0.125,0.128,0.132
126580,2001,785,453,332,171,54,117,25.83,0.258,0.218,0.163
126614,2001,4962,2396,2566,2013,887,1126,46.99,0.47,0.406,0.346
126818,2001,3683,2061,1622,1285,420,865,41.97,0.42,0.349,0.259
127060,2001,933,486,447,561,249,312,64.2,0.642,0.601,0.557
127185,2001,1047,469,578,139,50,89,18.98,0.19,0.133,0.087
127565,2001,1596,816,780,97,42,55,6.74,0.067,0.061,0.054
127741,2001,2108,1309,799,623,140,483,36.9,0.369,0.296,0.175
128106,2001,634,343,291,115,47,68,19.83,0.198,0.181,0.162
128744,2001,175,97,78,49,17,32,32.99,0.33,0.28,0.218
128771,2001,1261,623,638,169,74,95,15.25,0.152,0.134,0.116
129020,2001,3122,1648,1474,1671,682,989,60.01,0.6,0.535,0.463
129242,2001,831,463,368,646,265,381,82.29,0.823,0.777,0.72
129941,2001,503,202,301,123,54,69,34.16,0.342,0.245,0.179
130253,2001,766,465,301,457,172,285,61.29,0.613,0.597,0.571
130314,2001,165,165,0,75,0,75,45.45,0.454,0.455,NA
130493,2001,1429,858,571,134,37,97,11.31,0.113,0.094,0.065
130590,2001,491,239,252,388,184,204,85.36,0.854,0.79,0.73
130697,2001,722,372,350,606,280,326,87.63,0.876,0.839,0.8
130776,2001,841,439,402,111,36,75,17.08,0.171,0.132,0.09
130794,2001,1293,648,645,1125,538,587,90.59,0.906,0.87,0.834
130934,2001,686,385,301,107,30,77,20,0.2,0.156,0.1
130943,2001,3362,1944,1418,2147,767,1380,70.99,0.71,0.639,0.541
131159,2001,1387,875,512,924,330,594,67.89,0.679,0.666,0.645
131283,2001,613,342,271,407,170,237,69.3,0.693,0.664,0.627
131450,2001,213,113,100,10,3,7,6.19,0.062,0.047,0.03
131469,2001,2566,1433,1133,1864,761,1103,76.97,0.77,0.726,0.672
131496,2001,1482,757,725,1339,648,691,91.28,0.913,0.904,0.894
131520,2001,1344,900,444,680,185,495,55,0.55,0.506,0.417
132471,2001,431,264,167,101,32,69,26.14,0.261,0.234,0.192
132602,2001,720,386,334,91,31,60,15.54,0.155,0.126,0.093
132903,2001,4913,2621,2292,1529,529,1000,38.15,0.382,0.311,0.231
133492,2001,424,241,183,225,83,142,58.92,0.589,0.531,0.454
133553,2001,1013,159,854,338,277,61,38.36,0.384,0.334,0.324
133650,2001,2243,1300,943,368,88,280,21.54,0.215,0.164,0.093
133669,2001,1937,1120,817,292,85,207,18.48,0.185,0.151,0.104
133711,2001,407,253,154,185,59,126,49.8,0.498,0.455,0.383
133881,2001,544,153,391,203,128,75,49.02,0.49,0.373,0.327
133951,2001,2457,1364,1093,527,145,382,28.01,0.28,0.214,0.133
134079,2001,515,323,192,205,66,139,43.03,0.43,0.398,0.344
134097,2001,5681,3318,2363,2702,928,1774,53.47,0.535,0.476,0.393
134130,2001,6178,3348,2830,3304,1208,2096,62.6,0.626,0.535,0.427
134945,2001,428,186,242,219,140,79,42.47,0.425,0.512,0.579
135726,2001,2152,1277,875,1349,503,846,66.25,0.662,0.627,0.575
136172,2001,1672,979,693,392,126,266,27.17,0.272,0.234,0.182
136950,2001,473,300,173,278,90,188,62.67,0.627,0.588,0.52
137546,2001,527,298,229,289,117,172,57.72,0.577,0.548,0.511
138354,2001,695,406,289,167,59,108,26.6,0.266,0.24,0.204
138716,2001,420,266,154,79,17,62,23.31,0.233,0.188,0.11
138789,2001,551,328,223,39,7,32,9.76,0.098,0.071,0.031
139144,2001,536,357,179,262,74,188,52.66,0.527,0.489,0.413
139366,2001,761,468,293,84,20,64,13.68,0.137,0.11,0.068
139393,2001,238,151,87,120,41,79,52.32,0.523,0.504,0.471
139658,2001,1547,817,730,1013,486,527,64.5,0.645,0.655,0.666
139719,2001,425,225,200,60,16,44,19.56,0.196,0.141,0.08
139755,2001,2223,634,1589,736,441,295,46.53,0.465,0.331,0.278
139764,2001,266,173,93,31,8,23,13.29,0.133,0.117,0.086
139861,2001,879,556,323,203,52,151,27.16,0.272,0.231,0.161
139931,2001,2632,1278,1354,435,110,325,25.43,0.254,0.165,0.081
139940,2001,2136,1305,831,357,99,258,19.77,0.198,0.167,0.119
139959,2001,4459,2646,1813,2137,677,1460,55.18,0.552,0.479,0.373
140447,2001,767,472,295,257,73,184,38.98,0.39,0.335,0.247
140960,2001,440,238,202,58,13,45,18.91,0.189,0.132,0.064
140988,2001,258,186,72,92,20,72,38.71,0.387,0.357,0.278
141185,2001,198,124,74,71,25,46,37.1,0.371,0.359,0.338
141264,2001,1534,937,597,266,67,199,21.24,0.212,0.173,0.112
141334,2001,1551,931,620,194,34,160,17.19,0.172,0.125,0.055
141486,2001,223,160,63,39,11,28,17.5,0.175,0.175,0.175
141565,2001,400,231,169,53,17,36,15.58,0.156,0.132,0.101
141574,2001,1521,883,638,224,61,163,18.46,0.185,0.147,0.096
142276,2001,1485,783,702,53,9,44,5.62,0.056,0.036,0.013
142285,2001,1642,791,851,340,122,218,27.56,0.276,0.207,0.143
142461,2001,265,150,115,83,31,52,34.67,0.347,0.313,0.27
143084,2001,550,310,240,392,167,225,72.58,0.726,0.713,0.696
143288,2001,162,95,67,60,18,42,44.21,0.442,0.37,0.269
144005,2001,395,280,115,16,3,13,4.64,0.046,0.041,0.026
144281,2001,1448,767,681,353,157,196,25.55,0.256,0.244,0.231
144740,2001,2042,1180,862,866,325,541,45.85,0.458,0.424,0.377
144892,2001,1431,836,595,445,135,310,37.08,0.371,0.311,0.227
144962,2001,302,169,133,153,47,106,62.72,0.627,0.507,0.353
144971,2001,146,75,71,60,26,34,45.33,0.453,0.411,0.366
145600,2001,2637,1470,1167,590,210,380,25.85,0.258,0.224,0.18
145619,2001,262,159,103,120,41,79,49.69,0.497,0.458,0.398
145637,2001,6234,3008,3226,3886,1789,2097,69.71,0.697,0.623,0.555
145691,2001,205,113,92,94,37,57,50.44,0.504,0.459,0.402
145813,2001,3331,2080,1251,1316,364,952,45.77,0.458,0.395,0.291
146481,2001,336,188,148,214,83,131,69.68,0.697,0.637,0.561
146612,2001,384,191,193,126,52,74,38.74,0.387,0.328,0.269
146719,2001,1424,960,464,674,202,472,49.17,0.492,0.473,0.435
146825,2001,144,65,79,37,14,23,35.38,0.354,0.257,0.177
147013,2001,284,168,116,128,35,93,55.36,0.554,0.451,0.302
147244,2001,646,356,290,349,139,210,58.99,0.59,0.54,0.479
147341,2001,258,122,136,128,67,61,50,0.5,0.496,0.493
147703,2001,2792,1459,1333,725,281,444,30.43,0.304,0.26,0.211
147767,2001,1947,1026,921,1682,769,913,88.99,0.89,0.864,0.835
147776,2001,964,622,342,21,7,14,2.25,0.022,0.022,0.02
147828,2001,541,297,244,240,90,150,50.51,0.505,0.444,0.369
148131,2001,231,119,112,83,32,51,42.86,0.429,0.359,0.286
148496,2001,222,139,83,111,34,77,55.4,0.554,0.5,0.41
148584,2001,177,112,65,72,21,51,45.54,0.455,0.407,0.323
148627,2001,353,208,145,88,31,57,27.4,0.274,0.249,0.214
149222,2001,2153,967,1186,501,220,281,29.06,0.291,0.233,0.185
149231,2001,1573,895,678,332,108,224,25.03,0.25,0.211,0.159
149772,2001,1677,836,841,557,245,312,37.32,0.373,0.332,0.291
149781,2001,572,276,296,416,200,216,78.26,0.783,0.727,0.676
150066,2001,462,272,190,170,45,125,45.96,0.46,0.368,0.237
150136,2001,3743,2039,1704,1066,344,722,35.41,0.354,0.285,0.202
150145,2001,258,161,97,110,34,76,47.2,0.472,0.426,0.351
150163,2001,929,593,336,512,168,344,58.01,0.58,0.551,0.5
150400,2001,620,350,270,481,205,276,78.86,0.789,0.776,0.759
150534,2001,511,310,201,226,93,133,42.9,0.429,0.442,0.463
150668,2001,172,94,78,87,33,54,57.45,0.575,0.506,0.423
150941,2001,220,135,85,117,43,74,54.81,0.548,0.532,0.506
151102,2001,1426,735,691,69,30,39,5.31,0.053,0.048,0.043
151111,2001,2275,1325,950,188,71,117,8.83,0.088,0.083,0.075
151306,2001,1897,1135,762,236,64,172,15.15,0.152,0.124,0.084
151324,2001,2156,1166,990,413,148,265,22.73,0.227,0.192,0.149
151333,2001,343,233,110,36,8,28,12.02,0.12,0.105,0.073
151342,2001,750,449,301,40,15,25,5.57,0.056,0.053,0.05
151351,2001,6728,3716,3012,3353,1424,1929,51.91,0.519,0.498,0.473
151360,2001,511,340,171,43,12,31,9.12,0.091,0.084,0.07
151379,2001,722,440,282,57,13,44,10,0.1,0.079,0.046
151388,2001,264,172,92,18,5,13,7.56,0.076,0.068,0.054
151777,2001,334,179,155,145,53,92,51.4,0.514,0.434,0.342
151786,2001,183,113,70,66,21,45,39.82,0.398,0.361,0.3
152080,2001,2036,958,1078,1825,956,869,90.71,0.907,0.896,0.887
152248,2001,958,507,451,37,12,25,4.93,0.049,0.039,0.027
152363,2001,232,121,111,105,43,62,51.24,0.512,0.453,0.387
152530,2001,491,251,240,341,160,181,72.11,0.721,0.695,0.667
152600,2001,660,339,321,442,187,255,75.22,0.752,0.67,0.583
153001,2001,379,189,190,166,69,97,51.32,0.513,0.438,0.363
153108,2001,412,237,175,274,108,166,70.04,0.7,0.665,0.617
153269,2001,755,476,279,361,122,239,50.21,0.502,0.478,0.437
153384,2001,356,184,172,291,130,161,87.5,0.875,0.817,0.756
153603,2001,4589,2087,2502,1463,591,872,41.78,0.418,0.319,0.236
153834,2001,636,397,239,401,144,257,64.74,0.647,0.631,0.603
154095,2001,2055,1310,745,665,189,476,36.34,0.363,0.324,0.254
155089,2001,197,133,64,23,6,17,12.78,0.128,0.117,0.094
155317,2001,4024,2198,1826,1267,476,791,35.99,0.36,0.315,0.261
155335,2001,130,76,54,40,18,22,28.95,0.29,0.308,0.333
155399,2001,3358,1689,1669,836,274,562,33.27,0.333,0.249,0.164
155520,2001,248,124,124,74,20,54,43.55,0.436,0.298,0.161
155627,2001,132,46,86,35,11,24,52.17,0.522,0.265,0.128
155937,2001,105,51,54,39,16,23,45.1,0.451,0.371,0.296
156213,2001,331,206,125,178,66,112,54.37,0.544,0.538,0.528
156286,2001,376,255,121,178,47,131,51.37,0.514,0.473,0.388
156295,2001,424,241,183,192,76,116,48.13,0.481,0.453,0.415
156365,2001,330,175,155,58,24,34,19.43,0.194,0.176,0.155
156541,2001,406,203,203,93,33,60,29.56,0.296,0.229,0.163
156745,2001,356,203,153,173,69,104,51.23,0.512,0.486,0.451
157058,2001,387,199,188,31,4,27,13.57,0.136,0.08,0.021
157076,2001,164,60,104,24,8,16,26.67,0.267,0.146,0.077
157085,2001,3129,1679,1450,942,374,568,33.83,0.338,0.301,0.258
157289,2001,2209,1150,1059,351,137,214,18.61,0.186,0.159,0.129
157386,2001,1588,894,694,185,66,119,13.31,0.133,0.116,0.095
157401,2001,1409,827,582,423,135,288,34.82,0.348,0.3,0.232
157447,2001,1787,1008,779,149,52,97,9.62,0.096,0.083,0.067
157535,2001,258,142,116,41,11,30,21.13,0.211,0.159,0.095
157951,2001,2640,1563,1077,651,192,459,29.37,0.294,0.247,0.178
158477,2001,256,168,88,116,31,85,50.6,0.506,0.453,0.352
159009,2001,884,479,405,94,23,71,14.82,0.148,0.106,0.057
159391,2001,5214,2873,2341,1282,424,858,29.86,0.299,0.246,0.181
159647,2001,1770,850,920,481,211,270,31.76,0.318,0.272,0.229
159717,2001,1350,745,605,151,56,95,12.75,0.128,0.112,0.093
159966,2001,1408,841,567,121,28,93,11.06,0.111,0.086,0.049
160038,2001,1543,951,592,198,43,155,16.3,0.163,0.128,0.073
160612,2001,2007,1209,798,199,51,148,12.24,0.122,0.099,0.064
160621,2001,1206,690,516,75,14,61,8.84,0.088,0.062,0.027
160658,2001,2301,1306,995,322,93,229,17.53,0.175,0.14,0.093
161004,2001,452,228,224,374,191,183,80.26,0.803,0.827,0.853
161226,2001,479,323,156,174,45,129,39.94,0.399,0.363,0.288
161235,2001,99,49,50,24,8,16,32.65,0.326,0.242,0.16
161244,2001,155,105,50,32,6,26,24.76,0.248,0.206,0.12
161253,2001,1545,737,808,495,214,281,38.13,0.381,0.32,0.265
161554,2001,922,538,384,93,26,67,12.45,0.124,0.101,0.068
162007,2001,594,356,238,89,21,68,19.1,0.191,0.15,0.088
162210,2001,153,95,58,26,3,23,24.21,0.242,0.17,0.052
162283,2001,540,384,156,36,4,32,8.33,0.083,0.067,0.026
162584,2001,923,471,452,204,65,139,29.51,0.295,0.221,0.144
162654,2001,341,247,94,197,45,152,61.54,0.615,0.578,0.479
162760,2001,112,110,2,76,2,74,67.27,0.673,0.679,1
162928,2001,1077,435,642,884,510,374,85.98,0.86,0.821,0.794
163046,2001,880,517,363,679,252,427,82.59,0.826,0.772,0.694
163268,2001,1332,603,729,461,204,257,42.62,0.426,0.346,0.28
163286,2001,4341,2063,2278,2535,1169,1366,66.21,0.662,0.584,0.513
163453,2001,1125,663,462,172,39,133,20.06,0.201,0.153,0.084
163462,2001,355,197,158,230,105,125,63.45,0.635,0.648,0.665
163851,2001,945,542,403,429,135,294,54.24,0.542,0.454,0.335
163912,2001,457,287,170,344,114,230,80.14,0.801,0.753,0.671
164076,2001,1910,1245,665,681,169,512,41.12,0.411,0.357,0.254
164173,2001,512,374,138,246,56,190,50.8,0.508,0.48,0.406
164216,2001,338,204,134,234,89,145,71.08,0.711,0.692,0.664
164270,2001,368,209,159,244,88,156,74.64,0.746,0.663,0.553
164447,2001,197,98,99,91,34,57,58.16,0.582,0.462,0.343
164492,2001,140,97,43,69,24,45,46.39,0.464,0.493,0.558
164562,2001,604,369,235,402,148,254,68.83,0.688,0.666,0.63
165015,2001,735,416,319,629,261,368,88.46,0.885,0.856,0.818
165024,2001,1139,695,444,255,59,196,28.2,0.282,0.224,0.133
165334,2001,511,330,181,354,123,231,70,0.7,0.693,0.68
165662,2001,643,406,237,440,163,277,68.23,0.682,0.684,0.688
165671,2001,277,189,88,128,32,96,50.79,0.508,0.462,0.364
165820,2001,405,220,185,91,29,62,28.18,0.282,0.225,0.157
165866,2001,645,455,190,145,28,117,25.71,0.257,0.225,0.147
165936,2001,441,313,128,246,63,183,58.47,0.585,0.558,0.492
166027,2001,1637,786,851,1448,742,706,89.82,0.898,0.885,0.872
166124,2001,691,366,325,609,274,335,91.53,0.915,0.881,0.843
166513,2001,967,349,618,269,128,141,40.4,0.404,0.278,0.207
166629,2001,4289,2298,1991,2046,783,1263,54.96,0.55,0.477,0.393
166638,2001,676,359,317,67,22,45,12.53,0.125,0.099,0.069
166683,2001,1027,426,601,857,479,378,88.73,0.887,0.834,0.797
167288,2001,268,171,97,85,26,59,34.5,0.345,0.317,0.268
167987,2001,1148,575,573,310,125,185,32.17,0.322,0.27,0.218
167996,2001,586,328,258,479,203,276,84.15,0.842,0.817,0.787
168005,2001,710,393,317,285,116,169,43,0.43,0.401,0.366
168148,2001,1163,640,523,970,426,544,85,0.85,0.834,0.815
168254,2001,654,287,367,346,176,170,59.23,0.592,0.529,0.48
168281,2001,494,328,166,364,114,250,76.22,0.762,0.737,0.687
168342,2001,520,257,263,475,236,239,93,0.93,0.913,0.897
168546,2001,450,226,224,267,115,152,67.26,0.673,0.593,0.513
168786,2001,321,227,94,107,29,78,34.36,0.344,0.333,0.309
169080,2001,1026,601,425,571,214,357,59.4,0.594,0.557,0.504
169798,2001,2706,1627,1079,284,92,192,11.8,0.118,0.105,0.085
169910,2001,2128,901,1227,123,66,57,6.33,0.063,0.058,0.054
170082,2001,2977,1826,1151,569,189,380,20.81,0.208,0.191,0.164
170301,2001,763,468,295,474,158,316,67.52,0.675,0.621,0.536
170532,2001,341,198,143,248,100,148,74.75,0.748,0.727,0.699
170639,2001,536,235,301,83,42,41,17.45,0.174,0.155,0.14
170976,2001,5531,2884,2647,3896,1752,2144,74.34,0.743,0.704,0.662
171100,2001,6755,3808,2947,2878,1041,1837,48.24,0.482,0.426,0.353
171128,2001,1189,281,908,281,181,100,35.59,0.356,0.236,0.199
171137,2001,658,330,328,90,33,57,17.27,0.173,0.137,0.101
171146,2001,549,330,219,54,17,37,11.21,0.112,0.098,0.078
171599,2001,151,59,92,52,26,26,44.07,0.441,0.344,0.283
172051,2001,1044,539,505,106,39,67,12.43,0.124,0.102,0.077
172699,2001,4562,2306,2256,857,334,523,22.68,0.227,0.188,0.148
173160,2001,645,385,260,442,173,269,69.87,0.699,0.685,0.665
173258,2001,516,265,251,467,222,245,92.45,0.925,0.905,0.884
173328,2001,200,87,113,57,26,31,35.63,0.356,0.285,0.23
173647,2001,601,343,258,468,196,272,79.3,0.793,0.779,0.76
173902,2001,505,265,240,415,193,222,83.77,0.838,0.822,0.804
174066,2001,5259,2677,2582,1939,841,1098,41.02,0.41,0.369,0.326
174233,2001,2109,1094,1015,495,180,315,28.79,0.288,0.235,0.177
174251,2001,474,296,178,206,74,132,44.59,0.446,0.435,0.416
174491,2001,400,262,138,184,54,130,49.62,0.496,0.46,0.391
174792,2001,502,0,502,360,360,0,NA,NA,0.717,0.717
174844,2001,744,432,312,608,253,355,82.18,0.822,0.817,0.811
174899,2001,314,224,90,175,48,127,56.7,0.567,0.557,0.533
174914,2001,1080,579,501,601,253,348,60.1,0.601,0.556,0.505
175342,2001,495,262,233,97,36,61,23.28,0.233,0.196,0.155
175421,2001,224,122,102,50,22,28,22.95,0.23,0.223,0.216
175616,2001,430,253,177,77,21,56,22.13,0.221,0.179,0.119
175856,2001,930,540,390,154,35,119,22.04,0.22,0.166,0.09
175980,2001,324,178,146,208,80,128,71.91,0.719,0.642,0.548
176017,2001,2126,1110,1016,402,215,187,16.85,0.168,0.189,0.212
176035,2001,189,163,26,44,3,41,25.15,0.252,0.233,0.115
176044,2001,258,158,100,42,9,33,20.89,0.209,0.163,0.09
176080,2001,1826,909,917,483,201,282,31.02,0.31,0.265,0.219
176406,2001,201,137,64,58,13,45,32.85,0.328,0.289,0.203
176628,2001,155,62,93,32,7,25,40.32,0.403,0.206,0.075
176947,2001,240,116,124,67,23,44,37.93,0.379,0.279,0.185
176965,2001,1437,789,648,275,33,242,30.67,0.307,0.191,0.051
177418,2001,153,111,42,50,12,38,34.23,0.342,0.327,0.286
178059,2001,247,183,64,141,31,110,60.11,0.601,0.571,0.484
178341,2001,786,411,375,117,47,70,17.03,0.17,0.149,0.125
178387,2001,1079,666,413,140,44,96,14.41,0.144,0.13,0.107
178396,2001,4112,2175,1937,1686,643,1043,47.95,0.48,0.41,0.332
178402,2001,734,444,290,106,36,70,15.77,0.158,0.144,0.124
178411,2001,691,126,565,144,109,35,27.78,0.278,0.208,0.193
178420,2001,515,313,202,96,25,71,22.68,0.227,0.186,0.124
178615,2001,1456,865,591,666,232,434,50.17,0.502,0.457,0.393
179043,2001,298,150,148,165,76,89,59.33,0.593,0.554,0.514
179159,2001,1329,695,634,827,374,453,65.18,0.652,0.622,0.59
179557,2001,1502,910,592,356,98,258,28.35,0.284,0.237,0.166
179566,2001,2508,1417,1091,672,213,459,32.39,0.324,0.268,0.195
179867,2001,1262,637,625,1049,494,555,87.13,0.871,0.831,0.79
179894,2001,399,250,149,179,64,115,46,0.46,0.449,0.43
179946,2001,248,102,146,97,42,55,53.92,0.539,0.391,0.288
180179,2001,526,346,180,48,15,33,9.54,0.095,0.091,0.083
180461,2001,1720,731,989,292,148,144,19.7,0.197,0.17,0.15
180522,2001,177,76,101,16,10,6,7.89,0.079,0.09,0.099
180984,2001,265,163,102,71,23,48,29.45,0.294,0.268,0.225
181002,2001,760,440,320,454,170,284,64.55,0.645,0.597,0.531
181020,2001,218,118,100,128,62,66,55.93,0.559,0.587,0.62
181127,2001,252,125,127,130,55,75,60,0.6,0.516,0.433
181215,2001,1038,602,436,213,62,151,25.08,0.251,0.205,0.142
181394,2001,1588,857,731,170,62,108,12.6,0.126,0.107,0.085
181446,2001,392,223,169,219,84,135,60.54,0.605,0.559,0.497
181464,2001,3480,1691,1789,788,308,480,28.39,0.284,0.226,0.172
181534,2001,186,85,101,16,5,11,12.94,0.129,0.086,0.05
181783,2001,583,359,224,138,40,98,27.3,0.273,0.237,0.179
182281,2001,2424,1411,1013,324,99,225,15.95,0.16,0.134,0.098
182290,2001,1956,1125,831,268,78,190,16.89,0.169,0.137,0.094
182634,2001,285,184,101,140,43,97,52.72,0.527,0.491,0.426
182795,2001,477,249,228,153,67,86,34.54,0.345,0.321,0.294
183062,2001,942,561,381,283,94,189,33.69,0.337,0.3,0.247
183080,2001,872,463,409,272,89,183,39.52,0.395,0.312,0.218
183239,2001,535,286,249,363,152,211,73.78,0.738,0.679,0.61
183822,2001,250,150,100,41,16,25,16.67,0.167,0.164,0.16
183974,2001,195,141,54,57,6,51,36.17,0.362,0.292,0.111
184348,2001,395,254,141,261,89,172,67.72,0.677,0.661,0.631
184603,2001,448,260,188,80,27,53,20.38,0.204,0.179,0.144
184612,2001,272,188,84,46,9,37,19.68,0.197,0.169,0.107
184782,2001,1276,680,596,498,201,297,43.68,0.437,0.39,0.337
185129,2001,540,304,236,43,14,29,9.54,0.095,0.08,0.059
185572,2001,881,484,397,339,125,214,44.21,0.442,0.385,0.315
185590,2001,1378,826,552,371,102,269,32.57,0.326,0.269,0.185
185828,2001,706,129,577,102,70,32,24.81,0.248,0.144,0.121
186131,2001,1184,570,614,1051,526,525,92.11,0.921,0.888,0.857
186201,2001,628,382,246,303,99,204,53.4,0.534,0.482,0.402
186283,2001,839,472,367,361,143,218,46.19,0.462,0.43,0.39
186584,2001,1182,601,581,495,210,285,47.42,0.474,0.419,0.361
186876,2001,751,424,327,335,122,213,50.24,0.502,0.446,0.373
187134,2001,1258,750,508,852,302,550,73.33,0.733,0.677,0.594
187444,2001,1247,697,550,185,59,126,18.08,0.181,0.148,0.107
187985,2001,2364,1323,1041,280,103,177,13.38,0.134,0.118,0.099
188030,2001,2051,1075,976,250,76,174,16.19,0.162,0.122,0.078
188429,2001,664,469,195,367,89,278,59.28,0.593,0.553,0.456
188641,2001,500,243,257,232,97,135,55.56,0.556,0.464,0.377
190044,2001,722,164,558,382,290,92,56.1,0.561,0.529,0.52
190099,2001,740,392,348,631,282,349,89.03,0.89,0.853,0.81
190150,2001,1330,607,723,1108,612,496,81.71,0.817,0.833,0.846
190248,2001,132,88,44,50,9,41,46.59,0.466,0.379,0.205
190415,2001,2984,1471,1513,2524,1246,1278,86.88,0.869,0.846,0.824
190512,2001,1688,921,767,554,231,323,35.07,0.351,0.328,0.301
190549,2001,1017,591,426,209,64,145,24.53,0.245,0.206,0.15
190558,2001,1600,817,783,57,22,35,4.28,0.043,0.036,0.028
190567,2001,705,310,395,54,17,37,11.94,0.119,0.077,0.043
190594,2001,1877,1284,593,234,41,193,15.03,0.15,0.125,0.069
190637,2001,642,441,201,77,18,59,13.38,0.134,0.12,0.09
190664,2001,1204,704,500,325,100,225,31.96,0.32,0.27,0.2
190691,2001,464,320,144,35,11,24,7.5,0.075,0.075,0.076
190725,2001,340,278,62,88,12,76,27.34,0.273,0.259,0.194
191241,2001,1610,950,660,1218,470,748,78.74,0.787,0.757,0.712
191515,2001,465,233,232,386,185,201,86.27,0.863,0.83,0.797
191533,2001,433,232,201,200,73,127,54.74,0.547,0.462,0.363
191630,2001,548,313,235,368,137,231,73.8,0.738,0.672,0.583
191649,2001,1974,1037,937,685,248,437,42.14,0.421,0.347,0.265
191676,2001,355,229,126,222,77,145,63.32,0.633,0.625,0.611
191931,2001,768,376,392,360,144,216,57.45,0.575,0.469,0.367
191968,2001,1755,1002,753,1230,501,729,72.75,0.728,0.701,0.665
192192,2001,253,188,65,88,14,74,39.36,0.394,0.348,0.215
192323,2001,502,292,210,311,122,189,64.73,0.647,0.62,0.581
192439,2001,825,574,251,55,20,35,6.1,0.061,0.067,0.08
192703,2001,597,276,321,344,162,182,65.94,0.659,0.576,0.505
192749,2001,404,277,127,226,65,161,58.12,0.581,0.559,0.512
192819,2001,908,484,424,632,281,351,72.52,0.725,0.696,0.663
192925,2001,208,166,42,53,12,41,24.7,0.247,0.255,0.286
193016,2001,618,412,206,61,10,51,12.38,0.124,0.099,0.049
193292,2001,210,145,65,66,16,50,34.48,0.345,0.314,0.246
193353,2001,343,239,104,143,33,110,46.03,0.46,0.417,0.317
193399,2001,286,214,72,111,21,90,42.06,0.421,0.388,0.292
193584,2001,358,274,84,239,50,189,68.98,0.69,0.668,0.595
193645,2001,774,650,124,169,13,156,24,0.24,0.218,0.105
193654,2001,617,422,195,269,74,195,46.21,0.462,0.436,0.379
193900,2001,4136,2525,1611,2574,1016,1558,61.7,0.617,0.622,0.631
193973,2001,598,362,236,322,117,205,56.63,0.566,0.538,0.496
194161,2001,320,206,114,103,35,68,33.01,0.33,0.322,0.307
194310,2001,1573,948,625,567,192,375,39.56,0.396,0.36,0.307
194824,2001,1109,283,826,730,532,198,69.96,0.7,0.658,0.644
195003,2001,2227,574,1653,451,249,202,35.19,0.352,0.203,0.151
195030,2001,1095,481,614,767,390,377,78.38,0.784,0.7,0.635
195164,2001,518,263,255,280,121,159,60.46,0.605,0.541,0.475
195173,2001,471,220,251,171,75,96,43.64,0.436,0.363,0.299
195216,2001,511,269,242,377,179,198,73.61,0.736,0.738,0.74
195234,2001,490,356,134,239,45,194,54.49,0.545,0.488,0.336
195243,2001,301,164,137,101,35,66,40.24,0.402,0.336,0.255
195304,2001,323,240,83,213,50,163,67.92,0.679,0.659,0.602
195474,2001,713,394,319,530,230,300,76.14,0.761,0.743,0.721
195526,2001,598,352,246,469,196,273,77.56,0.776,0.784,0.797
195544,2001,66,56,10,43,4,39,69.64,0.696,0.652,0.4
195809,2001,2670,1523,1147,957,357,600,39.4,0.394,0.358,0.311
196413,2001,2601,1493,1108,1837,716,1121,75.08,0.751,0.706,0.646
196592,2001,1520,1064,456,146,42,104,9.77,0.098,0.096,0.092
197045,2001,475,218,257,154,76,78,35.78,0.358,0.324,0.296
197133,2001,695,447,248,612,211,401,89.71,0.897,0.881,0.851
197869,2001,2303,1196,1107,857,309,548,45.82,0.458,0.372,0.279
197984,2001,143,68,75,61,22,39,57.35,0.574,0.427,0.293
198385,2001,465,246,219,420,193,227,92.28,0.923,0.903,0.881
198464,2001,3182,1877,1305,813,242,571,30.42,0.304,0.255,0.185
198507,2001,363,200,163,102,32,70,35,0.35,0.281,0.196
198516,2001,1212,757,455,797,263,534,70.54,0.705,0.658,0.578
198835,2001,268,159,109,107,27,80,50.31,0.503,0.399,0.248
198969,2001,379,117,262,59,28,31,26.5,0.265,0.156,0.107
199102,2001,1760,874,886,354,117,237,27.12,0.271,0.201,0.132
199111,2001,446,281,165,149,43,106,37.72,0.377,0.334,0.261
199120,2001,3681,2195,1486,2611,986,1625,74.03,0.74,0.709,0.664
199139,2001,2309,1273,1036,610,209,401,31.5,0.315,0.264,0.202
199148,2001,1898,1350,548,511,102,409,30.3,0.303,0.269,0.186
199157,2001,763,492,271,174,29,145,29.47,0.295,0.228,0.107
199193,2001,3862,1630,2232,1404,619,785,48.16,0.482,0.364,0.277
199218,2001,1983,1246,737,824,205,619,49.68,0.497,0.416,0.278
199281,2001,688,363,325,100,31,69,19.01,0.19,0.145,0.095
199306,2001,146,69,77,63,26,37,53.62,0.536,0.432,0.338
199412,2001,209,166,43,105,23,82,49.4,0.494,0.502,0.535
199582,2001,324,172,152,52,16,36,20.93,0.209,0.16,0.105
199643,2001,445,283,162,83,18,65,22.97,0.23,0.187,0.111
199847,2001,960,481,479,756,343,413,85.86,0.859,0.787,0.716
199962,2001,393,209,184,147,44,103,49.28,0.493,0.374,0.239
199999,2001,614,424,190,124,17,107,25.24,0.252,0.202,0.089
200004,2001,1176,530,646,266,108,158,29.81,0.298,0.226,0.167
200059,2001,375,188,187,39,8,31,16.49,0.165,0.104,0.043
200156,2001,293,173,120,96,35,61,35.26,0.353,0.328,0.292
200217,2001,372,213,159,143,43,100,46.95,0.47,0.384,0.27
200226,2001,133,62,71,18,6,12,19.35,0.194,0.135,0.085
200253,2001,419,241,178,43,11,32,13.28,0.133,0.103,0.062
200280,2001,1969,870,1099,436,191,245,28.16,0.282,0.221,0.174
200332,2001,1187,491,696,162,80,82,16.7,0.167,0.136,0.115
200572,2001,155,75,80,40,15,25,33.33,0.333,0.258,0.188
201104,2001,492,273,219,200,69,131,47.99,0.48,0.407,0.315
201371,2001,239,133,106,117,44,73,54.89,0.549,0.49,0.415
201548,2001,519,324,195,243,68,175,54.01,0.54,0.468,0.349
201645,2001,737,288,449,433,228,205,71.18,0.712,0.588,0.508
201690,2001,397,204,193,33,7,26,12.75,0.128,0.083,0.036
202134,2001,1008,493,515,95,47,48,9.74,0.097,0.094,0.091
202480,2001,1715,879,836,971,389,582,66.21,0.662,0.566,0.465
202523,2001,553,309,244,414,170,244,78.96,0.79,0.749,0.697
202763,2001,613,377,236,255,69,186,49.34,0.493,0.416,0.292
203085,2001,262,119,143,113,38,75,63.03,0.63,0.431,0.266
203128,2001,269,157,112,149,52,97,61.78,0.618,0.554,0.464
203368,2001,789,442,347,515,219,296,66.97,0.67,0.653,0.631
203517,2001,3588,2202,1386,556,158,398,18.07,0.181,0.155,0.114
203535,2001,424,243,181,344,149,195,80.25,0.802,0.811,0.823
203580,2001,127,98,29,46,7,39,39.8,0.398,0.362,0.241
203775,2001,355,214,141,145,46,99,46.26,0.463,0.408,0.326
203845,2001,362,151,211,164,77,87,57.62,0.576,0.453,0.365
204024,2001,3440,1922,1518,2305,905,1400,72.84,0.728,0.67,0.596
204185,2001,591,329,262,298,89,209,63.53,0.635,0.504,0.34
204194,2001,321,176,145,110,34,76,43.18,0.432,0.343,0.234
204617,2001,174,116,58,51,18,33,28.45,0.284,0.293,0.31
204796,2001,5955,2935,3020,2381,906,1475,50.26,0.503,0.4,0.3
204857,2001,3697,2200,1497,1778,594,1184,53.82,0.538,0.481,0.397
206330,2001,202,67,135,42,19,23,34.33,0.343,0.208,0.141
206589,2001,532,282,250,342,143,199,70.57,0.706,0.643,0.572
206604,2001,2117,1165,952,373,129,244,20.94,0.209,0.176,0.136
206622,2001,795,426,369,555,249,306,71.83,0.718,0.698,0.675
206695,2001,1951,1041,910,243,81,162,15.56,0.156,0.125,0.089
206914,2001,673,355,318,55,16,39,10.99,0.11,0.082,0.05
207209,2001,446,232,214,18,5,13,5.6,0.056,0.04,0.023
207306,2001,310,138,172,36,16,20,14.49,0.145,0.116,0.093
207324,2001,465,234,231,107,42,65,27.78,0.278,0.23,0.182
207388,2001,3111,1594,1517,834,285,549,34.44,0.344,0.268,0.188
207500,2001,3629,1908,1721,897,332,565,29.61,0.296,0.247,0.193
207722,2001,261,138,123,26,11,15,10.87,0.109,0.1,0.089
207847,2001,579,266,313,75,40,35,13.16,0.132,0.13,0.128
207865,2001,853,481,372,128,45,83,17.26,0.173,0.15,0.121
208822,2001,301,180,121,172,64,108,60,0.6,0.571,0.529
209056,2001,415,240,175,277,109,168,70,0.7,0.667,0.623
209065,2001,422,232,190,250,89,161,69.4,0.694,0.592,0.468
209542,2001,2982,1467,1515,885,356,529,36.06,0.361,0.297,0.235
209551,2001,3049,1687,1362,1244,464,780,46.24,0.462,0.408,0.341
209612,2001,310,206,104,171,47,124,60.19,0.602,0.552,0.452
209807,2001,1020,548,472,129,42,87,15.88,0.159,0.126,0.089
209922,2001,349,198,151,203,84,119,60.1,0.601,0.582,0.556
210146,2001,759,436,323,149,47,102,23.39,0.234,0.196,0.146
210401,2001,476,261,215,345,143,202,77.39,0.774,0.725,0.665
210429,2001,811,536,275,144,25,119,22.2,0.222,0.178,0.091
210571,2001,402,243,159,215,75,140,57.61,0.576,0.535,0.472
210669,2001,486,271,215,312,128,184,67.9,0.679,0.642,0.595
210775,2001,248,159,89,90,28,62,38.99,0.39,0.363,0.315
211088,2001,293,203,90,158,47,111,54.68,0.547,0.539,0.522
211158,2001,1684,1021,663,646,183,463,45.35,0.454,0.384,0.276
211291,2001,913,468,445,784,367,417,89.1,0.891,0.859,0.825
211352,2001,374,221,153,166,50,116,52.49,0.525,0.444,0.327
211361,2001,817,413,404,208,84,124,30.02,0.3,0.255,0.208
211431,2001,177,170,7,65,0,65,38.24,0.382,0.367,0
211440,2001,1317,534,783,927,526,401,75.09,0.751,0.704,0.672
211468,2001,170,170,0,78,0,78,45.88,0.459,0.459,NA
211556,2001,133,133,0,56,0,56,42.11,0.421,0.421,NA
211583,2001,94,94,0,50,0,50,53.19,0.532,0.532,NA
211608,2001,292,146,146,32,7,25,17.12,0.171,0.11,0.048
211644,2001,1286,814,472,313,82,231,28.38,0.284,0.243,0.174
211981,2001,355,157,198,126,53,73,46.5,0.465,0.355,0.268
212009,2001,611,321,290,484,218,266,82.87,0.829,0.792,0.752
212054,2001,1934,759,1175,313,124,189,24.9,0.249,0.162,0.106
212106,2001,1176,684,492,596,219,377,55.12,0.551,0.507,0.445
212115,2001,969,564,405,259,66,193,34.22,0.342,0.267,0.163
212133,2001,427,287,140,216,69,147,51.22,0.512,0.506,0.493
212160,2001,1409,831,578,323,99,224,26.96,0.27,0.229,0.171
212197,2001,514,319,195,326,116,210,65.83,0.658,0.634,0.595
212577,2001,510,248,262,401,190,211,85.08,0.851,0.786,0.725
212601,2001,525,313,212,244,83,161,51.44,0.514,0.465,0.392
212832,2001,176,140,36,85,15,70,50,0.5,0.483,0.417
212911,2001,296,154,142,256,120,136,88.31,0.883,0.865,0.845
213020,2001,2557,1460,1097,624,190,434,29.73,0.297,0.244,0.173
213251,2001,340,205,135,242,87,155,75.61,0.756,0.712,0.644
213321,2001,441,217,224,286,121,165,76.04,0.76,0.649,0.54
213349,2001,1630,957,673,474,111,363,37.93,0.379,0.291,0.165
213358,2001,214,133,81,91,34,57,42.86,0.429,0.425,0.42
213367,2001,849,476,373,514,190,324,68.07,0.681,0.605,0.509
213385,2001,575,287,288,487,238,249,86.76,0.868,0.847,0.826
213507,2001,416,229,187,266,105,161,70.31,0.703,0.639,0.561
213543,2001,1109,435,674,798,436,362,83.22,0.832,0.72,0.647
213613,2001,978,581,397,286,96,190,32.7,0.327,0.292,0.242
213668,2001,407,218,189,249,100,149,68.35,0.683,0.612,0.529
213783,2001,640,362,278,200,77,123,33.98,0.34,0.312,0.277
213826,2001,287,215,72,114,23,91,42.33,0.423,0.397,0.319
213996,2001,702,425,277,472,166,306,72,0.72,0.672,0.599
214041,2001,1245,758,487,518,162,356,46.97,0.47,0.416,0.333
214069,2001,260,188,72,157,39,118,62.77,0.628,0.604,0.542
214157,2001,315,200,115,219,68,151,75.5,0.755,0.695,0.591
214175,2001,574,330,244,456,184,272,82.42,0.824,0.794,0.754
214272,2001,345,217,128,115,25,90,41.47,0.415,0.333,0.195
214777,2001,6146,2983,3163,3576,1586,1990,66.71,0.667,0.582,0.501
215062,2001,2316,1148,1168,2018,997,1021,88.94,0.889,0.871,0.854
215743,2001,342,187,155,163,60,103,55.08,0.551,0.477,0.387
215798,2001,262,128,134,161,69,92,71.88,0.719,0.615,0.515
215929,2001,1013,578,435,674,258,416,71.97,0.72,0.665,0.593
216010,2001,1478,805,673,683,239,444,55.16,0.552,0.462,0.355
216038,2001,1314,751,563,378,117,261,34.75,0.348,0.288,0.208
216287,2001,380,193,187,346,165,181,93.78,0.938,0.911,0.882
216339,2001,3157,1826,1331,919,319,600,32.86,0.329,0.291,0.24
216524,2001,387,230,157,278,114,164,71.3,0.713,0.718,0.726
216694,2001,315,159,156,141,56,85,53.46,0.535,0.448,0.359
216764,2001,1626,1020,606,561,144,417,40.88,0.409,0.345,0.238
216807,2001,375,219,156,224,76,148,67.58,0.676,0.597,0.487
216852,2001,550,227,323,188,78,110,48.46,0.485,0.342,0.241
216931,2001,407,198,209,198,99,99,50,0.5,0.486,0.474
217059,2001,968,540,428,383,137,246,45.56,0.456,0.396,0.32
217156,2001,1375,760,615,1154,506,648,85.26,0.853,0.839,0.823
217402,2001,933,531,402,795,334,461,86.82,0.868,0.852,0.831
217536,2001,551,396,155,321,78,243,61.36,0.614,0.583,0.503
217776,2001,139,78,61,46,18,28,35.9,0.359,0.331,0.295
217819,2001,1967,1295,672,868,248,620,47.88,0.479,0.441,0.369
217882,2001,2530,1184,1346,1166,443,723,61.06,0.611,0.461,0.329
217998,2001,217,127,90,125,44,81,63.78,0.638,0.576,0.489
218061,2001,634,377,257,127,41,86,22.81,0.228,0.2,0.16
218229,2001,488,291,197,118,25,93,31.96,0.32,0.242,0.127
218238,2001,136,69,67,31,11,20,28.99,0.29,0.228,0.164
218399,2001,268,167,101,56,13,43,25.75,0.258,0.209,0.129
218414,2001,178,70,108,55,26,29,41.43,0.414,0.309,0.241
218663,2001,3227,1770,1457,1304,461,843,47.63,0.476,0.404,0.316
218724,2001,931,494,437,212,60,152,30.77,0.308,0.228,0.137
218733,2001,615,358,257,135,47,88,24.58,0.246,0.22,0.183
218742,2001,573,350,223,107,36,71,20.29,0.203,0.187,0.161
218973,2001,303,152,151,218,100,118,77.63,0.776,0.719,0.662
219000,2001,416,276,140,214,58,156,56.52,0.565,0.514,0.414
219046,2001,565,354,211,65,27,38,10.73,0.107,0.115,0.128
219082,2001,292,123,169,54,28,26,21.14,0.211,0.185,0.166
219198,2001,148,109,39,49,10,39,35.78,0.358,0.331,0.256
219259,2001,409,244,165,61,14,47,19.26,0.193,0.149,0.085
219356,2001,1495,751,744,316,105,211,28.1,0.281,0.211,0.141
219471,2001,932,578,354,196,45,151,26.12,0.261,0.21,0.127
219602,2001,900,569,331,77,20,57,10.02,0.1,0.086,0.06
219709,2001,502,309,193,284,121,163,52.75,0.527,0.566,0.627
219718,2001,141,63,78,21,3,18,28.57,0.286,0.149,0.038
219949,2001,200,92,108,39,15,24,26.09,0.261,0.195,0.139
220075,2001,1472,838,634,255,79,176,21,0.21,0.173,0.125
220215,2001,346,191,155,146,58,88,46.07,0.461,0.422,0.374
220613,2001,663,405,258,204,57,147,36.3,0.363,0.308,0.221
220631,2001,153,101,52,34,12,22,21.78,0.218,0.222,0.231
220710,2001,288,166,122,133,35,98,59.04,0.59,0.462,0.287
221351,2001,417,249,168,292,107,185,74.3,0.743,0.7,0.637
221519,2001,353,185,168,259,117,142,76.76,0.768,0.734,0.696
221731,2001,119,69,50,33,9,24,34.78,0.348,0.277,0.18
221847,2001,1289,529,760,230,108,122,23.06,0.231,0.178,0.142
221892,2001,216,112,104,82,36,46,41.07,0.411,0.38,0.346
222178,2001,1031,598,433,387,127,260,43.48,0.435,0.375,0.293
222983,2001,312,174,138,220,91,129,74.14,0.741,0.705,0.659
223232,2001,2790,1664,1126,1340,434,906,54.45,0.545,0.48,0.385
224004,2001,189,104,85,28,10,18,17.31,0.173,0.148,0.118
224323,2001,310,180,130,170,77,93,51.67,0.517,0.548,0.592
225432,2001,869,481,388,19,5,14,2.91,0.029,0.022,0.013
225548,2001,319,152,167,80,34,46,30.26,0.303,0.251,0.204
225627,2001,416,285,131,66,10,56,19.65,0.196,0.159,0.076
226231,2001,242,66,176,74,47,27,40.91,0.409,0.306,0.267
226833,2001,668,376,292,69,22,47,12.5,0.125,0.103,0.075
227216,2001,2803,1665,1138,466,146,320,19.22,0.192,0.166,0.128
227331,2001,401,323,78,49,7,42,13,0.13,0.122,0.09
227526,2001,1380,771,609,182,62,120,15.56,0.156,0.132,0.102
227757,2001,657,326,331,509,247,262,80.37,0.804,0.775,0.746
227845,2001,413,254,159,131,37,94,37.01,0.37,0.317,0.233
227863,2001,272,166,106,68,23,45,27.11,0.271,0.25,0.217
228042,2001,180,110,70,46,12,34,30.91,0.309,0.256,0.171
228149,2001,534,299,235,181,72,109,36.45,0.365,0.339,0.306
228246,2001,1353,713,640,751,297,454,63.67,0.637,0.555,0.464
228343,2001,327,174,153,196,77,119,68.39,0.684,0.599,0.503
228431,2001,2191,1370,821,360,90,270,19.71,0.197,0.164,0.11
228459,2001,2469,1508,961,553,134,419,27.79,0.278,0.224,0.139
228501,2001,333,124,209,28,7,21,16.94,0.169,0.084,0.033
228529,2001,783,411,372,126,37,89,21.65,0.216,0.161,0.099
228705,2001,820,388,432,66,28,38,9.79,0.098,0.08,0.065
228723,2001,6271,3265,3006,2408,815,1593,48.79,0.488,0.384,0.271
228769,2001,1838,914,924,271,104,167,18.27,0.183,0.147,0.113
228778,2001,7198,3742,3456,3385,1392,1993,53.26,0.533,0.47,0.403
228787,2001,984,402,582,304,145,159,39.55,0.395,0.309,0.249
228796,2001,2156,1156,1000,89,30,59,5.1,0.051,0.041,0.03
228875,2001,1514,894,620,761,251,510,57.05,0.571,0.503,0.405
228981,2001,376,208,168,133,42,91,43.75,0.438,0.354,0.25
229018,2001,165,104,61,36,9,27,25.96,0.26,0.218,0.148
229027,2001,1910,977,933,137,60,77,7.88,0.079,0.072,0.064
229115,2001,4075,1967,2108,1133,438,695,35.33,0.353,0.278,0.208
229780,2001,204,111,93,50,17,33,29.73,0.297,0.245,0.183
229814,2001,759,419,340,109,24,85,20.29,0.203,0.144,0.071
230603,2001,562,443,119,113,18,95,21.44,0.214,0.201,0.151
230728,2001,1892,1270,622,384,72,312,24.57,0.246,0.203,0.116
230764,2001,1877,1038,839,390,135,255,24.57,0.246,0.208,0.161
230782,2001,1509,897,612,47,18,29,3.23,0.032,0.031,0.029
231059,2001,518,286,232,380,150,230,80.42,0.804,0.734,0.647
231174,2001,1835,1052,783,1017,381,636,60.46,0.605,0.554,0.487
231420,2001,175,81,94,48,12,36,44.44,0.444,0.274,0.128
231554,2001,162,91,71,53,21,32,35.16,0.352,0.327,0.296
231624,2001,1358,793,565,1140,441,699,88.15,0.882,0.839,0.781
231712,2001,1042,595,447,318,100,218,36.64,0.366,0.305,0.224
232025,2001,267,130,137,113,48,65,50,0.5,0.423,0.35
232043,2001,208,124,84,115,44,71,57.26,0.573,0.553,0.524
232089,2001,269,104,165,51,20,31,29.81,0.298,0.19,0.121
232186,2001,2068,1136,932,631,191,440,38.73,0.387,0.305,0.205
232265,2001,1189,748,441,450,106,344,45.99,0.46,0.378,0.24
232423,2001,3244,2004,1240,2103,696,1407,70.21,0.702,0.648,0.561
232557,2001,1129,602,527,381,146,235,39.04,0.39,0.337,0.277
232566,2001,891,611,280,410,103,307,50.25,0.503,0.46,0.368
232609,2001,475,278,197,219,67,152,54.68,0.547,0.461,0.34
232681,2001,840,574,266,570,158,412,71.78,0.718,0.679,0.594
232706,2001,354,241,113,123,29,94,39,0.39,0.347,0.257
232937,2001,1067,655,412,113,25,88,13.44,0.134,0.106,0.061
232982,2001,1502,821,681,340,116,224,27.28,0.273,0.226,0.17
233277,2001,1875,1155,720,674,200,474,41.04,0.41,0.359,0.278
233374,2001,790,430,360,640,277,363,84.42,0.844,0.81,0.769
233426,2001,498,311,187,283,96,187,60.13,0.601,0.568,0.513
233541,2001,308,158,150,106,40,66,41.77,0.418,0.344,0.267
233897,2001,325,154,171,80,36,44,28.57,0.286,0.246,0.211
233921,2001,5020,2063,2957,2511,1228,1283,62.19,0.622,0.5,0.415
234030,2001,2675,1563,1112,547,170,377,24.12,0.241,0.204,0.153
234085,2001,372,17,355,205,196,9,52.94,0.529,0.551,0.552
234155,2001,1085,618,467,252,61,191,30.91,0.309,0.232,0.131
234164,2001,534,316,218,68,12,56,17.72,0.177,0.127,0.055
235097,2001,1179,694,485,256,98,158,22.77,0.228,0.217,0.202
235167,2001,460,236,224,206,93,113,47.88,0.479,0.448,0.415
236230,2001,578,348,230,287,89,198,56.9,0.569,0.497,0.387
236328,2001,702,423,279,477,182,295,69.74,0.697,0.679,0.652
236577,2001,645,433,212,327,95,232,53.58,0.536,0.507,0.448
236595,2001,643,412,231,321,101,220,53.4,0.534,0.499,0.437
236896,2001,285,149,136,63,26,37,24.83,0.248,0.221,0.191
236939,2001,2575,1369,1206,852,314,538,39.3,0.393,0.331,0.26
236948,2001,5288,2737,2551,2555,1099,1456,53.2,0.532,0.483,0.431
237011,2001,2205,1284,921,641,207,434,33.8,0.338,0.291,0.225
237057,2001,362,195,167,288,126,162,83.08,0.831,0.796,0.754
237066,2001,427,265,162,251,88,163,61.51,0.615,0.588,0.543
237215,2001,380,233,147,3,1,2,0.86,0.009,0.008,0.007
237330,2001,646,343,303,199,74,125,36.44,0.364,0.308,0.244
237358,2001,123,71,52,31,13,18,25.35,0.254,0.252,0.25
237367,2001,568,320,248,62,18,44,13.75,0.138,0.109,0.073
237792,2001,647,333,314,71,27,44,13.21,0.132,0.11,0.086
237899,2001,379,193,186,16,5,11,5.7,0.057,0.042,0.027
237932,2001,521,298,223,99,40,59,19.8,0.198,0.19,0.179
237969,2001,400,202,198,175,65,110,54.46,0.545,0.438,0.328
238032,2001,3593,1743,1850,928,381,547,31.38,0.314,0.258,0.206
238333,2001,311,189,122,234,86,148,78.31,0.783,0.752,0.705
238430,2001,296,215,81,78,29,49,22.79,0.228,0.264,0.358
238458,2001,471,319,152,197,48,149,46.71,0.467,0.418,0.316
238476,2001,578,280,298,237,112,125,44.64,0.446,0.41,0.376
238616,2001,351,169,182,158,82,76,44.97,0.45,0.45,0.451
238661,2001,291,203,88,70,21,49,24.14,0.241,0.241,0.239
239080,2001,227,149,78,65,18,47,31.54,0.315,0.286,0.231
239105,2001,1658,950,708,947,374,573,60.32,0.603,0.571,0.528
239628,2001,200,108,92,119,48,71,65.74,0.657,0.595,0.522
239716,2001,558,306,252,359,142,217,70.92,0.709,0.643,0.563
240107,2001,335,254,81,97,20,77,30.31,0.303,0.29,0.247
240189,2001,1857,936,921,379,153,226,24.15,0.242,0.204,0.166
240277,2001,866,608,258,214,45,169,27.8,0.278,0.247,0.174
240329,2001,1596,1022,574,444,138,306,29.94,0.299,0.278,0.24
240338,2001,200,124,76,96,31,65,52.42,0.524,0.48,0.408
240365,2001,1822,994,828,249,86,163,16.4,0.164,0.137,0.104
240374,2001,854,486,368,84,21,63,12.96,0.13,0.098,0.057
240417,2001,1272,652,620,202,62,140,21.47,0.215,0.159,0.1
240426,2001,339,192,147,53,24,29,15.1,0.151,0.156,0.163
240444,2001,6050,3370,2680,2758,1046,1712,50.8,0.508,0.456,0.39
240453,2001,2884,1532,1352,423,160,263,17.17,0.172,0.147,0.118
240462,2001,1039,373,666,176,85,91,24.4,0.244,0.169,0.128
240471,2001,1108,680,428,265,86,179,26.32,0.263,0.239,0.201
240480,2001,1505,849,656,297,108,189,22.26,0.223,0.197,0.165
240727,2001,1411,724,687,369,135,234,32.32,0.323,0.262,0.197
243443,2001,478,333,145,52,7,45,13.51,0.135,0.109,0.048
243780,2001,6567,2601,3966,2218,1059,1159,44.56,0.446,0.338,0.267
100654,2002,1043,506,537,118,37,81,16.01,0.16,0.113,0.069
100663,2002,1398,820,578,228,86,142,17.32,0.173,0.163,0.149
100751,2002,2585,1441,1144,932,318,614,42.61,0.426,0.361,0.278
100858,2002,4148,2184,1964,1424,498,926,42.4,0.424,0.343,0.254
101435,2002,165,108,57,76,21,55,50.93,0.509,0.461,0.368
101480,2002,1059,567,492,146,41,105,18.52,0.185,0.138,0.083
101675,2002,391,195,196,24,7,17,8.72,0.087,0.061,0.036
101879,2002,786,457,329,104,27,77,16.85,0.168,0.132,0.082
102049,2002,652,428,224,5,0,5,1.17,0.012,0.008,0
102094,2002,1004,597,407,135,42,93,15.58,0.156,0.134,0.103
102234,2002,289,168,121,151,60,91,54.17,0.542,0.522,0.496
102368,2002,1353,730,623,288,101,187,25.62,0.256,0.213,0.162
102377,2002,738,426,312,168,36,132,30.99,0.31,0.228,0.115
104151,2002,6094,3323,2771,1813,661,1152,34.67,0.347,0.298,0.239
104179,2002,5613,3008,2605,1805,703,1102,36.64,0.366,0.322,0.27
105330,2002,2153,1327,826,681,173,508,38.28,0.383,0.316,0.209
106245,2002,739,456,283,72,19,53,11.62,0.116,0.097,0.067
106342,2002,113,47,66,62,33,29,61.7,0.617,0.549,0.5
106397,2002,2137,1106,1031,707,284,423,38.25,0.382,0.331,0.275
106412,2002,712,358,354,63,16,47,13.13,0.131,0.088,0.045
106458,2002,1539,813,726,291,109,182,22.39,0.224,0.189,0.15
106467,2002,1169,624,545,207,80,127,20.35,0.204,0.177,0.147
106485,2002,645,368,277,46,14,32,8.7,0.087,0.071,0.051
106704,2002,1766,1062,704,389,108,281,26.46,0.265,0.22,0.153
107044,2002,1011,580,431,383,138,245,42.24,0.422,0.379,0.32
107080,2002,317,184,133,199,73,126,68.48,0.685,0.628,0.549
107141,2002,303,186,117,176,64,112,60.22,0.602,0.581,0.547
107512,2002,396,229,167,166,64,102,44.54,0.445,0.419,0.383
107558,2002,200,97,103,60,28,32,32.99,0.33,0.3,0.272
110097,2002,656,414,242,345,108,237,57.25,0.573,0.526,0.446
110404,2002,252,73,179,203,138,65,89.04,0.89,0.806,0.771
110422,2002,2565,1158,1407,587,209,378,32.64,0.326,0.229,0.149
110486,2002,679,408,271,99,28,71,17.4,0.174,0.146,0.103
110495,2002,550,360,190,116,20,96,26.67,0.267,0.211,0.105
110510,2002,1161,751,410,142,32,110,14.65,0.147,0.122,0.078
110529,2002,2674,1080,1594,345,161,184,17.04,0.17,0.129,0.101
110538,2002,1995,1125,870,372,95,277,24.62,0.246,0.186,0.109
110547,2002,630,466,164,28,6,22,4.72,0.047,0.044,0.037
110556,2002,2189,1274,915,346,109,237,18.6,0.186,0.158,0.119
110565,2002,3291,2039,1252,481,111,370,18.15,0.182,0.146,0.089
110574,2002,746,473,273,119,43,76,16.07,0.161,0.16,0.158
110583,2002,2912,1871,1041,365,91,274,14.64,0.146,0.125,0.087
110592,2002,1404,906,498,116,34,82,9.05,0.091,0.083,0.068
110617,2002,2378,1395,983,221,56,165,11.83,0.118,0.093,0.057
113698,2002,202,145,57,75,19,56,38.62,0.386,0.371,0.333
115755,2002,836,505,331,97,28,69,13.66,0.137,0.116,0.085
119173,2002,127,123,4,64,1,63,51.22,0.512,0.504,0.25
120184,2002,97,57,40,42,12,30,52.63,0.526,0.433,0.3
121309,2002,535,324,211,321,111,210,64.81,0.648,0.6,0.526
121345,2002,374,191,183,338,158,180,94.24,0.942,0.904,0.863
122409,2002,3662,2217,1445,879,237,642,28.96,0.29,0.24,0.164
122436,2002,1049,681,368,672,219,453,66.52,0.665,0.641,0.595
122597,2002,2130,1378,752,211,52,159,11.54,0.115,0.099,0.069
122612,2002,839,582,257,431,132,299,51.37,0.514,0.514,0.514
122931,2002,1116,659,457,873,342,531,80.58,0.806,0.782,0.748
123554,2002,663,408,255,381,141,240,58.82,0.588,0.575,0.553
123572,2002,1210,816,394,289,53,236,28.92,0.289,0.239,0.135
126562,2002,580,326,254,86,26,60,18.4,0.184,0.148,0.102
126580,2002,834,501,333,211,66,145,28.94,0.289,0.253,0.198
126614,2002,5377,2607,2770,2218,1001,1217,46.68,0.467,0.412,0.361
126818,2002,3783,2121,1662,1340,442,898,42.34,0.423,0.354,0.266
127060,2002,988,527,461,571,235,336,63.76,0.638,0.578,0.51
127185,2002,1035,467,568,147,59,88,18.84,0.188,0.142,0.104
127565,2002,1655,852,803,73,25,48,5.63,0.056,0.044,0.031
127741,2002,1938,1253,685,548,116,432,34.48,0.345,0.283,0.169
128106,2002,642,329,313,105,39,66,20.06,0.201,0.164,0.125
128744,2002,234,144,90,66,23,43,29.86,0.299,0.282,0.256
128771,2002,1473,735,738,192,61,131,17.82,0.178,0.13,0.083
129020,2002,3157,1722,1435,1766,674,1092,63.41,0.634,0.559,0.47
129242,2002,813,461,352,609,240,369,80.04,0.8,0.749,0.682
129941,2002,529,240,289,166,67,99,41.25,0.413,0.314,0.232
130253,2002,797,457,340,445,171,274,59.96,0.6,0.558,0.503
130314,2002,201,201,0,69,0,69,34.33,0.343,0.343,NA
130493,2002,1276,719,557,144,46,98,13.63,0.136,0.113,0.083
130590,2002,548,286,262,445,207,238,83.22,0.832,0.812,0.79
130697,2002,716,377,339,634,288,346,91.78,0.918,0.885,0.85
130776,2002,794,434,360,113,32,81,18.66,0.187,0.142,0.089
130794,2002,1299,643,656,1164,576,588,91.45,0.915,0.896,0.878
130934,2002,761,439,322,1,0,1,0.23,0.002,0.001,0
130943,2002,3712,2222,1490,2282,777,1505,67.73,0.677,0.615,0.521
131159,2002,1303,811,492,917,329,588,72.5,0.725,0.704,0.669
131283,2002,700,406,294,438,170,268,66.01,0.66,0.626,0.578
131450,2002,235,122,113,12,6,6,4.92,0.049,0.051,0.053
131469,2002,2283,1359,924,1735,660,1075,79.1,0.791,0.76,0.714
131496,2002,1477,795,682,1324,608,716,90.06,0.901,0.896,0.891
131520,2002,1366,931,435,621,125,496,53.28,0.533,0.455,0.287
132471,2002,446,273,173,110,34,76,27.84,0.278,0.247,0.197
132602,2002,607,351,256,161,59,102,29.06,0.291,0.265,0.23
132903,2002,5330,2851,2479,1736,578,1158,40.62,0.406,0.326,0.233
133492,2002,442,239,203,261,117,144,60.25,0.603,0.59,0.576
133553,2002,872,148,724,315,244,71,47.97,0.48,0.361,0.337
133650,2002,2097,1249,848,280,77,203,16.25,0.162,0.134,0.091
133669,2002,1994,1102,892,323,115,208,18.87,0.189,0.162,0.129
133711,2002,481,308,173,231,70,161,52.27,0.523,0.48,0.405
133881,2002,518,139,379,218,142,76,54.68,0.547,0.421,0.375
133951,2002,2801,1617,1184,566,176,390,24.12,0.241,0.202,0.149
134079,2002,491,322,169,184,41,143,44.41,0.444,0.375,0.243
134097,2002,6258,3742,2516,2927,959,1968,52.59,0.526,0.468,0.381
134130,2002,6406,3674,2732,3586,1215,2371,64.53,0.645,0.56,0.445
134945,2002,389,165,224,105,52,53,32.12,0.321,0.27,0.232
135726,2002,2046,1197,849,1311,497,814,68,0.68,0.641,0.585
136172,2002,1865,1067,798,395,129,266,24.93,0.249,0.212,0.162
136950,2002,466,280,186,278,97,181,64.64,0.646,0.597,0.522
137546,2002,542,325,217,299,104,195,60,0.6,0.552,0.479
138354,2002,760,443,317,172,52,120,27.09,0.271,0.226,0.164
138716,2002,470,300,170,88,22,66,22,0.22,0.187,0.129
138789,2002,581,350,231,48,13,35,10,0.1,0.083,0.056
139144,2002,565,353,212,276,94,182,51.56,0.516,0.488,0.443
139366,2002,943,548,395,91,18,73,13.32,0.133,0.097,0.046
139393,2002,231,141,90,129,44,85,60.28,0.603,0.558,0.489
139658,2002,1558,903,655,1061,444,617,68.33,0.683,0.681,0.678
139719,2002,386,192,194,59,12,47,24.48,0.245,0.153,0.062
139755,2002,2275,636,1639,711,445,266,41.82,0.418,0.313,0.272
139764,2002,331,216,115,46,15,31,14.35,0.144,0.139,0.13
139861,2002,984,612,372,199,45,154,25.16,0.252,0.202,0.121
139931,2002,2597,1232,1365,434,138,296,24.03,0.24,0.167,0.101
139940,2002,2469,1419,1050,423,107,316,22.27,0.223,0.171,0.102
139959,2002,4282,2570,1712,2155,713,1442,56.11,0.561,0.503,0.416
140447,2002,687,387,300,275,93,182,47.03,0.47,0.4,0.31
140960,2002,496,269,227,52,7,45,16.73,0.167,0.105,0.031
140988,2002,218,144,74,80,23,57,39.58,0.396,0.367,0.311
141185,2002,175,106,69,88,37,51,48.11,0.481,0.503,0.536
141264,2002,1584,973,611,239,54,185,19.01,0.19,0.151,0.088
141334,2002,1617,921,696,181,41,140,15.2,0.152,0.112,0.059
141486,2002,212,154,58,23,8,15,9.74,0.097,0.108,0.138
141565,2002,404,238,166,57,17,40,16.81,0.168,0.141,0.102
141574,2002,1726,970,756,251,74,177,18.25,0.182,0.145,0.098
142276,2002,704,474,230,59,5,54,11.39,0.114,0.084,0.022
142285,2002,1619,784,835,371,153,218,27.81,0.278,0.229,0.183
142461,2002,276,169,107,87,38,49,28.99,0.29,0.315,0.355
143084,2002,601,349,252,417,158,259,74.21,0.742,0.694,0.627
143288,2002,147,75,72,44,16,28,37.33,0.373,0.299,0.222
144005,2002,438,302,136,11,2,9,2.98,0.03,0.025,0.015
144281,2002,1589,854,735,401,164,237,27.75,0.278,0.252,0.223
144740,2002,2231,1323,908,985,346,639,48.3,0.483,0.442,0.381
144892,2002,1984,1143,841,582,183,399,34.91,0.349,0.293,0.218
144962,2002,295,185,110,157,41,116,62.7,0.627,0.532,0.373
144971,2002,136,70,66,50,16,34,48.57,0.486,0.368,0.242
145600,2002,2952,1674,1278,607,248,359,21.45,0.214,0.206,0.194
145619,2002,303,165,138,150,56,94,56.97,0.57,0.495,0.406
145637,2002,6354,3120,3234,4027,1814,2213,70.93,0.709,0.634,0.561
145691,2002,306,170,136,156,60,96,56.47,0.565,0.51,0.441
145813,2002,3097,1933,1164,1279,366,913,47.23,0.472,0.413,0.314
146481,2002,358,219,139,213,71,142,64.84,0.648,0.595,0.511
146612,2002,366,161,205,132,66,66,40.99,0.41,0.361,0.322
146719,2002,1623,1069,554,821,261,560,52.39,0.524,0.506,0.471
146825,2002,127,72,55,46,14,32,44.44,0.444,0.362,0.255
147013,2002,258,135,123,127,48,79,58.52,0.585,0.492,0.39
147244,2002,634,351,283,335,117,218,62.11,0.621,0.528,0.413
147341,2002,282,147,135,150,61,89,60.54,0.605,0.532,0.452
147703,2002,3015,1585,1430,698,283,415,26.18,0.262,0.232,0.198
147767,2002,2000,1075,925,1725,759,966,89.86,0.899,0.863,0.821
147776,2002,977,589,388,27,9,18,3.06,0.031,0.028,0.023
147828,2002,553,328,225,274,95,179,54.57,0.546,0.495,0.422
148131,2002,229,112,117,88,33,55,49.11,0.491,0.384,0.282
148496,2002,192,123,69,111,29,82,66.67,0.667,0.578,0.42
148584,2002,149,86,63,49,17,32,37.21,0.372,0.329,0.27
148627,2002,375,262,113,89,24,65,24.81,0.248,0.237,0.212
149222,2002,2395,1037,1358,550,262,288,27.77,0.278,0.23,0.193
149231,2002,1629,866,763,356,126,230,26.56,0.266,0.219,0.165
149772,2002,1917,941,976,619,280,339,36.03,0.36,0.323,0.287
149781,2002,569,286,283,447,213,234,81.82,0.818,0.786,0.753
150066,2002,591,335,256,225,72,153,45.67,0.457,0.381,0.281
150136,2002,4010,2207,1803,1327,507,820,37.15,0.372,0.331,0.281
150145,2002,253,143,110,108,34,74,51.75,0.517,0.427,0.309
150163,2002,936,595,341,485,157,328,55.13,0.551,0.518,0.46
150400,2002,685,369,316,566,259,307,83.2,0.832,0.826,0.82
150534,2002,600,369,231,289,100,189,51.22,0.512,0.482,0.433
150668,2002,133,81,52,74,28,46,56.79,0.568,0.556,0.538
150941,2002,236,145,91,110,40,70,48.28,0.483,0.466,0.44
151102,2002,1409,782,627,61,24,37,4.73,0.047,0.043,0.038
151111,2002,2235,1286,949,195,63,132,10.26,0.103,0.087,0.066
151306,2002,1891,1152,739,217,50,167,14.5,0.145,0.115,0.068
151324,2002,2083,1065,1018,393,143,250,23.47,0.235,0.189,0.14
151333,2002,339,226,113,28,5,23,10.18,0.102,0.083,0.044
151342,2002,660,390,270,36,9,27,6.92,0.069,0.055,0.033
151351,2002,6987,3895,3092,3546,1471,2075,53.27,0.533,0.508,0.476
151360,2002,602,365,237,39,14,25,6.85,0.068,0.065,0.059
151379,2002,678,419,259,53,11,42,10.02,0.1,0.078,0.042
151388,2002,303,200,103,19,4,15,7.5,0.075,0.063,0.039
151777,2002,309,178,131,137,54,83,46.63,0.466,0.443,0.412
151786,2002,230,153,77,73,16,57,37.25,0.372,0.317,0.208
152080,2002,1945,935,1010,1765,909,856,91.55,0.915,0.907,0.9
152248,2002,927,474,453,36,16,20,4.22,0.042,0.039,0.035
152363,2002,276,155,121,108,34,74,47.74,0.477,0.391,0.281
152530,2002,452,244,208,322,142,180,73.77,0.738,0.712,0.683
152600,2002,715,365,350,454,197,257,70.41,0.704,0.635,0.563
153001,2002,356,192,164,184,79,105,54.69,0.547,0.517,0.482
153108,2002,425,234,191,263,103,160,68.38,0.684,0.619,0.539
153269,2002,775,459,316,360,148,212,46.19,0.462,0.465,0.468
153384,2002,368,202,166,297,132,165,81.68,0.817,0.807,0.795
153603,2002,4167,1915,2252,1399,566,833,43.5,0.435,0.336,0.251
153834,2002,608,365,243,371,135,236,64.66,0.647,0.61,0.556
154095,2002,1821,1139,682,610,194,416,36.52,0.365,0.335,0.284
155089,2002,203,121,82,35,15,20,16.53,0.165,0.172,0.183
155317,2002,4013,2181,1832,1227,477,750,34.39,0.344,0.306,0.26
155335,2002,143,79,64,37,17,20,25.32,0.253,0.259,0.266
155399,2002,3338,1652,1686,828,278,550,33.29,0.333,0.248,0.165
155520,2002,306,156,150,128,46,82,52.56,0.526,0.418,0.307
155627,2002,112,35,77,32,15,17,48.57,0.486,0.286,0.195
155937,2002,98,50,48,43,14,29,58,0.58,0.439,0.292
156213,2002,323,200,123,195,80,115,57.5,0.575,0.604,0.65
156286,2002,325,214,111,165,46,119,55.61,0.556,0.508,0.414
156295,2002,356,206,150,158,61,97,47.09,0.471,0.444,0.407
156365,2002,288,138,150,61,18,43,31.16,0.312,0.212,0.12
156541,2002,386,209,177,93,31,62,29.67,0.297,0.241,0.175
156745,2002,328,199,129,150,53,97,48.74,0.487,0.457,0.411
157058,2002,373,203,170,34,6,28,13.79,0.138,0.091,0.035
157076,2002,150,77,73,44,13,31,40.26,0.403,0.293,0.178
157085,2002,3701,1999,1702,1045,362,683,34.17,0.342,0.282,0.213
157289,2002,2209,1153,1056,428,157,271,23.5,0.235,0.194,0.149
157386,2002,1563,882,681,172,59,113,12.81,0.128,0.11,0.087
157401,2002,1467,879,588,439,130,309,35.15,0.352,0.299,0.221
157447,2002,1907,1084,823,185,66,119,10.98,0.11,0.097,0.08
157535,2002,226,129,97,40,9,31,24.03,0.24,0.177,0.093
157951,2002,2954,1714,1240,513,136,377,22,0.22,0.174,0.11
158477,2002,272,163,109,122,42,80,49.08,0.491,0.449,0.385
159009,2002,850,430,420,107,44,63,14.65,0.147,0.126,0.105
159391,2002,5170,2842,2328,1353,464,889,31.28,0.313,0.262,0.199
159647,2002,1936,947,989,500,202,298,31.47,0.315,0.258,0.204
159717,2002,1358,762,596,179,67,112,14.7,0.147,0.132,0.112
159966,2002,1404,821,583,120,27,93,11.33,0.113,0.085,0.046
160038,2002,1875,1093,782,216,80,136,12.44,0.124,0.115,0.102
160612,2002,2382,1370,1012,168,49,119,8.69,0.087,0.071,0.048
160621,2002,1176,673,503,77,14,63,9.36,0.094,0.065,0.028
160658,2002,2385,1326,1059,293,77,216,16.29,0.163,0.123,0.073
161004,2002,457,237,220,384,196,188,79.32,0.793,0.84,0.891
161226,2002,453,295,158,156,40,116,39.32,0.393,0.344,0.253
161235,2002,130,61,69,30,15,15,24.59,0.246,0.231,0.217
161244,2002,132,81,51,19,9,10,12.35,0.124,0.144,0.176
161253,2002,1651,808,843,554,246,308,38.12,0.381,0.336,0.292
161554,2002,895,519,376,118,39,79,15.22,0.152,0.132,0.104
162007,2002,566,352,214,102,24,78,22.16,0.222,0.18,0.112
162210,2002,176,104,72,17,2,15,14.42,0.144,0.097,0.028
162283,2002,578,430,148,30,3,27,6.28,0.063,0.052,0.02
162584,2002,999,492,507,220,67,153,31.1,0.311,0.22,0.132
162654,2002,365,265,100,208,48,160,60.38,0.604,0.57,0.48
162760,2002,179,172,7,108,3,105,61.05,0.61,0.603,0.429
162928,2002,1203,539,664,960,501,459,85.16,0.852,0.798,0.755
163046,2002,901,527,374,733,295,438,83.11,0.831,0.814,0.789
163268,2002,1356,572,784,437,210,227,39.69,0.397,0.322,0.268
163286,2002,3886,1961,1925,2452,1128,1324,67.52,0.675,0.631,0.586
163453,2002,1247,741,506,139,26,113,15.25,0.152,0.111,0.051
163462,2002,399,211,188,233,97,136,64.45,0.645,0.584,0.516
163851,2002,908,529,379,417,121,296,55.95,0.559,0.459,0.319
163912,2002,425,243,182,286,113,173,71.19,0.712,0.673,0.621
164076,2002,2198,1385,813,815,229,586,42.31,0.423,0.371,0.282
164173,2002,487,365,122,281,63,218,59.73,0.597,0.577,0.516
164216,2002,368,243,125,276,88,188,77.37,0.774,0.75,0.704
164270,2002,440,253,187,307,124,183,72.33,0.723,0.698,0.663
164447,2002,256,117,139,55,21,34,29.06,0.291,0.215,0.151
164492,2002,159,108,51,82,29,53,49.07,0.491,0.516,0.569
164562,2002,618,381,237,451,168,283,74.28,0.743,0.73,0.709
165015,2002,837,456,381,708,316,392,85.96,0.86,0.846,0.829
165024,2002,1272,769,503,277,72,205,26.66,0.267,0.218,0.143
165334,2002,576,357,219,387,148,239,66.95,0.67,0.672,0.676
165662,2002,656,419,237,473,179,294,70.17,0.702,0.721,0.755
165671,2002,322,258,64,179,31,148,57.36,0.574,0.556,0.484
165820,2002,496,292,204,119,41,78,26.71,0.267,0.24,0.201
165866,2002,716,500,216,193,38,155,31,0.31,0.27,0.176
165936,2002,400,266,134,248,77,171,64.29,0.643,0.62,0.575
166027,2002,1619,783,836,1422,710,712,90.93,0.909,0.878,0.849
166124,2002,669,348,321,644,300,344,98.85,0.988,0.963,0.935
166513,2002,1013,371,642,289,138,151,40.7,0.407,0.285,0.215
166629,2002,3411,1799,1612,1682,707,975,54.2,0.542,0.493,0.439
166638,2002,534,307,227,64,16,48,15.64,0.156,0.12,0.07
166683,2002,977,420,557,806,446,360,85.71,0.857,0.825,0.801
167288,2002,265,159,106,106,38,68,42.77,0.428,0.4,0.358
167987,2002,1699,825,874,452,191,261,31.64,0.316,0.266,0.219
167996,2002,566,342,224,448,160,288,84.21,0.842,0.792,0.714
168005,2002,787,481,306,307,88,219,45.53,0.455,0.39,0.288
168148,2002,1276,736,540,1094,455,639,86.82,0.868,0.857,0.843
168254,2002,682,301,381,298,151,147,48.84,0.488,0.437,0.396
168281,2002,411,255,156,316,106,210,82.35,0.824,0.769,0.679
168342,2002,539,291,248,492,226,266,91.41,0.914,0.913,0.911
168546,2002,525,293,232,330,129,201,68.6,0.686,0.629,0.556
168786,2002,346,216,130,85,25,60,27.78,0.278,0.246,0.192
169080,2002,1045,577,468,586,228,358,62.05,0.62,0.561,0.487
169798,2002,2601,1564,1037,272,91,181,11.57,0.116,0.105,0.088
169910,2002,2035,882,1153,138,67,71,8.05,0.08,0.068,0.058
170082,2002,2868,1801,1067,634,188,446,24.76,0.248,0.221,0.176
170301,2002,725,465,260,457,139,318,68.39,0.684,0.63,0.535
170532,2002,335,177,158,239,105,134,75.71,0.757,0.713,0.665
170639,2002,574,262,312,53,29,24,9.16,0.092,0.092,0.093
170976,2002,5180,2704,2476,3641,1634,2007,74.22,0.742,0.703,0.66
171100,2002,6829,3864,2965,3127,1133,1994,51.6,0.516,0.458,0.382
171128,2002,1186,267,919,306,210,96,35.96,0.36,0.258,0.229
171137,2002,735,342,393,105,48,57,16.67,0.167,0.143,0.122
171146,2002,467,269,198,52,16,36,13.38,0.134,0.111,0.081
171599,2002,238,85,153,82,42,40,47.06,0.471,0.345,0.275
172051,2002,1109,654,455,97,27,70,10.7,0.107,0.087,0.059
172699,2002,4442,2318,2124,941,381,560,24.16,0.242,0.212,0.179
173160,2002,567,348,219,370,125,245,70.4,0.704,0.653,0.571
173258,2002,499,264,235,447,203,244,92.42,0.924,0.896,0.864
173328,2002,175,89,86,57,19,38,42.7,0.427,0.326,0.221
173647,2002,645,383,262,521,216,305,79.63,0.796,0.808,0.824
173902,2002,440,241,199,370,169,201,83.4,0.834,0.841,0.849
174066,2002,5162,2762,2400,2118,869,1249,45.22,0.452,0.41,0.362
174233,2002,2025,1029,996,476,183,293,28.47,0.285,0.235,0.184
174251,2002,475,309,166,219,71,148,47.9,0.479,0.461,0.428
174491,2002,431,267,164,183,75,108,40.45,0.404,0.425,0.457
174792,2002,468,0,468,340,340,0,NA,NA,0.726,0.726
174844,2002,777,479,298,645,235,410,85.59,0.856,0.83,0.789
174899,2002,382,286,96,218,43,175,61.19,0.612,0.571,0.448
174914,2002,1095,577,518,629,280,349,60.49,0.605,0.574,0.541
175342,2002,423,249,174,86,23,63,25.3,0.253,0.203,0.132
175421,2002,266,150,116,68,19,49,32.67,0.327,0.256,0.164
175616,2002,336,200,136,58,13,45,22.5,0.225,0.173,0.096
175856,2002,1014,581,433,206,49,157,27.02,0.27,0.203,0.113
175980,2002,251,125,126,159,75,84,67.2,0.672,0.633,0.595
176017,2002,2230,1150,1080,724,271,453,39.39,0.394,0.325,0.251
176035,2002,250,223,27,61,2,59,26.46,0.265,0.244,0.074
176044,2002,269,129,140,37,14,23,17.83,0.178,0.138,0.1
176080,2002,1737,833,904,476,181,295,35.41,0.354,0.274,0.2
176406,2002,209,149,60,55,12,43,28.86,0.289,0.263,0.2
176628,2002,129,70,59,29,5,24,34.29,0.343,0.225,0.085
176947,2002,232,100,132,61,16,45,45,0.45,0.263,0.121
176965,2002,1248,668,580,306,106,200,29.94,0.299,0.245,0.183
177418,2002,183,134,49,76,16,60,44.78,0.448,0.415,0.327
178059,2002,279,194,85,132,46,86,44.33,0.443,0.473,0.541
178341,2002,614,334,280,78,27,51,15.27,0.153,0.127,0.096
178387,2002,1131,655,476,134,52,82,12.52,0.125,0.118,0.109
178396,2002,4379,2284,2095,1813,669,1144,50.09,0.501,0.414,0.319
178402,2002,747,454,293,128,41,87,19.16,0.192,0.171,0.14
178411,2002,785,150,635,175,128,47,31.33,0.313,0.223,0.202
178420,2002,426,234,192,96,29,67,28.63,0.286,0.225,0.151
178615,2002,1441,872,569,654,227,427,48.97,0.49,0.454,0.399
179043,2002,214,133,81,119,44,75,56.39,0.564,0.556,0.543
179159,2002,1409,762,647,867,366,501,65.75,0.657,0.615,0.566
179557,2002,1457,858,599,361,105,256,29.84,0.298,0.248,0.175
179566,2002,2702,1609,1093,720,205,515,32.01,0.32,0.266,0.188
179867,2002,1329,699,630,1127,513,614,87.84,0.878,0.848,0.814
179894,2002,385,226,159,178,67,111,49.12,0.491,0.462,0.421
179946,2002,207,93,114,100,48,52,55.91,0.559,0.483,0.421
180179,2002,542,357,185,48,9,39,10.92,0.109,0.089,0.049
180461,2002,1924,833,1091,307,130,177,21.25,0.212,0.16,0.119
180522,2002,185,87,98,23,13,10,11.49,0.115,0.124,0.133
180984,2002,319,175,144,130,41,89,50.86,0.509,0.408,0.285
181002,2002,802,488,314,534,191,343,70.29,0.703,0.666,0.608
181020,2002,273,142,131,178,84,94,66.2,0.662,0.652,0.641
181127,2002,276,132,144,148,57,91,68.94,0.689,0.536,0.396
181215,2002,1022,574,448,216,69,147,25.61,0.256,0.211,0.154
181394,2002,1601,851,750,199,77,122,14.34,0.143,0.124,0.103
181446,2002,336,187,149,157,70,87,46.52,0.465,0.467,0.47
181464,2002,3615,1878,1737,919,358,561,29.87,0.299,0.254,0.206
181534,2002,171,85,86,29,10,19,22.35,0.224,0.17,0.116
181783,2002,602,325,277,155,66,89,27.38,0.274,0.257,0.238
182281,2002,2383,1373,1010,293,80,213,15.51,0.155,0.123,0.079
182290,2002,2066,1137,929,308,102,206,18.12,0.181,0.149,0.11
182634,2002,270,172,98,133,54,79,45.93,0.459,0.493,0.551
182795,2002,505,252,253,197,88,109,43.25,0.432,0.39,0.348
183062,2002,1170,668,502,333,119,214,32.04,0.32,0.285,0.237
183080,2002,940,447,493,279,120,159,35.57,0.356,0.297,0.243
183239,2002,570,330,240,406,148,258,78.18,0.782,0.712,0.617
183822,2002,339,216,123,57,15,42,19.44,0.194,0.168,0.122
183974,2002,236,147,89,97,27,70,47.62,0.476,0.411,0.303
184348,2002,396,231,165,281,110,171,74.03,0.74,0.71,0.667
184603,2002,474,281,193,87,34,53,18.86,0.189,0.184,0.176
184612,2002,208,151,57,45,8,37,24.5,0.245,0.216,0.14
184782,2002,1257,637,620,542,224,318,49.92,0.499,0.431,0.361
185129,2002,566,293,273,34,9,25,8.53,0.085,0.06,0.033
185572,2002,948,521,427,351,116,235,45.11,0.451,0.37,0.272
185590,2002,1470,881,589,410,117,293,33.26,0.333,0.279,0.199
185828,2002,658,113,545,106,81,25,22.12,0.221,0.161,0.149
186131,2002,1164,557,607,1049,542,507,91.02,0.91,0.901,0.893
186201,2002,684,420,264,363,109,254,60.48,0.605,0.531,0.413
186283,2002,958,542,416,439,173,266,49.08,0.491,0.458,0.416
186584,2002,1157,607,550,523,232,291,47.94,0.479,0.452,0.422
186876,2002,794,436,358,338,131,207,47.48,0.475,0.426,0.366
187134,2002,1231,738,493,834,288,546,73.98,0.74,0.677,0.584
187444,2002,1286,715,571,208,59,149,20.84,0.208,0.162,0.103
187985,2002,2758,1565,1193,314,100,214,13.67,0.137,0.114,0.084
188030,2002,1977,1111,866,257,78,179,16.11,0.161,0.13,0.09
188429,2002,666,463,203,373,97,276,59.61,0.596,0.56,0.478
188641,2002,474,223,251,247,111,136,60.99,0.61,0.521,0.442
190044,2002,723,164,559,391,296,95,57.93,0.579,0.541,0.53
190099,2002,728,386,342,629,292,337,87.31,0.873,0.864,0.854
190150,2002,1386,636,750,1168,630,538,84.59,0.846,0.843,0.84
190248,2002,135,75,60,43,16,27,36,0.36,0.319,0.267
190415,2002,2999,1530,1469,2605,1253,1352,88.37,0.884,0.869,0.853
190512,2002,1654,830,824,554,217,337,40.6,0.406,0.335,0.263
190549,2002,1194,679,515,235,78,157,23.12,0.231,0.197,0.151
190558,2002,1743,905,838,66,25,41,4.53,0.045,0.038,0.03
190567,2002,961,435,526,65,28,37,8.51,0.085,0.068,0.053
190594,2002,1445,1010,435,256,50,206,20.4,0.204,0.177,0.115
190637,2002,729,485,244,73,21,52,10.72,0.107,0.1,0.086
190664,2002,1178,693,485,325,90,235,33.91,0.339,0.276,0.186
190691,2002,563,385,178,34,8,26,6.75,0.068,0.06,0.045
190725,2002,316,246,70,84,16,68,27.64,0.276,0.266,0.229
191241,2002,1694,1020,674,1263,478,785,76.96,0.77,0.746,0.709
191515,2002,492,252,240,418,195,223,88.49,0.885,0.85,0.812
191533,2002,375,224,151,165,56,109,48.66,0.487,0.44,0.371
191630,2002,532,283,249,367,151,216,76.33,0.763,0.69,0.606
191649,2002,1764,912,852,693,254,439,48.14,0.481,0.393,0.298
191676,2002,289,201,88,187,54,133,66.17,0.662,0.647,0.614
191931,2002,731,379,352,337,123,214,56.46,0.565,0.461,0.349
191968,2002,1515,896,619,1083,441,642,71.65,0.717,0.715,0.712
192192,2002,195,138,57,81,21,60,43.48,0.435,0.415,0.368
192323,2002,561,333,228,388,144,244,73.27,0.733,0.692,0.632
192439,2002,776,561,215,48,9,39,6.95,0.07,0.062,0.042
192703,2002,769,401,368,501,228,273,68.08,0.681,0.651,0.62
192749,2002,420,287,133,212,50,162,56.45,0.565,0.505,0.376
192819,2002,956,576,380,693,252,441,76.56,0.766,0.725,0.663
192925,2002,308,204,104,69,25,44,21.57,0.216,0.224,0.24
193016,2002,680,425,255,69,14,55,12.94,0.129,0.101,0.055
193292,2002,229,168,61,77,19,58,34.52,0.345,0.336,0.311
193353,2002,361,261,100,151,33,118,45.21,0.452,0.418,0.33
193399,2002,326,239,87,128,21,107,44.77,0.448,0.393,0.241
193584,2002,385,292,93,230,49,181,61.99,0.62,0.597,0.527
193645,2002,850,733,117,151,12,139,18.96,0.19,0.178,0.103
193654,2002,605,415,190,328,89,239,57.59,0.576,0.542,0.468
193900,2002,4126,2577,1549,2564,963,1601,62.13,0.621,0.621,0.622
193973,2002,735,440,295,409,148,261,59.32,0.593,0.556,0.502
194161,2002,295,183,112,109,40,69,37.7,0.377,0.369,0.357
194310,2002,1508,916,592,592,190,402,43.89,0.439,0.393,0.321
194824,2002,1047,263,784,672,490,182,69.2,0.692,0.642,0.625
195003,2002,2327,614,1713,563,299,264,43,0.43,0.242,0.175
195030,2002,1055,492,563,776,392,384,78.05,0.78,0.736,0.696
195164,2002,584,295,289,300,136,164,55.59,0.556,0.514,0.471
195173,2002,454,238,216,153,61,92,38.66,0.387,0.337,0.282
195216,2002,615,316,299,443,197,246,77.85,0.778,0.72,0.659
195234,2002,526,391,135,303,65,238,60.87,0.609,0.576,0.481
195243,2002,329,191,138,130,38,92,48.17,0.482,0.395,0.275
195304,2002,323,249,74,205,56,149,59.84,0.598,0.635,0.757
195474,2002,677,405,272,497,185,312,77.04,0.77,0.734,0.68
195526,2002,634,383,251,494,191,303,79.11,0.791,0.779,0.761
195544,2002,109,92,17,78,11,67,72.83,0.728,0.716,0.647
195809,2002,2954,1736,1218,1001,347,654,37.67,0.377,0.339,0.285
196413,2002,2894,1676,1218,2021,793,1228,73.27,0.733,0.698,0.651
196592,2002,1877,1306,571,159,40,119,9.11,0.091,0.085,0.07
197045,2002,451,226,225,180,73,107,47.35,0.474,0.399,0.324
197133,2002,632,377,255,552,217,335,88.86,0.889,0.873,0.851
197869,2002,2412,1261,1151,964,385,579,45.92,0.459,0.4,0.334
197984,2002,223,136,87,64,20,44,32.35,0.324,0.287,0.23
198385,2002,468,243,225,430,201,229,94.24,0.942,0.919,0.893
198464,2002,3561,2117,1444,968,294,674,31.84,0.318,0.272,0.204
198507,2002,458,270,188,108,16,92,34.07,0.341,0.236,0.085
198516,2002,1192,736,456,856,308,548,74.46,0.745,0.718,0.675
198835,2002,319,161,158,145,69,76,47.2,0.472,0.455,0.437
198969,2002,395,118,277,58,20,38,32.2,0.322,0.147,0.072
199102,2002,2025,1043,982,299,90,209,20.04,0.2,0.148,0.092
199111,2002,421,250,171,140,41,99,39.6,0.396,0.333,0.24
199120,2002,3455,2053,1402,2513,935,1578,76.86,0.769,0.727,0.667
199139,2002,2383,1234,1149,577,204,373,30.23,0.302,0.242,0.178
199148,2002,2071,1420,651,570,118,452,31.83,0.318,0.275,0.181
199157,2002,821,542,279,191,42,149,27.49,0.275,0.233,0.151
199193,2002,3713,1561,2152,1391,580,811,51.95,0.52,0.375,0.27
199218,2002,1629,1014,615,733,209,524,51.68,0.517,0.45,0.34
199281,2002,709,376,333,101,38,63,16.76,0.168,0.142,0.114
199306,2002,166,97,69,71,29,42,43.3,0.433,0.428,0.42
199412,2002,193,150,43,111,24,87,58,0.58,0.575,0.558
199582,2002,449,183,266,25,13,12,6.56,0.066,0.056,0.049
199643,2002,526,240,286,67,26,41,17.08,0.171,0.127,0.091
199847,2002,999,509,490,832,393,439,86.25,0.863,0.833,0.802
199962,2002,374,197,177,167,62,105,53.3,0.533,0.447,0.35
199999,2002,670,471,199,121,28,93,19.75,0.198,0.181,0.141
200004,2002,1216,627,589,344,127,217,34.61,0.346,0.283,0.216
200059,2002,368,193,175,32,8,24,12.44,0.124,0.087,0.046
200156,2002,332,176,156,98,29,69,39.2,0.392,0.295,0.186
200217,2002,402,240,162,168,44,124,51.67,0.517,0.418,0.272
200226,2002,135,79,56,32,4,28,35.44,0.354,0.237,0.071
200253,2002,476,268,208,62,11,51,19.03,0.19,0.13,0.053
200280,2002,1987,935,1052,438,205,233,24.92,0.249,0.22,0.195
200332,2002,1803,785,1018,387,186,201,25.61,0.256,0.215,0.183
200572,2002,153,72,81,41,21,20,27.78,0.278,0.268,0.259
201104,2002,559,373,186,258,60,198,53.08,0.531,0.462,0.323
201371,2002,262,141,121,135,55,80,56.74,0.567,0.515,0.455
201548,2002,563,330,233,296,104,192,58.18,0.582,0.526,0.446
201645,2002,835,322,513,482,264,218,67.7,0.677,0.577,0.515
201690,2002,378,207,171,51,14,37,17.87,0.179,0.135,0.082
202134,2002,946,463,483,80,39,41,8.86,0.089,0.085,0.081
202480,2002,1644,797,847,944,390,554,69.51,0.695,0.574,0.46
202523,2002,633,338,295,469,192,277,81.95,0.82,0.741,0.651
202763,2002,651,386,265,276,98,178,46.11,0.461,0.424,0.37
203085,2002,278,160,118,103,34,69,43.12,0.431,0.371,0.288
203128,2002,233,126,107,132,52,80,63.49,0.635,0.567,0.486
203368,2002,843,456,387,599,256,343,75.22,0.752,0.711,0.661
203517,2002,3640,2232,1408,892,283,609,27.28,0.273,0.245,0.201
203535,2002,440,246,194,376,158,218,88.62,0.886,0.855,0.814
203580,2002,133,102,31,38,4,34,33.33,0.333,0.286,0.129
203775,2002,348,219,129,148,54,94,42.92,0.429,0.425,0.419
203845,2002,263,129,134,120,49,71,55.04,0.55,0.456,0.366
204024,2002,3614,1998,1616,2461,1008,1453,72.72,0.727,0.681,0.624
204185,2002,579,299,280,299,115,184,61.54,0.615,0.516,0.411
204194,2002,332,203,129,129,48,81,39.9,0.399,0.389,0.372
204617,2002,251,163,88,94,34,60,36.81,0.368,0.375,0.386
204796,2002,5936,2945,2991,2511,989,1522,51.68,0.517,0.423,0.331
204857,2002,3628,2068,1560,1832,670,1162,56.19,0.562,0.505,0.429
206330,2002,150,51,99,22,11,11,21.57,0.216,0.147,0.111
206589,2002,514,281,233,354,140,214,76.16,0.762,0.689,0.601
206604,2002,2169,1225,944,407,128,279,22.78,0.228,0.188,0.136
206622,2002,757,424,333,518,224,294,69.34,0.693,0.684,0.673
206695,2002,1944,1058,886,234,76,158,14.93,0.149,0.12,0.086
206914,2002,583,330,253,39,17,22,6.67,0.067,0.067,0.067
207209,2002,492,248,244,31,8,23,9.27,0.093,0.063,0.033
207306,2002,298,164,134,56,19,37,22.56,0.226,0.188,0.142
207324,2002,405,215,190,93,43,50,23.26,0.233,0.23,0.226
207388,2002,3206,1698,1508,939,327,612,36.04,0.36,0.293,0.217
207500,2002,3749,1940,1809,973,350,623,32.11,0.321,0.26,0.193
207722,2002,280,186,94,44,11,33,17.74,0.177,0.157,0.117
207847,2002,577,287,290,64,29,35,12.2,0.122,0.111,0.1
207865,2002,926,486,440,121,46,75,15.43,0.154,0.131,0.105
208822,2002,319,204,115,171,60,111,54.41,0.544,0.536,0.522
209056,2002,503,309,194,339,123,216,69.9,0.699,0.674,0.634
209065,2002,425,245,180,258,92,166,67.76,0.678,0.607,0.511
209542,2002,2864,1437,1427,906,319,587,40.85,0.409,0.316,0.224
209551,2002,3272,1834,1438,1353,500,853,46.51,0.465,0.414,0.348
209612,2002,275,166,109,171,64,107,64.46,0.645,0.622,0.587
209807,2002,1177,632,545,153,43,110,17.41,0.174,0.13,0.079
209922,2002,307,160,147,182,79,103,64.38,0.644,0.593,0.537
210146,2002,787,412,375,166,56,110,26.7,0.267,0.211,0.149
210401,2002,353,181,172,210,92,118,65.19,0.652,0.595,0.535
210429,2002,769,466,303,142,36,106,22.75,0.228,0.185,0.119
210571,2002,453,250,203,254,104,150,60,0.6,0.561,0.512
210669,2002,536,271,265,374,165,209,77.12,0.771,0.698,0.623
210775,2002,242,153,89,89,29,60,39.22,0.392,0.368,0.326
211088,2002,399,308,91,237,55,182,59.09,0.591,0.594,0.604
211158,2002,1478,938,540,650,169,481,51.28,0.513,0.44,0.313
211291,2002,914,455,459,764,371,393,86.37,0.864,0.836,0.808
211352,2002,408,277,131,191,53,138,49.82,0.498,0.468,0.405
211361,2002,893,464,429,224,95,129,27.8,0.278,0.251,0.221
211431,2002,238,231,7,79,0,79,34.2,0.342,0.332,0
211440,2002,1364,542,822,957,557,400,73.8,0.738,0.702,0.678
211468,2002,185,185,0,89,0,89,48.11,0.481,0.481,NA
211556,2002,108,108,0,49,0,49,45.37,0.454,0.454,NA
211583,2002,105,104,1,27,0,27,25.96,0.26,0.257,0
211608,2002,247,132,115,25,5,20,15.15,0.152,0.101,0.043
211644,2002,1249,745,504,367,117,250,33.56,0.336,0.294,0.232
211981,2002,406,204,202,159,59,100,49.02,0.49,0.392,0.292
212009,2002,572,328,244,459,185,274,83.54,0.835,0.802,0.758
212054,2002,1937,709,1228,374,150,224,31.59,0.316,0.193,0.122
212106,2002,1429,875,554,748,253,495,56.57,0.566,0.523,0.457
212115,2002,1123,587,536,314,100,214,36.46,0.365,0.28,0.187
212133,2002,405,288,117,211,49,162,56.25,0.562,0.521,0.419
212160,2002,1372,788,584,297,86,211,26.78,0.268,0.216,0.147
212197,2002,456,304,152,293,85,208,68.42,0.684,0.643,0.559
212577,2002,534,248,286,388,189,199,80.24,0.802,0.727,0.661
212601,2002,536,311,225,255,80,175,56.27,0.563,0.476,0.356
212832,2002,261,211,50,62,18,44,20.85,0.209,0.238,0.36
212911,2002,312,168,144,283,128,155,92.26,0.923,0.907,0.889
213020,2002,2666,1536,1130,697,207,490,31.9,0.319,0.261,0.183
213251,2002,375,215,160,285,119,166,77.21,0.772,0.76,0.744
213321,2002,409,195,214,263,125,138,70.77,0.708,0.643,0.584
213349,2002,1726,1027,699,498,141,357,34.76,0.348,0.289,0.202
213358,2002,295,175,120,117,43,74,42.29,0.423,0.397,0.358
213367,2002,837,456,381,445,173,272,59.65,0.597,0.532,0.454
213385,2002,580,267,313,498,263,235,88.01,0.88,0.859,0.84
213507,2002,422,234,188,266,99,167,71.37,0.714,0.63,0.527
213543,2002,1143,442,701,822,461,361,81.67,0.817,0.719,0.658
213613,2002,1038,646,392,305,89,216,33.44,0.334,0.294,0.227
213668,2002,373,195,178,234,100,134,68.72,0.687,0.627,0.562
213783,2002,654,381,273,171,48,123,32.28,0.323,0.261,0.176
213826,2002,310,238,72,164,29,135,56.72,0.567,0.529,0.403
213996,2002,763,475,288,526,168,358,75.37,0.754,0.689,0.583
214041,2002,1270,748,522,463,158,305,40.78,0.408,0.365,0.303
214069,2002,347,239,108,201,59,142,59.41,0.594,0.579,0.546
214157,2002,372,214,158,264,102,162,75.7,0.757,0.71,0.646
214175,2002,547,300,247,445,191,254,84.67,0.847,0.814,0.773
214272,2002,363,228,135,114,25,89,39.04,0.39,0.314,0.185
214777,2002,5935,2911,3024,3558,1554,2004,68.84,0.688,0.599,0.514
215062,2002,2373,1183,1190,2096,1030,1066,90.11,0.901,0.883,0.866
215743,2002,281,154,127,122,47,75,48.7,0.487,0.434,0.37
215798,2002,322,159,163,209,102,107,67.3,0.673,0.649,0.626
215929,2002,958,569,389,702,258,444,78.03,0.78,0.733,0.663
216010,2002,1507,831,676,721,270,451,54.27,0.543,0.478,0.399
216038,2002,1421,796,625,416,139,277,34.8,0.348,0.293,0.222
216287,2002,371,189,182,326,155,171,90.48,0.905,0.879,0.852
216339,2002,3467,2034,1433,1170,394,776,38.15,0.382,0.337,0.275
216524,2002,427,212,215,301,134,167,78.77,0.788,0.705,0.623
216694,2002,297,141,156,142,50,92,65.25,0.652,0.478,0.321
216764,2002,1766,1104,662,642,168,474,42.93,0.429,0.364,0.254
216807,2002,350,235,115,208,56,152,64.68,0.647,0.594,0.487
216852,2002,716,327,389,284,119,165,50.46,0.505,0.397,0.306
216931,2002,471,239,232,224,101,123,51.46,0.515,0.476,0.435
217059,2002,921,521,400,373,138,235,45.11,0.451,0.405,0.345
217156,2002,1451,817,634,1213,505,708,86.66,0.867,0.836,0.797
217402,2002,877,540,337,734,274,460,85.19,0.852,0.837,0.813
217536,2002,523,378,145,334,93,241,63.76,0.638,0.639,0.641
217776,2002,141,76,65,36,11,25,32.89,0.329,0.255,0.169
217819,2002,1991,1333,658,941,253,688,51.61,0.516,0.473,0.384
217882,2002,2463,1214,1249,1231,462,769,63.34,0.633,0.5,0.37
217998,2002,165,100,65,87,25,62,62,0.62,0.527,0.385
218061,2002,734,431,303,142,48,94,21.81,0.218,0.193,0.158
218229,2002,526,335,191,117,25,92,27.46,0.275,0.222,0.131
218238,2002,180,83,97,26,12,14,16.87,0.169,0.144,0.124
218399,2002,289,175,114,51,11,40,22.86,0.229,0.176,0.096
218414,2002,250,94,156,70,33,37,39.36,0.394,0.28,0.212
218663,2002,3500,1909,1591,1557,594,963,50.45,0.505,0.445,0.373
218724,2002,1072,523,549,236,104,132,25.24,0.252,0.22,0.189
218733,2002,717,401,316,174,45,129,32.17,0.322,0.243,0.142
218742,2002,647,414,233,119,19,100,24.15,0.242,0.184,0.082
218973,2002,297,170,127,234,95,139,81.76,0.818,0.788,0.748
219000,2002,416,259,157,208,74,134,51.74,0.517,0.5,0.471
219046,2002,537,334,203,43,11,32,9.58,0.096,0.08,0.054
219082,2002,273,111,162,45,22,23,20.72,0.207,0.165,0.136
219198,2002,137,104,33,44,7,37,35.58,0.356,0.321,0.212
219259,2002,376,214,162,51,12,39,18.22,0.182,0.136,0.074
219356,2002,1767,864,903,348,140,208,24.07,0.241,0.197,0.155
219471,2002,976,544,432,186,74,112,20.59,0.206,0.191,0.171
219602,2002,986,636,350,126,37,89,13.99,0.14,0.128,0.106
219709,2002,524,320,204,264,91,173,54.06,0.541,0.504,0.446
219718,2002,139,53,86,16,5,11,20.75,0.208,0.115,0.058
219949,2002,164,74,90,35,6,29,39.19,0.392,0.213,0.067
220075,2002,1473,831,642,262,76,186,22.38,0.224,0.178,0.118
220215,2002,414,231,183,181,73,108,46.75,0.468,0.437,0.399
220613,2002,705,423,282,195,60,135,31.91,0.319,0.277,0.213
220631,2002,151,109,42,33,8,25,22.94,0.229,0.219,0.19
220710,2002,246,127,119,103,44,59,46.46,0.465,0.419,0.37
221351,2002,439,238,201,306,136,170,71.43,0.714,0.697,0.677
221519,2002,368,198,170,270,116,154,77.78,0.778,0.734,0.682
221731,2002,128,79,49,34,5,29,36.71,0.367,0.266,0.102
221847,2002,1376,585,791,251,99,152,25.98,0.26,0.182,0.125
221892,2002,198,134,64,75,24,51,38.06,0.381,0.379,0.375
222178,2002,942,536,406,360,112,248,46.27,0.463,0.382,0.276
222983,2002,347,191,156,245,104,141,73.82,0.738,0.706,0.667
223232,2002,2601,1558,1043,1323,439,884,56.74,0.567,0.509,0.421
224004,2002,166,85,81,12,9,3,3.53,0.035,0.072,0.111
224323,2002,307,185,122,142,52,90,48.65,0.486,0.463,0.426
225432,2002,905,498,407,14,4,10,2.01,0.02,0.015,0.01
225548,2002,325,157,168,78,24,54,34.39,0.344,0.24,0.143
225627,2002,395,244,151,58,18,40,16.39,0.164,0.147,0.119
226231,2002,243,55,188,68,46,22,40,0.4,0.28,0.245
226833,2002,624,327,297,66,23,43,13.15,0.132,0.106,0.077
227216,2002,2912,1683,1229,523,147,376,22.34,0.223,0.18,0.12
227331,2002,331,241,90,55,11,44,18.26,0.183,0.166,0.122
227526,2002,1431,769,662,222,74,148,19.25,0.192,0.155,0.112
227757,2002,700,318,382,570,301,269,84.59,0.846,0.814,0.788
227845,2002,445,255,190,164,60,104,40.78,0.408,0.369,0.316
227863,2002,276,174,102,65,15,50,28.74,0.287,0.236,0.147
228042,2002,165,80,85,45,18,27,33.75,0.338,0.273,0.212
228149,2002,667,397,270,214,63,151,38.04,0.38,0.321,0.233
228246,2002,1380,764,616,811,315,496,64.92,0.649,0.588,0.511
228343,2002,342,217,125,227,76,151,69.59,0.696,0.664,0.608
228431,2002,2006,1229,777,314,83,231,18.8,0.188,0.157,0.107
228459,2002,2674,1665,1009,587,140,447,26.85,0.268,0.22,0.139
228501,2002,315,130,185,14,3,11,8.46,0.085,0.044,0.016
228529,2002,974,507,467,148,46,102,20.12,0.201,0.152,0.099
228705,2002,962,401,561,135,75,60,14.96,0.15,0.14,0.134
228723,2002,6589,3528,3061,2734,863,1871,53.03,0.53,0.415,0.282
228769,2002,2126,1070,1056,269,112,157,14.67,0.147,0.127,0.106
228778,2002,7842,4111,3731,3769,1531,2238,54.44,0.544,0.481,0.41
228787,2002,903,405,498,325,141,184,45.43,0.454,0.36,0.283
228796,2002,2279,1202,1077,101,41,60,4.99,0.05,0.044,0.038
228875,2002,1450,904,546,719,207,512,56.64,0.566,0.496,0.379
228981,2002,371,181,190,111,34,77,42.54,0.425,0.299,0.179
229018,2002,216,126,90,31,9,22,17.46,0.175,0.144,0.1
229027,2002,3001,1619,1382,234,76,158,9.76,0.098,0.078,0.055
229115,2002,4283,2066,2217,1302,551,751,36.35,0.364,0.304,0.249
229780,2002,182,104,78,41,13,28,26.92,0.269,0.225,0.167
229814,2002,798,425,373,138,38,100,23.53,0.235,0.173,0.102
230603,2002,528,383,145,106,12,94,24.54,0.245,0.201,0.083
230728,2002,1497,1010,487,423,81,342,33.86,0.339,0.283,0.166
230764,2002,1962,1109,853,391,127,264,23.81,0.238,0.199,0.149
230782,2002,1675,1019,656,79,16,63,6.18,0.062,0.047,0.024
231059,2002,527,301,226,406,172,234,77.74,0.777,0.77,0.761
231174,2002,1828,1005,823,1000,415,585,58.21,0.582,0.547,0.504
231420,2002,187,90,97,59,20,39,43.33,0.433,0.316,0.206
231554,2002,131,62,69,36,17,19,30.65,0.306,0.275,0.246
231624,2002,1314,721,593,1082,456,626,86.82,0.868,0.823,0.769
231712,2002,1176,660,516,363,128,235,35.61,0.356,0.309,0.248
232025,2002,235,130,105,118,48,70,53.85,0.538,0.502,0.457
232043,2002,208,120,88,113,46,67,55.83,0.558,0.543,0.523
232089,2002,288,97,191,69,32,37,38.14,0.381,0.24,0.168
232186,2002,2161,1180,981,770,254,516,43.73,0.437,0.356,0.259
232265,2002,1017,644,373,384,90,294,45.65,0.456,0.378,0.241
232423,2002,3283,2116,1167,2220,690,1530,72.31,0.723,0.676,0.591
232557,2002,1530,812,718,393,154,239,29.43,0.294,0.257,0.214
232566,2002,860,593,267,410,101,309,52.11,0.521,0.477,0.378
232609,2002,438,246,192,220,72,148,60.16,0.602,0.502,0.375
232681,2002,862,618,244,607,164,443,71.68,0.717,0.704,0.672
232706,2002,361,261,100,128,25,103,39.46,0.395,0.355,0.25
232937,2002,1091,634,457,133,35,98,15.46,0.155,0.122,0.077
232982,2002,1701,902,799,373,139,234,25.94,0.259,0.219,0.174
233277,2002,1813,1109,704,754,244,510,45.99,0.46,0.416,0.347
233374,2002,775,422,353,634,279,355,84.12,0.841,0.818,0.79
233426,2002,460,274,186,256,95,161,58.76,0.588,0.557,0.511
233541,2002,323,163,160,115,42,73,44.79,0.448,0.356,0.262
233897,2002,345,181,164,100,34,66,36.46,0.365,0.29,0.207
233921,2002,4714,2002,2712,2437,1151,1286,64.24,0.642,0.517,0.424
234030,2002,3014,1810,1204,711,237,474,26.19,0.262,0.236,0.197
234085,2002,356,24,332,209,197,12,50,0.5,0.587,0.593
234155,2002,1129,650,479,237,60,177,27.23,0.272,0.21,0.125
234164,2002,437,259,178,74,14,60,23.17,0.232,0.169,0.079
235097,2002,1265,768,497,274,84,190,24.74,0.247,0.217,0.169
235167,2002,486,236,250,250,133,117,49.58,0.496,0.514,0.532
236230,2002,625,400,225,325,98,227,56.75,0.568,0.52,0.436
236328,2002,666,399,267,459,173,286,71.68,0.717,0.689,0.648
236577,2002,601,412,189,302,94,208,50.49,0.505,0.502,0.497
236595,2002,633,387,246,324,110,214,55.3,0.553,0.512,0.447
236896,2002,336,172,164,61,29,32,18.6,0.186,0.182,0.177
236939,2002,2771,1469,1302,1018,372,646,43.98,0.44,0.367,0.286
236948,2002,4776,2561,2215,2450,1039,1411,55.1,0.551,0.513,0.469
237011,2002,2213,1290,923,761,225,536,41.55,0.416,0.344,0.244
237057,2002,379,230,149,322,126,196,85.22,0.852,0.85,0.846
237066,2002,433,232,201,261,107,154,66.38,0.664,0.603,0.532
237215,2002,499,265,234,2,2,0,0,0,0.004,0.009
237330,2002,587,273,314,74,34,40,14.65,0.147,0.126,0.108
237358,2002,122,68,54,29,18,11,16.18,0.162,0.238,0.333
237367,2002,682,377,305,80,30,50,13.26,0.133,0.117,0.098
237792,2002,705,378,327,92,24,68,17.99,0.18,0.13,0.073
237899,2002,351,178,173,28,8,20,11.24,0.112,0.08,0.046
237932,2002,445,253,192,107,23,84,33.2,0.332,0.24,0.12
237969,2002,500,283,217,224,83,141,49.82,0.498,0.448,0.382
238032,2002,3917,1841,2076,1161,473,688,37.37,0.374,0.296,0.228
238333,2002,303,191,112,210,75,135,70.68,0.707,0.693,0.67
238430,2002,197,155,42,55,12,43,27.74,0.277,0.279,0.286
238458,2002,529,324,205,240,70,170,52.47,0.525,0.454,0.341
238476,2002,618,351,267,236,84,152,43.3,0.433,0.382,0.315
238616,2002,287,139,148,96,42,54,38.85,0.388,0.334,0.284
238661,2002,271,205,66,70,10,60,29.27,0.293,0.258,0.152
239080,2002,247,176,71,52,13,39,22.16,0.222,0.211,0.183
239105,2002,1856,1034,822,1052,433,619,59.86,0.599,0.567,0.527
239628,2002,250,116,134,139,75,64,55.17,0.552,0.556,0.56
239716,2002,495,273,222,345,134,211,77.29,0.773,0.697,0.604
240107,2002,321,236,85,91,19,72,30.51,0.305,0.283,0.224
240189,2002,2004,1095,909,463,176,287,26.21,0.262,0.231,0.194
240277,2002,896,595,301,204,55,149,25.04,0.25,0.228,0.183
240329,2002,1555,1006,549,463,128,335,33.3,0.333,0.298,0.233
240338,2002,158,88,70,79,31,48,54.55,0.545,0.5,0.443
240365,2002,1775,1045,730,259,71,188,17.99,0.18,0.146,0.097
240374,2002,760,418,342,70,24,46,11,0.11,0.092,0.07
240417,2002,1303,658,645,219,51,168,25.53,0.255,0.168,0.079
240426,2002,286,150,136,37,15,22,14.67,0.147,0.129,0.11
240444,2002,5488,3016,2472,2729,1037,1692,56.1,0.561,0.497,0.419
240453,2002,3178,1736,1442,457,175,282,16.24,0.162,0.144,0.121
240462,2002,1120,395,725,184,75,109,27.59,0.276,0.164,0.103
240471,2002,1045,642,403,277,81,196,30.53,0.305,0.265,0.201
240480,2002,1464,806,658,286,109,177,21.96,0.22,0.195,0.166
240727,2002,1443,733,710,328,113,215,29.33,0.293,0.227,0.159
243443,2002,496,320,176,43,8,35,10.94,0.109,0.087,0.045
243780,2002,6294,2535,3759,2230,1046,1184,46.71,0.467,0.354,0.278
100654,2003,1287,673,614,112,30,82,12.18,0.122,0.087,0.049
100663,2003,1607,1042,565,266,61,205,19.67,0.197,0.166,0.108
100751,2003,2982,1685,1297,1121,364,757,44.93,0.449,0.376,0.281
100858,2003,3692,1965,1727,1352,444,908,46.21,0.462,0.366,0.257
101435,2003,203,76,127,72,30,42,55.26,0.553,0.355,0.236
101480,2003,1044,561,483,139,45,94,16.76,0.168,0.133,0.093
101675,2003,347,179,168,24,6,18,10.06,0.101,0.069,0.036
101879,2003,789,479,310,142,37,105,21.92,0.219,0.18,0.119
102049,2003,682,426,256,362,123,239,56.1,0.561,0.531,0.48
102094,2003,1218,704,514,155,42,113,16.05,0.16,0.127,0.082
102234,2003,308,193,115,157,61,96,49.74,0.497,0.51,0.53
102368,2003,1229,672,557,215,66,149,22.17,0.222,0.175,0.118
102377,2003,528,272,256,82,32,50,18.38,0.184,0.155,0.125
104151,2003,6815,3652,3163,1997,730,1267,34.69,0.347,0.293,0.231
104179,2003,5780,3154,2626,1870,708,1162,36.84,0.368,0.324,0.27
105330,2003,2114,1249,865,644,196,448,35.87,0.359,0.305,0.227
106245,2003,691,405,286,29,9,20,4.94,0.049,0.042,0.031
106342,2003,120,67,53,53,23,30,44.78,0.448,0.442,0.434
106397,2003,2260,1175,1085,775,318,457,38.89,0.389,0.343,0.293
106412,2003,731,333,398,47,12,35,10.51,0.105,0.064,0.03
106458,2003,1426,798,628,233,70,163,20.43,0.204,0.163,0.111
106467,2003,1445,723,722,248,96,152,21.02,0.21,0.172,0.133
106485,2003,674,371,303,57,25,32,8.63,0.086,0.085,0.083
106704,2003,2414,1450,964,527,165,362,24.97,0.25,0.218,0.171
107044,2003,966,543,423,369,132,237,43.65,0.436,0.382,0.312
107080,2003,267,155,112,157,63,94,60.65,0.607,0.588,0.562
107141,2003,274,140,134,145,68,77,55,0.55,0.529,0.507
107512,2003,343,195,148,140,52,88,45.13,0.451,0.408,0.351
107558,2003,206,113,93,63,20,43,38.05,0.38,0.306,0.215
110097,2003,685,459,226,348,104,244,53.16,0.532,0.508,0.46
110404,2003,190,64,126,138,90,48,75,0.75,0.726,0.714
110422,2003,2798,1239,1559,673,264,409,33.01,0.33,0.241,0.169
110486,2003,714,476,238,92,23,69,14.5,0.145,0.129,0.097
110495,2003,551,365,186,119,37,82,22.47,0.225,0.216,0.199
110510,2003,1335,918,417,178,45,133,14.49,0.145,0.133,0.108
110529,2003,2558,1107,1451,384,172,212,19.15,0.192,0.15,0.119
110538,2003,1970,1140,830,322,71,251,22.02,0.22,0.163,0.086
110547,2003,639,458,181,31,5,26,5.68,0.057,0.049,0.028
110556,2003,2485,1503,982,353,101,252,16.77,0.168,0.142,0.103
110565,2003,3098,1873,1225,481,107,374,19.97,0.2,0.155,0.087
110574,2003,672,415,257,111,32,79,19.04,0.19,0.165,0.125
110583,2003,3339,2236,1103,432,103,329,14.71,0.147,0.129,0.093
110592,2003,1305,845,460,115,32,83,9.82,0.098,0.088,0.07
110617,2003,2347,1415,932,227,62,165,11.66,0.117,0.097,0.067
113698,2003,244,188,56,98,24,74,39.36,0.394,0.402,0.429
115755,2003,853,481,372,97,26,71,14.76,0.148,0.114,0.07
119173,2003,339,330,9,84,4,80,24.24,0.242,0.248,0.444
120184,2003,190,106,84,90,36,54,50.94,0.509,0.474,0.429
121309,2003,566,356,210,353,119,234,65.73,0.657,0.624,0.567
121345,2003,398,202,196,354,170,184,91.09,0.911,0.889,0.867
122409,2003,3418,2106,1312,973,286,687,32.62,0.326,0.285,0.218
122436,2003,1059,718,341,695,208,487,67.83,0.678,0.656,0.61
122597,2003,2291,1474,817,267,69,198,13.43,0.134,0.117,0.084
122612,2003,914,632,282,452,131,321,50.79,0.508,0.495,0.465
122931,2003,892,509,383,690,284,406,79.76,0.798,0.774,0.742
123554,2003,562,317,245,285,106,179,56.47,0.565,0.507,0.433
123572,2003,1287,838,449,341,80,261,31.15,0.312,0.265,0.178
126562,2003,624,353,271,104,36,68,19.26,0.193,0.167,0.133
126580,2003,892,552,340,193,43,150,27.17,0.272,0.216,0.126
126614,2003,5515,2761,2754,2267,966,1301,47.12,0.471,0.411,0.351
126818,2003,3730,2012,1718,1319,483,836,41.55,0.416,0.354,0.281
127060,2003,1010,549,461,540,216,324,59.02,0.59,0.535,0.469
127185,2003,899,422,477,138,51,87,20.62,0.206,0.154,0.107
127565,2003,1809,931,878,82,26,56,6.02,0.06,0.045,0.03
127741,2003,2118,1337,781,598,169,429,32.09,0.321,0.282,0.216
128106,2003,686,372,314,93,35,58,15.59,0.156,0.136,0.111
128744,2003,286,158,128,61,14,47,29.75,0.298,0.213,0.109
128771,2003,1176,571,605,166,59,107,18.74,0.187,0.141,0.098
129020,2003,3182,1733,1449,1912,757,1155,66.65,0.667,0.601,0.522
129242,2003,789,459,330,636,260,376,81.92,0.819,0.806,0.788
129941,2003,618,301,317,223,85,138,45.85,0.458,0.361,0.268
130253,2003,816,497,319,462,144,318,63.98,0.64,0.566,0.451
130314,2003,190,190,0,59,0,59,31.05,0.31,0.311,NA
130493,2003,1310,802,508,7,2,5,0.62,0.006,0.005,0.004
130590,2003,548,257,291,421,212,209,81.32,0.813,0.768,0.729
130697,2003,713,376,337,631,291,340,90.43,0.904,0.885,0.864
130776,2003,808,444,364,105,40,65,14.64,0.146,0.13,0.11
130794,2003,1350,680,670,1221,582,639,93.97,0.94,0.904,0.869
130934,2003,597,355,242,89,13,76,21.41,0.214,0.149,0.054
130943,2003,3794,2157,1637,2016,761,1255,58.18,0.582,0.531,0.465
131159,2003,1238,832,406,882,286,596,71.63,0.716,0.712,0.704
131283,2003,646,362,284,423,167,256,70.72,0.707,0.655,0.588
131450,2003,236,124,112,25,8,17,13.71,0.137,0.106,0.071
131469,2003,2260,1333,927,1726,683,1043,78.24,0.782,0.764,0.737
131496,2003,1504,827,677,1321,575,746,90.21,0.902,0.878,0.849
131520,2003,1446,992,454,679,155,524,52.82,0.528,0.47,0.341
132471,2003,517,336,181,91,33,58,17.26,0.173,0.176,0.182
132602,2003,827,492,335,112,24,88,17.89,0.179,0.135,0.072
132903,2003,5653,2956,2697,1923,673,1250,42.29,0.423,0.34,0.25
133492,2003,434,248,186,250,101,149,60.08,0.601,0.576,0.543
133553,2003,1012,164,848,292,238,54,32.93,0.329,0.289,0.281
133650,2003,2403,1391,1012,289,79,210,15.1,0.151,0.12,0.078
133669,2003,2038,1143,895,335,109,226,19.77,0.198,0.164,0.122
133711,2003,556,318,238,220,84,136,42.77,0.428,0.396,0.353
133881,2003,549,174,375,219,136,83,47.7,0.477,0.399,0.363
133951,2003,3038,1756,1282,597,185,412,23.46,0.235,0.197,0.144
134079,2003,436,250,186,163,51,112,44.8,0.448,0.374,0.274
134097,2003,6059,3522,2537,2847,987,1860,52.81,0.528,0.47,0.389
134130,2003,6499,3790,2709,3779,1253,2526,66.65,0.667,0.581,0.463
134945,2003,430,192,238,137,57,80,41.67,0.417,0.319,0.239
135726,2003,2066,1142,924,1374,582,792,69.35,0.694,0.665,0.63
136172,2003,1919,1115,804,444,120,324,29.06,0.291,0.231,0.149
136950,2003,496,298,198,291,102,189,63.42,0.634,0.587,0.515
137546,2003,523,284,239,260,109,151,53.17,0.532,0.497,0.456
138354,2003,816,469,347,169,48,121,25.8,0.258,0.207,0.138
138716,2003,537,322,215,78,21,57,17.7,0.177,0.145,0.098
138789,2003,719,433,286,47,8,39,9.01,0.09,0.065,0.028
139144,2003,504,321,183,240,76,164,51.09,0.511,0.476,0.415
139366,2003,1037,619,418,114,32,82,13.25,0.132,0.11,0.077
139393,2003,236,146,90,108,32,76,52.05,0.52,0.458,0.356
139658,2003,1595,895,700,1060,453,607,67.82,0.678,0.665,0.647
139719,2003,496,260,236,64,17,47,18.08,0.181,0.129,0.072
139755,2003,2224,607,1617,683,427,256,42.17,0.422,0.307,0.264
139764,2003,326,222,104,48,13,35,15.77,0.158,0.147,0.125
139861,2003,1027,611,416,254,69,185,30.28,0.303,0.247,0.166
139931,2003,2735,1305,1430,466,145,321,24.6,0.246,0.17,0.101
139940,2003,1920,1159,761,349,114,235,20.28,0.203,0.182,0.15
139959,2003,5157,3146,2011,2535,807,1728,54.93,0.549,0.492,0.401
140447,2003,663,381,282,292,88,204,53.54,0.535,0.44,0.312
140960,2003,607,354,253,76,12,64,18.08,0.181,0.125,0.047
140988,2003,184,96,88,80,33,47,48.96,0.49,0.435,0.375
141185,2003,165,107,58,83,22,61,57.01,0.57,0.503,0.379
141264,2003,1756,1007,749,262,73,189,18.77,0.188,0.149,0.097
141334,2003,1738,1020,718,215,47,168,16.47,0.165,0.124,0.065
141486,2003,254,174,80,54,18,36,20.69,0.207,0.213,0.225
141565,2003,423,274,149,54,17,37,13.5,0.135,0.128,0.114
141574,2003,1878,1035,843,307,92,215,20.77,0.208,0.163,0.109
142276,2003,787,499,288,53,10,43,8.62,0.086,0.067,0.035
142285,2003,1590,748,842,393,163,230,30.75,0.308,0.247,0.194
142461,2003,241,153,88,89,22,67,43.79,0.438,0.369,0.25
143084,2003,614,369,245,443,153,290,78.59,0.786,0.721,0.624
143288,2003,176,82,94,49,19,30,36.59,0.366,0.278,0.202
144005,2003,476,336,140,12,4,8,2.38,0.024,0.025,0.029
144281,2003,1446,777,669,389,166,223,28.7,0.287,0.269,0.248
144740,2003,2249,1351,898,966,341,625,46.26,0.463,0.43,0.38
144892,2003,1892,1098,794,563,185,378,34.43,0.344,0.298,0.233
144962,2003,366,230,136,194,54,140,60.87,0.609,0.53,0.397
144971,2003,92,44,48,15,5,10,22.73,0.227,0.163,0.104
145600,2003,2880,1573,1307,702,275,427,27.15,0.272,0.244,0.21
145619,2003,302,169,133,116,49,67,39.64,0.396,0.384,0.368
145637,2003,6807,3268,3539,4390,2070,2320,70.99,0.71,0.645,0.585
145691,2003,318,180,138,157,59,98,54.44,0.544,0.494,0.428
145813,2003,3088,1934,1154,1294,411,883,45.66,0.457,0.419,0.356
146481,2003,347,194,153,203,86,117,60.31,0.603,0.585,0.562
146612,2003,458,224,234,179,86,93,41.52,0.415,0.391,0.368
146719,2003,1915,1292,623,924,296,628,48.61,0.486,0.483,0.475
146825,2003,162,79,83,48,17,31,39.24,0.392,0.296,0.205
147013,2003,287,124,163,113,55,58,46.77,0.468,0.394,0.337
147244,2003,595,299,296,317,132,185,61.87,0.619,0.533,0.446
147341,2003,355,175,180,215,97,118,67.43,0.674,0.606,0.539
147703,2003,3229,1635,1594,737,300,437,26.73,0.267,0.228,0.188
147767,2003,1941,1035,906,1694,753,941,90.92,0.909,0.873,0.831
147776,2003,1046,657,389,36,12,24,3.65,0.036,0.034,0.031
147828,2003,578,339,239,252,93,159,46.9,0.469,0.436,0.389
148131,2003,222,108,114,68,32,36,33.33,0.333,0.306,0.281
148496,2003,240,176,64,146,40,106,60.23,0.602,0.608,0.625
148584,2003,190,110,80,62,27,35,31.82,0.318,0.326,0.338
148627,2003,371,231,140,107,32,75,32.47,0.325,0.288,0.229
149222,2003,2532,1089,1443,595,280,315,28.93,0.289,0.235,0.194
149231,2003,1699,982,717,399,129,270,27.49,0.275,0.235,0.18
149772,2003,1938,939,999,675,322,353,37.59,0.376,0.348,0.322
149781,2003,576,288,288,462,223,239,82.99,0.83,0.802,0.774
150066,2003,559,337,222,246,81,165,48.96,0.49,0.44,0.365
150136,2003,3963,2139,1824,1329,507,822,38.43,0.384,0.335,0.278
150145,2003,291,175,116,117,39,78,44.57,0.446,0.402,0.336
150163,2003,972,612,360,550,184,366,59.8,0.598,0.566,0.511
150400,2003,580,305,275,456,202,254,83.28,0.833,0.786,0.735
150534,2003,662,418,244,346,119,227,54.31,0.543,0.523,0.488
150668,2003,181,99,82,101,41,60,60.61,0.606,0.558,0.5
150941,2003,190,103,87,94,45,49,47.57,0.476,0.495,0.517
151102,2003,1366,757,609,76,29,47,6.21,0.062,0.056,0.048
151111,2003,2336,1361,975,210,79,131,9.63,0.096,0.09,0.081
151306,2003,1953,1151,802,271,78,193,16.77,0.168,0.139,0.097
151324,2003,1974,974,1000,351,128,223,22.9,0.229,0.178,0.128
151333,2003,382,264,118,27,5,22,8.33,0.083,0.071,0.042
151342,2003,707,417,290,42,18,24,5.76,0.058,0.059,0.062
151351,2003,6739,3773,2966,3490,1419,2071,54.89,0.549,0.518,0.478
151360,2003,660,417,243,49,14,35,8.39,0.084,0.074,0.058
151379,2003,674,400,274,53,15,38,9.5,0.095,0.079,0.055
151388,2003,318,203,115,20,7,13,6.4,0.064,0.063,0.061
151777,2003,335,168,167,127,53,74,44.05,0.44,0.379,0.317
151786,2003,239,162,77,71,27,44,27.16,0.272,0.297,0.351
152080,2003,1995,928,1067,1797,955,842,90.73,0.907,0.901,0.895
152248,2003,997,527,470,56,21,35,6.64,0.066,0.056,0.045
152363,2003,306,159,147,134,66,68,42.77,0.428,0.438,0.449
152530,2003,468,270,198,331,137,194,71.85,0.718,0.707,0.692
152600,2003,791,400,391,501,229,272,68,0.68,0.633,0.586
153001,2003,377,193,184,172,74,98,50.78,0.508,0.456,0.402
153108,2003,416,227,189,231,87,144,63.44,0.634,0.555,0.46
153269,2003,809,474,335,410,151,259,54.64,0.546,0.507,0.451
153384,2003,403,214,189,315,138,177,82.71,0.827,0.782,0.73
153603,2003,3860,1683,2177,1364,577,787,46.76,0.468,0.353,0.265
153834,2003,667,397,270,436,172,264,66.5,0.665,0.654,0.637
154095,2003,1739,1088,651,613,182,431,39.61,0.396,0.353,0.28
155089,2003,201,102,99,38,14,24,23.53,0.235,0.189,0.141
155317,2003,3971,2126,1845,1261,480,781,36.74,0.367,0.318,0.26
155335,2003,200,118,82,57,19,38,32.2,0.322,0.285,0.232
155399,2003,3098,1529,1569,855,303,552,36.1,0.361,0.276,0.193
155520,2003,260,125,135,103,41,62,49.6,0.496,0.396,0.304
155627,2003,114,47,67,28,6,22,46.81,0.468,0.246,0.09
155937,2003,124,57,67,44,16,28,49.12,0.491,0.355,0.239
156213,2003,258,146,112,148,68,80,54.79,0.548,0.574,0.607
156286,2003,450,289,161,235,79,156,53.98,0.54,0.522,0.491
156295,2003,396,240,156,203,83,120,50,0.5,0.513,0.532
156365,2003,351,162,189,86,37,49,30.25,0.302,0.245,0.196
156541,2003,401,191,210,98,33,65,34.03,0.34,0.244,0.157
156745,2003,368,213,155,181,54,127,59.62,0.596,0.492,0.348
157058,2003,309,162,147,23,9,14,8.64,0.086,0.074,0.061
157076,2003,165,91,74,58,19,39,42.86,0.429,0.352,0.257
157085,2003,3678,1951,1727,1160,460,700,35.88,0.359,0.315,0.266
157289,2003,2197,1118,1079,468,173,295,26.39,0.264,0.213,0.16
157386,2003,1555,867,688,185,60,125,14.42,0.144,0.119,0.087
157401,2003,1500,876,624,477,160,317,36.19,0.362,0.318,0.256
157447,2003,1962,1108,854,155,35,120,10.83,0.108,0.079,0.041
157535,2003,147,67,80,27,10,17,25.37,0.254,0.184,0.125
157951,2003,3034,1782,1252,541,169,372,20.88,0.209,0.178,0.135
158477,2003,197,113,84,101,34,67,59.29,0.593,0.513,0.405
159009,2003,1022,570,452,124,29,95,16.67,0.167,0.121,0.064
159391,2003,5359,2938,2421,1396,468,928,31.59,0.316,0.26,0.193
159647,2003,1948,958,990,485,190,295,30.79,0.308,0.249,0.192
159717,2003,1506,843,663,176,51,125,14.83,0.148,0.117,0.077
159966,2003,1391,813,578,121,36,85,10.46,0.105,0.087,0.062
160038,2003,1826,1117,709,227,71,156,13.97,0.14,0.124,0.1
160612,2003,2539,1451,1088,221,72,149,10.27,0.103,0.087,0.066
160621,2003,1351,782,569,77,16,61,7.8,0.078,0.057,0.028
160658,2003,2576,1437,1139,333,86,247,17.19,0.172,0.129,0.076
161004,2003,464,236,228,412,202,210,88.98,0.89,0.888,0.886
161226,2003,482,339,143,221,59,162,47.79,0.478,0.459,0.413
161235,2003,126,62,64,19,4,15,24.19,0.242,0.151,0.062
161244,2003,142,92,50,17,1,16,17.39,0.174,0.12,0.02
161253,2003,1599,812,787,538,235,303,37.32,0.373,0.336,0.299
161554,2003,851,496,355,106,24,82,16.53,0.165,0.125,0.068
162007,2003,762,479,283,98,18,80,16.7,0.167,0.129,0.064
162210,2003,187,120,67,24,6,18,15,0.15,0.128,0.09
162283,2003,571,432,139,29,9,20,4.63,0.046,0.051,0.065
162584,2003,988,450,538,216,85,131,29.11,0.291,0.219,0.158
162654,2003,342,207,135,207,60,147,71.01,0.71,0.605,0.444
162760,2003,181,143,38,110,20,90,62.94,0.629,0.608,0.526
162928,2003,1122,499,623,919,488,431,86.37,0.864,0.819,0.783
163046,2003,915,545,370,704,277,427,78.35,0.783,0.769,0.749
163268,2003,1487,657,830,506,215,291,44.29,0.443,0.34,0.259
163286,2003,4045,2031,2014,2539,1158,1381,68,0.68,0.628,0.575
163453,2003,1220,699,521,138,34,104,14.88,0.149,0.113,0.065
163462,2003,395,237,158,279,110,169,71.31,0.713,0.706,0.696
163851,2003,947,531,416,433,142,291,54.8,0.548,0.457,0.341
163912,2003,421,249,172,300,106,194,77.91,0.779,0.713,0.616
164076,2003,1756,1192,564,763,181,582,48.83,0.488,0.435,0.321
164173,2003,539,384,155,247,63,184,47.92,0.479,0.458,0.406
164216,2003,361,228,133,272,93,179,78.51,0.785,0.753,0.699
164270,2003,451,249,202,274,94,180,72.29,0.723,0.608,0.465
164447,2003,327,174,153,105,45,60,34.48,0.345,0.321,0.294
164492,2003,154,102,52,76,19,57,55.88,0.559,0.494,0.365
164562,2003,640,408,232,409,140,269,65.93,0.659,0.639,0.603
165015,2003,824,486,338,692,285,407,83.74,0.837,0.84,0.843
165024,2003,1285,745,540,320,93,227,30.47,0.305,0.249,0.172
165334,2003,537,324,213,391,150,241,74.38,0.744,0.728,0.704
165662,2003,706,413,293,525,229,296,71.67,0.717,0.744,0.782
165671,2003,406,299,107,222,47,175,58.53,0.585,0.547,0.439
165820,2003,585,320,265,144,50,94,29.38,0.294,0.246,0.189
165866,2003,617,441,176,202,45,157,35.6,0.356,0.327,0.256
165936,2003,427,274,153,260,86,174,63.5,0.635,0.609,0.562
166027,2003,1633,782,851,1433,726,707,90.41,0.904,0.878,0.853
166124,2003,698,378,320,607,270,337,89.15,0.892,0.87,0.844
166513,2003,1008,393,615,291,145,146,37.15,0.372,0.289,0.236
166629,2003,4149,2060,2089,1958,850,1108,53.79,0.538,0.472,0.407
166638,2003,602,353,249,60,21,39,11.05,0.111,0.1,0.084
166683,2003,1018,459,559,842,450,392,85.4,0.854,0.827,0.805
167288,2003,244,149,95,91,28,63,42.28,0.423,0.373,0.295
167987,2003,1510,764,746,489,187,302,39.53,0.395,0.324,0.251
167996,2003,565,307,258,451,193,258,84.04,0.84,0.798,0.748
168005,2003,914,542,372,320,117,203,37.45,0.375,0.35,0.315
168148,2003,1281,664,617,1087,507,580,87.35,0.873,0.849,0.822
168254,2003,672,279,393,275,148,127,45.52,0.455,0.409,0.377
168281,2003,445,286,159,324,104,220,76.92,0.769,0.728,0.654
168342,2003,533,272,261,497,245,252,92.65,0.927,0.932,0.939
168546,2003,486,263,223,306,118,188,71.48,0.715,0.63,0.529
168786,2003,284,182,102,94,31,63,34.62,0.346,0.331,0.304
169080,2003,1041,577,464,572,230,342,59.27,0.593,0.549,0.496
169798,2003,2479,1510,969,295,85,210,13.91,0.139,0.119,0.088
169910,2003,2205,960,1245,137,67,70,7.29,0.073,0.062,0.054
170082,2003,3270,2096,1174,851,257,594,28.34,0.283,0.26,0.219
170301,2003,810,515,295,531,167,364,70.68,0.707,0.656,0.566
170532,2003,382,220,162,275,118,157,71.36,0.714,0.72,0.728
170639,2003,551,243,308,42,17,25,10.29,0.103,0.076,0.055
170976,2003,5538,2903,2635,4025,1840,2185,75.27,0.753,0.727,0.698
171100,2003,6938,3932,3006,3315,1201,2114,53.76,0.538,0.478,0.4
171128,2003,1168,238,930,251,177,74,31.09,0.311,0.215,0.19
171137,2003,704,313,391,123,62,61,19.49,0.195,0.175,0.159
171146,2003,420,252,168,57,17,40,15.87,0.159,0.136,0.101
171599,2003,271,99,172,101,53,48,48.48,0.485,0.373,0.308
172051,2003,1156,667,489,104,32,72,10.79,0.108,0.09,0.065
172699,2003,4218,2191,2027,915,388,527,24.05,0.241,0.217,0.191
173160,2003,690,419,271,427,172,255,60.86,0.609,0.619,0.635
173258,2003,488,241,247,435,215,220,91.29,0.913,0.891,0.87
173328,2003,167,83,84,59,25,34,40.96,0.41,0.353,0.298
173647,2003,623,331,292,514,235,279,84.29,0.843,0.825,0.805
173902,2003,513,300,213,422,168,254,84.67,0.847,0.823,0.789
174066,2003,5160,2820,2340,2341,902,1439,51.03,0.51,0.454,0.385
174233,2003,2155,1073,1082,514,218,296,27.59,0.276,0.239,0.201
174251,2003,412,249,163,179,60,119,47.79,0.478,0.434,0.368
174491,2003,431,291,140,191,55,136,46.74,0.467,0.443,0.393
174792,2003,490,0,490,346,346,0,NA,NA,0.706,0.706
174844,2003,719,422,297,593,234,359,85.07,0.851,0.825,0.788
174899,2003,411,299,112,256,75,181,60.54,0.605,0.623,0.67
174914,2003,1038,547,491,584,244,340,62.16,0.622,0.563,0.497
175342,2003,495,271,224,108,32,76,28.04,0.28,0.218,0.143
175421,2003,170,96,74,53,15,38,39.58,0.396,0.312,0.203
175616,2003,327,191,136,55,19,36,18.85,0.189,0.168,0.14
175856,2003,883,470,413,141,43,98,20.85,0.209,0.16,0.104
175980,2003,259,141,118,152,63,89,63.12,0.631,0.587,0.534
176017,2003,2377,1297,1080,851,286,565,43.56,0.436,0.358,0.265
176035,2003,202,178,24,48,3,45,25.28,0.253,0.238,0.125
176044,2003,325,187,138,57,16,41,21.93,0.219,0.175,0.116
176080,2003,1659,822,837,509,185,324,39.42,0.394,0.307,0.221
176406,2003,221,166,55,53,9,44,26.51,0.265,0.24,0.164
176628,2003,152,93,59,36,5,31,33.33,0.333,0.237,0.085
176947,2003,223,93,130,64,25,39,41.94,0.419,0.287,0.192
176965,2003,1355,737,618,323,115,208,28.22,0.282,0.238,0.186
177418,2003,194,143,51,61,14,47,32.87,0.329,0.314,0.275
178059,2003,318,236,82,163,39,124,52.54,0.525,0.513,0.476
178341,2003,568,319,249,76,25,51,15.99,0.16,0.134,0.1
178387,2003,994,572,422,111,27,84,14.69,0.147,0.112,0.064
178396,2003,4605,2443,2162,1985,737,1248,51.08,0.511,0.431,0.341
178402,2003,758,455,303,124,38,86,18.9,0.189,0.164,0.125
178411,2003,870,181,689,217,154,63,34.81,0.348,0.249,0.224
178420,2003,464,280,184,97,26,71,25.36,0.254,0.209,0.141
178615,2003,1310,787,523,612,198,414,52.6,0.526,0.467,0.379
179043,2003,244,130,114,141,60,81,62.31,0.623,0.578,0.526
179159,2003,1377,752,625,832,338,494,65.69,0.657,0.604,0.541
179557,2003,1410,826,584,336,98,238,28.81,0.288,0.238,0.168
179566,2003,2645,1495,1150,1044,382,662,44.28,0.443,0.395,0.332
179867,2003,1349,699,650,1138,517,621,88.84,0.888,0.844,0.795
179894,2003,419,260,159,201,62,139,53.46,0.535,0.48,0.39
179946,2003,240,93,147,96,56,40,43.01,0.43,0.4,0.381
180179,2003,588,380,208,54,13,41,10.79,0.108,0.092,0.062
180461,2003,2004,837,1167,383,193,190,22.7,0.227,0.191,0.165
180522,2003,214,108,106,36,20,16,14.81,0.148,0.168,0.189
180984,2003,222,138,84,77,25,52,37.68,0.377,0.347,0.298
181002,2003,933,567,366,601,223,378,66.67,0.667,0.644,0.609
181020,2003,288,152,136,173,75,98,64.47,0.645,0.601,0.551
181127,2003,338,143,195,185,87,98,68.53,0.685,0.547,0.446
181215,2003,1012,588,424,229,73,156,26.53,0.265,0.226,0.172
181394,2003,1465,787,678,189,85,104,13.21,0.132,0.129,0.125
181446,2003,417,241,176,216,83,133,55.19,0.552,0.518,0.472
181464,2003,3639,1825,1814,904,341,563,30.85,0.308,0.248,0.188
181534,2003,188,89,99,29,9,20,22.47,0.225,0.154,0.091
181783,2003,598,342,256,163,59,104,30.41,0.304,0.273,0.23
182281,2003,2827,1596,1231,338,107,231,14.47,0.145,0.12,0.087
182290,2003,2047,1154,893,254,76,178,15.42,0.154,0.124,0.085
182634,2003,304,207,97,158,34,124,59.9,0.599,0.52,0.351
182795,2003,514,244,270,172,74,98,40.16,0.402,0.335,0.274
183062,2003,991,598,393,369,126,243,40.64,0.406,0.372,0.321
183080,2003,900,469,431,310,134,176,37.53,0.375,0.344,0.311
183239,2003,587,336,251,418,172,246,73.21,0.732,0.712,0.685
183822,2003,341,215,126,39,6,33,15.35,0.154,0.114,0.048
183974,2003,221,126,95,112,47,65,51.59,0.516,0.507,0.495
184348,2003,419,247,172,289,109,180,72.87,0.729,0.69,0.634
184603,2003,540,303,237,105,40,65,21.45,0.214,0.194,0.169
184612,2003,218,158,60,33,10,23,14.56,0.146,0.151,0.167
184782,2003,1243,600,643,588,265,323,53.83,0.538,0.473,0.412
185129,2003,652,380,272,49,15,34,8.95,0.09,0.075,0.055
185572,2003,904,484,420,358,125,233,48.14,0.481,0.396,0.298
185590,2003,1594,934,660,471,134,337,36.08,0.361,0.295,0.203
185828,2003,685,119,566,118,92,26,21.85,0.219,0.172,0.163
186131,2003,1161,539,622,1044,549,495,91.84,0.918,0.899,0.883
186201,2003,719,423,296,439,165,274,64.78,0.648,0.611,0.557
186283,2003,944,575,369,443,154,289,50.26,0.503,0.469,0.417
186584,2003,1241,616,625,620,301,319,51.79,0.518,0.5,0.482
186876,2003,816,439,377,319,119,200,45.56,0.456,0.391,0.316
187134,2003,1176,679,497,855,327,528,77.76,0.778,0.727,0.658
187444,2003,1269,711,558,262,86,176,24.75,0.248,0.206,0.154
187985,2003,2940,1660,1280,300,76,224,13.49,0.135,0.102,0.059
188030,2003,2016,1087,929,257,90,167,15.36,0.154,0.127,0.097
188429,2003,772,514,258,402,117,285,55.45,0.554,0.521,0.453
188641,2003,472,250,222,237,89,148,59.2,0.592,0.502,0.401
190044,2003,720,193,527,372,257,115,59.59,0.596,0.517,0.488
190099,2003,725,355,370,615,301,314,88.45,0.885,0.848,0.814
190150,2003,1355,626,729,1131,606,525,83.87,0.839,0.835,0.831
190248,2003,137,85,52,37,12,25,29.41,0.294,0.27,0.231
190415,2003,3131,1533,1598,2672,1322,1350,88.06,0.881,0.853,0.827
190512,2003,1659,819,840,544,214,330,40.29,0.403,0.328,0.255
190549,2003,1296,679,617,220,73,147,21.65,0.216,0.17,0.118
190558,2003,1885,1013,872,67,17,50,4.94,0.049,0.036,0.019
190567,2003,1124,547,577,62,20,42,7.68,0.077,0.055,0.035
190594,2003,1661,1113,548,280,63,217,19.5,0.195,0.169,0.115
190637,2003,790,529,261,85,20,65,12.29,0.123,0.108,0.077
190664,2003,1290,790,500,327,88,239,30.25,0.302,0.253,0.176
190691,2003,565,366,199,30,8,22,6.01,0.06,0.053,0.04
190725,2003,356,252,104,108,23,85,33.73,0.337,0.303,0.221
191241,2003,1687,961,726,1265,547,718,74.71,0.747,0.75,0.753
191515,2003,464,234,230,383,185,198,84.62,0.846,0.825,0.804
191533,2003,447,236,211,210,77,133,56.36,0.564,0.47,0.365
191630,2003,516,267,249,383,176,207,77.53,0.775,0.742,0.707
191649,2003,1855,979,876,768,290,478,48.83,0.488,0.414,0.331
191676,2003,299,203,96,179,53,126,62.07,0.621,0.599,0.552
191931,2003,811,434,377,409,152,257,59.22,0.592,0.504,0.403
191968,2003,1581,912,669,1118,456,662,72.59,0.726,0.707,0.682
192192,2003,239,168,71,107,29,78,46.43,0.464,0.448,0.408
192323,2003,503,310,193,323,115,208,67.1,0.671,0.642,0.596
192439,2003,680,480,200,45,10,35,7.29,0.073,0.066,0.05
192703,2003,638,342,296,400,173,227,66.37,0.664,0.627,0.584
192749,2003,422,295,127,223,68,155,52.54,0.525,0.528,0.535
192819,2003,961,528,433,732,310,422,79.92,0.799,0.762,0.716
192925,2003,241,146,95,100,42,58,39.73,0.397,0.415,0.442
193016,2003,611,379,232,58,10,48,12.66,0.127,0.095,0.043
193292,2003,262,185,77,89,29,60,32.43,0.324,0.34,0.377
193353,2003,347,246,101,137,31,106,43.09,0.431,0.395,0.307
193399,2003,336,272,64,136,13,123,45.22,0.452,0.405,0.203
193584,2003,383,284,99,236,54,182,64.08,0.641,0.616,0.545
193645,2003,769,668,101,121,5,116,17.37,0.174,0.157,0.05
193654,2003,581,409,172,288,81,207,50.61,0.506,0.496,0.471
193900,2003,4203,2563,1640,2664,1069,1595,62.23,0.622,0.634,0.652
193973,2003,686,417,269,403,152,251,60.19,0.602,0.587,0.565
194161,2003,267,166,101,79,26,53,31.93,0.319,0.296,0.257
194310,2003,1553,997,556,653,214,439,44.03,0.44,0.42,0.385
194824,2003,1341,320,1021,856,626,230,71.88,0.719,0.638,0.613
195003,2003,2121,567,1554,538,286,252,44.44,0.444,0.254,0.184
195030,2003,1086,508,578,747,368,379,74.61,0.746,0.688,0.637
195164,2003,595,292,303,296,135,161,55.14,0.551,0.497,0.446
195173,2003,428,224,204,71,18,53,23.66,0.237,0.166,0.088
195216,2003,565,296,269,444,196,248,83.78,0.838,0.786,0.729
195234,2003,531,397,134,277,52,225,56.68,0.567,0.522,0.388
195243,2003,343,188,155,97,39,58,30.85,0.308,0.283,0.252
195304,2003,322,234,88,218,63,155,66.24,0.662,0.677,0.716
195474,2003,759,438,321,519,204,315,71.92,0.719,0.684,0.636
195526,2003,642,377,265,527,208,319,84.62,0.846,0.821,0.785
195544,2003,96,80,16,67,10,57,71.25,0.713,0.698,0.625
195809,2003,2966,1749,1217,1058,381,677,38.71,0.387,0.357,0.313
196413,2003,2628,1501,1127,1914,755,1159,77.22,0.772,0.728,0.67
196592,2003,1967,1343,624,247,74,173,12.88,0.129,0.126,0.119
197045,2003,447,254,193,169,70,99,38.98,0.39,0.378,0.363
197133,2003,631,367,264,554,226,328,89.37,0.894,0.878,0.856
197869,2003,2462,1216,1246,920,360,560,46.05,0.46,0.374,0.289
197984,2003,147,70,77,48,25,23,32.86,0.329,0.327,0.325
198385,2003,489,237,252,435,218,217,91.56,0.916,0.89,0.865
198464,2003,3458,2117,1341,1035,293,742,35.05,0.35,0.299,0.218
198507,2003,459,258,201,104,36,68,26.36,0.264,0.227,0.179
198516,2003,1227,775,452,875,294,581,74.97,0.75,0.713,0.65
198835,2003,308,178,130,124,45,79,44.38,0.444,0.403,0.346
198969,2003,384,120,264,58,26,32,26.67,0.267,0.151,0.098
199102,2003,2221,1176,1045,389,104,285,24.23,0.242,0.175,0.1
199111,2003,590,332,258,170,45,125,37.65,0.376,0.288,0.174
199120,2003,3511,2068,1443,2535,945,1590,76.89,0.769,0.722,0.655
199139,2003,2472,1291,1181,630,244,386,29.9,0.299,0.255,0.207
199148,2003,2039,1422,617,577,123,454,31.93,0.319,0.283,0.199
199157,2003,1025,679,346,190,32,158,23.27,0.233,0.185,0.092
199193,2003,3915,1665,2250,1595,734,861,51.71,0.517,0.407,0.326
199218,2003,1764,1133,631,783,227,556,49.07,0.491,0.444,0.36
199281,2003,792,415,377,130,45,85,20.48,0.205,0.164,0.119
199306,2003,158,86,72,56,20,36,41.86,0.419,0.354,0.278
199412,2003,252,186,66,127,34,93,50,0.5,0.504,0.515
199582,2003,542,238,304,46,15,31,13.03,0.13,0.085,0.049
199643,2003,469,249,220,79,31,48,19.28,0.193,0.168,0.141
199847,2003,984,507,477,834,386,448,88.36,0.884,0.848,0.809
199962,2003,372,198,174,160,55,105,53.03,0.53,0.43,0.316
199999,2003,883,580,303,124,25,99,17.07,0.171,0.14,0.083
200004,2003,1485,739,746,394,138,256,34.64,0.346,0.265,0.185
200059,2003,383,201,182,42,14,28,13.93,0.139,0.11,0.077
200156,2003,261,142,119,82,27,55,38.73,0.387,0.314,0.227
200217,2003,390,226,164,147,36,111,49.12,0.491,0.377,0.22
200226,2003,135,70,65,26,9,17,24.29,0.243,0.193,0.138
200253,2003,435,252,183,70,16,54,21.43,0.214,0.161,0.087
200280,2003,2213,1039,1174,511,244,267,25.7,0.257,0.231,0.208
200332,2003,1944,902,1042,423,178,245,27.16,0.272,0.218,0.171
200572,2003,159,71,88,36,15,21,29.58,0.296,0.226,0.17
201104,2003,605,379,226,275,76,199,52.51,0.525,0.455,0.336
201371,2003,236,143,93,133,51,82,57.34,0.573,0.564,0.548
201548,2003,565,352,213,284,100,184,52.27,0.523,0.503,0.469
201645,2003,874,350,524,552,292,260,74.29,0.743,0.632,0.557
201690,2003,542,277,265,43,10,33,11.91,0.119,0.079,0.038
202134,2003,925,463,462,65,34,31,6.7,0.067,0.07,0.074
202480,2003,1858,956,902,1084,431,653,68.31,0.683,0.583,0.478
202523,2003,629,358,271,502,199,303,84.64,0.846,0.798,0.734
202763,2003,671,441,230,260,72,188,42.63,0.426,0.387,0.313
203085,2003,298,142,156,116,43,73,51.41,0.514,0.389,0.276
203128,2003,236,127,109,151,59,92,72.44,0.724,0.64,0.541
203368,2003,859,453,406,543,226,317,69.98,0.7,0.632,0.557
203517,2003,3746,2293,1453,895,266,629,27.43,0.274,0.239,0.183
203535,2003,453,247,206,386,176,210,85.02,0.85,0.852,0.854
203580,2003,120,86,34,41,13,28,32.56,0.326,0.342,0.382
203775,2003,389,238,151,173,48,125,52.52,0.525,0.445,0.318
203845,2003,376,168,208,160,70,90,53.57,0.536,0.426,0.337
204024,2003,3362,1844,1518,2371,1002,1369,74.24,0.742,0.705,0.66
204185,2003,579,276,303,287,114,173,62.68,0.627,0.496,0.376
204194,2003,373,221,152,137,51,86,38.91,0.389,0.367,0.336
204617,2003,296,191,105,88,27,61,31.94,0.319,0.297,0.257
204796,2003,6347,3201,3146,2938,1132,1806,56.42,0.564,0.463,0.36
204857,2003,3587,2026,1561,1722,638,1084,53.5,0.535,0.48,0.409
206330,2003,216,72,144,27,6,21,29.17,0.292,0.125,0.042
206589,2003,552,281,271,373,169,204,72.6,0.726,0.676,0.624
206604,2003,2272,1312,960,78,16,62,4.73,0.047,0.034,0.017
206622,2003,786,428,358,526,230,296,69.16,0.692,0.669,0.642
206695,2003,1976,1048,928,207,73,134,12.79,0.128,0.105,0.079
206914,2003,667,375,292,34,15,19,5.07,0.051,0.051,0.051
207209,2003,553,256,297,23,9,14,5.47,0.055,0.042,0.03
207306,2003,308,139,169,45,20,25,17.99,0.18,0.146,0.118
207324,2003,356,199,157,99,38,61,30.65,0.306,0.278,0.242
207388,2003,3128,1666,1462,958,336,622,37.33,0.373,0.306,0.23
207500,2003,3729,1921,1808,1100,406,694,36.13,0.361,0.295,0.225
207722,2003,282,172,110,54,11,43,25,0.25,0.191,0.1
207847,2003,651,339,312,70,27,43,12.68,0.127,0.108,0.087
207865,2003,980,492,488,119,38,81,16.46,0.165,0.121,0.078
208822,2003,336,203,133,177,73,104,51.23,0.512,0.527,0.549
209056,2003,493,308,185,352,127,225,73.05,0.731,0.714,0.686
209065,2003,448,243,205,286,101,185,76.13,0.761,0.638,0.493
209542,2003,2862,1371,1491,811,321,490,35.74,0.357,0.283,0.215
209551,2003,2826,1594,1232,1300,519,781,49,0.49,0.46,0.421
209612,2003,303,174,129,158,58,100,57.47,0.575,0.521,0.45
209807,2003,1264,668,596,159,55,104,15.57,0.156,0.126,0.092
209922,2003,297,153,144,169,74,95,62.09,0.621,0.569,0.514
210146,2003,896,497,399,158,51,107,21.53,0.215,0.176,0.128
210401,2003,541,312,229,383,143,240,76.92,0.769,0.708,0.624
210429,2003,903,555,348,144,37,107,19.28,0.193,0.159,0.106
210571,2003,456,259,197,252,96,156,60.23,0.602,0.553,0.487
210669,2003,478,234,244,317,143,174,74.36,0.744,0.663,0.586
210775,2003,278,165,113,99,32,67,40.61,0.406,0.356,0.283
211088,2003,489,360,129,259,77,182,50.56,0.506,0.53,0.597
211158,2003,1665,1000,665,677,201,476,47.6,0.476,0.407,0.302
211291,2003,906,462,444,794,374,420,90.91,0.909,0.876,0.842
211352,2003,401,270,131,184,55,129,47.78,0.478,0.459,0.42
211361,2003,982,520,462,251,105,146,28.08,0.281,0.256,0.227
211431,2003,236,229,7,71,3,68,29.69,0.297,0.301,0.429
211440,2003,1338,528,810,903,532,371,70.27,0.703,0.675,0.657
211468,2003,233,233,0,105,0,105,45.06,0.451,0.451,NA
211556,2003,74,74,0,38,0,38,51.35,0.514,0.514,NA
211583,2003,188,125,63,66,19,47,37.6,0.376,0.351,0.302
211608,2003,378,208,170,51,13,38,18.27,0.183,0.135,0.076
211644,2003,1219,729,490,366,113,253,34.71,0.347,0.3,0.231
211981,2003,438,198,240,164,70,94,47.47,0.475,0.374,0.292
212009,2003,624,356,268,496,205,291,81.74,0.817,0.795,0.765
212054,2003,1980,768,1212,486,176,310,40.36,0.404,0.245,0.145
212106,2003,1485,899,586,774,283,491,54.62,0.546,0.521,0.483
212115,2003,1076,650,426,394,107,287,44.15,0.442,0.366,0.251
212133,2003,438,298,140,242,74,168,56.38,0.564,0.553,0.529
212160,2003,1392,818,574,304,103,201,24.57,0.246,0.218,0.179
212197,2003,495,326,169,328,100,228,69.94,0.699,0.663,0.592
212577,2003,503,233,270,398,198,200,85.84,0.858,0.791,0.733
212601,2003,587,339,248,246,91,155,45.72,0.457,0.419,0.367
212832,2003,322,245,77,105,26,79,32.24,0.322,0.326,0.338
212911,2003,313,164,149,275,132,143,87.2,0.872,0.879,0.886
213020,2003,2847,1669,1178,822,242,580,34.75,0.348,0.289,0.205
213251,2003,381,200,181,284,135,149,74.5,0.745,0.745,0.746
213321,2003,448,166,282,284,164,120,72.29,0.723,0.634,0.582
213349,2003,1825,1035,790,549,158,391,37.78,0.378,0.301,0.2
213358,2003,174,124,50,58,13,45,36.29,0.363,0.333,0.26
213367,2003,809,423,386,461,204,257,60.76,0.608,0.57,0.528
213385,2003,584,268,316,502,267,235,87.69,0.877,0.86,0.845
213507,2003,429,231,198,292,119,173,74.89,0.749,0.681,0.601
213543,2003,1124,448,676,854,487,367,81.92,0.819,0.76,0.72
213613,2003,1145,657,488,316,104,212,32.27,0.323,0.276,0.213
213668,2003,381,226,155,254,97,157,69.47,0.695,0.667,0.626
213783,2003,690,403,287,179,74,105,26.05,0.26,0.259,0.258
213826,2003,277,199,78,152,34,118,59.3,0.593,0.549,0.436
213996,2003,735,463,272,529,189,340,73.43,0.734,0.72,0.695
214041,2003,1334,754,580,478,159,319,42.31,0.423,0.358,0.274
214069,2003,313,233,80,206,49,157,67.38,0.674,0.658,0.613
214157,2003,379,239,140,270,90,180,75.31,0.753,0.712,0.643
214175,2003,589,354,235,485,179,306,86.44,0.864,0.823,0.762
214272,2003,510,327,183,209,72,137,41.9,0.419,0.41,0.393
214777,2003,6035,3058,2977,3747,1598,2149,70.27,0.703,0.621,0.537
215062,2003,2378,1221,1157,2082,992,1090,89.27,0.893,0.876,0.857
215743,2003,332,200,132,174,63,111,55.5,0.555,0.524,0.477
215798,2003,362,196,166,221,91,130,66.33,0.663,0.61,0.548
215929,2003,974,538,436,716,307,409,76.02,0.76,0.735,0.704
216010,2003,1485,742,743,666,271,395,53.23,0.532,0.448,0.365
216038,2003,1465,803,662,455,158,297,36.99,0.37,0.311,0.239
216287,2003,368,198,170,316,141,175,88.38,0.884,0.859,0.829
216339,2003,3590,2106,1484,1232,459,773,36.7,0.367,0.343,0.309
216524,2003,453,233,220,356,163,193,82.83,0.828,0.786,0.741
216694,2003,327,157,170,157,70,87,55.41,0.554,0.48,0.412
216764,2003,1723,1119,604,685,152,533,47.63,0.476,0.398,0.252
216807,2003,337,206,131,200,61,139,67.48,0.675,0.593,0.466
216852,2003,578,286,292,237,90,147,51.4,0.514,0.41,0.308
216931,2003,509,235,274,254,107,147,62.55,0.625,0.499,0.391
217059,2003,1013,541,472,425,171,254,46.95,0.47,0.42,0.362
217156,2003,1392,736,656,1192,539,653,88.72,0.887,0.856,0.822
217402,2003,975,561,414,823,339,484,86.27,0.863,0.844,0.819
217536,2003,571,401,170,361,91,270,67.33,0.673,0.632,0.535
217776,2003,160,100,60,41,17,24,24,0.24,0.256,0.283
217819,2003,1868,1229,639,896,251,645,52.48,0.525,0.48,0.393
217882,2003,2748,1293,1455,1379,535,844,65.27,0.653,0.502,0.368
217998,2003,176,102,74,111,43,68,66.67,0.667,0.631,0.581
218061,2003,765,447,318,153,48,105,23.49,0.235,0.2,0.151
218229,2003,541,356,185,139,30,109,30.62,0.306,0.257,0.162
218238,2003,176,98,78,35,15,20,20.41,0.204,0.199,0.192
218399,2003,276,168,108,46,9,37,22.02,0.22,0.167,0.083
218414,2003,203,69,134,64,36,28,40.58,0.406,0.315,0.269
218663,2003,3441,1949,1492,1578,586,992,50.9,0.509,0.459,0.393
218724,2003,1266,618,648,283,109,174,28.16,0.282,0.224,0.168
218733,2003,794,453,341,106,33,73,16.11,0.161,0.134,0.097
218742,2003,684,450,234,139,35,104,23.11,0.231,0.203,0.15
218973,2003,330,163,167,255,127,128,78.53,0.785,0.773,0.76
219000,2003,424,281,143,217,61,156,55.52,0.555,0.512,0.427
219046,2003,653,409,244,62,17,45,11,0.11,0.095,0.07
219082,2003,290,120,170,43,18,25,20.83,0.208,0.148,0.106
219198,2003,158,113,45,33,11,22,19.47,0.195,0.209,0.244
219259,2003,380,210,170,59,16,43,20.48,0.205,0.155,0.094
219356,2003,1993,957,1036,427,176,251,26.23,0.262,0.214,0.17
219471,2003,982,539,443,186,76,110,20.41,0.204,0.189,0.172
219602,2003,967,609,358,118,33,85,13.96,0.14,0.122,0.092
219709,2003,599,360,239,312,110,202,56.11,0.561,0.521,0.46
219718,2003,129,59,70,27,10,17,28.81,0.288,0.209,0.143
219949,2003,149,76,73,24,9,15,19.74,0.197,0.161,0.123
220075,2003,1563,921,642,301,99,202,21.93,0.219,0.193,0.154
220215,2003,374,211,163,138,53,85,40.28,0.403,0.369,0.325
220613,2003,646,393,253,197,66,131,33.33,0.333,0.305,0.261
220631,2003,183,129,54,33,7,26,20.16,0.202,0.18,0.13
220710,2003,293,140,153,133,51,82,58.57,0.586,0.454,0.333
221351,2003,456,274,182,343,140,203,74.09,0.741,0.752,0.769
221519,2003,426,239,187,318,142,176,73.64,0.736,0.746,0.759
221731,2003,106,63,43,33,4,29,46.03,0.46,0.311,0.093
221847,2003,1374,577,797,300,133,167,28.94,0.289,0.218,0.167
221892,2003,219,126,93,82,31,51,40.48,0.405,0.374,0.333
222178,2003,948,489,459,369,125,244,49.9,0.499,0.389,0.272
222983,2003,338,193,145,228,86,142,73.58,0.736,0.675,0.593
223232,2003,2667,1673,994,1266,347,919,54.93,0.549,0.475,0.349
224004,2003,154,83,71,26,13,13,15.66,0.157,0.169,0.183
224323,2003,299,189,110,185,58,127,67.2,0.672,0.619,0.527
225432,2003,1012,559,453,16,5,11,1.97,0.02,0.016,0.011
225548,2003,293,136,157,76,27,49,36.03,0.36,0.259,0.172
225627,2003,396,280,116,70,18,52,18.57,0.186,0.177,0.155
226231,2003,333,94,239,93,52,41,43.62,0.436,0.279,0.218
226833,2003,613,302,311,41,18,23,7.62,0.076,0.067,0.058
227216,2003,3320,1945,1375,632,194,438,22.52,0.225,0.19,0.141
227331,2003,322,238,84,60,10,50,21.01,0.21,0.186,0.119
227526,2003,1553,820,733,175,71,104,12.68,0.127,0.113,0.097
227757,2003,716,364,352,591,279,312,85.71,0.857,0.825,0.793
227845,2003,544,327,217,239,78,161,49.24,0.492,0.439,0.359
227863,2003,292,172,120,87,33,54,31.4,0.314,0.298,0.275
228042,2003,168,88,80,40,14,26,29.55,0.296,0.238,0.175
228149,2003,470,292,178,147,41,106,36.3,0.363,0.313,0.23
228246,2003,1383,772,611,853,324,529,68.52,0.685,0.617,0.53
228343,2003,343,196,147,234,80,154,78.57,0.786,0.682,0.544
228431,2003,1839,1148,691,348,88,260,22.65,0.226,0.189,0.127
228459,2003,2818,1681,1137,667,195,472,28.08,0.281,0.237,0.172
228501,2003,357,163,194,30,11,19,11.66,0.117,0.084,0.057
228529,2003,1277,686,591,201,62,139,20.26,0.203,0.157,0.105
228705,2003,828,370,458,60,24,36,9.73,0.097,0.072,0.052
228723,2003,6389,3358,3031,2898,981,1917,57.09,0.571,0.454,0.324
228769,2003,2431,1182,1249,364,144,220,18.61,0.186,0.15,0.115
228778,2003,6477,3537,2940,3300,1309,1991,56.29,0.563,0.509,0.445
228787,2003,1043,420,623,446,242,204,48.57,0.486,0.428,0.388
228796,2003,2386,1237,1149,111,46,65,5.25,0.052,0.047,0.04
228875,2003,1598,1005,593,877,273,604,60.1,0.601,0.549,0.46
228981,2003,375,212,163,117,38,79,37.26,0.373,0.312,0.233
229018,2003,292,160,132,52,19,33,20.62,0.206,0.178,0.144
229027,2003,4091,2070,2021,310,107,203,9.81,0.098,0.076,0.053
229115,2003,4312,2039,2273,1372,547,825,40.46,0.405,0.318,0.241
229780,2003,205,112,93,41,13,28,25,0.25,0.2,0.14
229814,2003,774,404,370,125,31,94,23.27,0.233,0.161,0.084
230603,2003,478,338,140,103,17,86,25.44,0.254,0.215,0.121
230728,2003,1829,1229,600,491,86,405,32.95,0.33,0.268,0.143
230764,2003,1870,1073,797,405,129,276,25.72,0.257,0.217,0.162
230782,2003,1688,944,744,90,31,59,6.25,0.062,0.053,0.042
231059,2003,512,263,249,362,158,204,77.57,0.776,0.707,0.635
231174,2003,1916,1089,827,1087,439,648,59.5,0.595,0.567,0.531
231420,2003,219,83,136,78,34,44,53.01,0.53,0.356,0.25
231554,2003,83,50,33,27,10,17,34,0.34,0.325,0.303
231624,2003,1319,736,583,1098,439,659,89.54,0.895,0.832,0.753
231712,2003,1205,619,586,475,176,299,48.3,0.483,0.394,0.3
232025,2003,223,106,117,96,43,53,50,0.5,0.43,0.368
232043,2003,195,121,74,94,32,62,51.24,0.512,0.482,0.432
232089,2003,301,106,195,71,37,34,32.08,0.321,0.236,0.19
232186,2003,2191,1166,1025,847,284,563,48.28,0.483,0.387,0.277
232265,2003,1379,873,506,506,131,375,42.96,0.43,0.367,0.259
232423,2003,3386,2167,1219,2220,697,1523,70.28,0.703,0.656,0.572
232557,2003,1811,1024,787,506,190,316,30.86,0.309,0.279,0.241
232566,2003,872,576,296,340,91,249,43.23,0.432,0.39,0.307
232609,2003,589,342,247,316,116,200,58.48,0.585,0.537,0.47
232681,2003,879,572,307,590,181,409,71.5,0.715,0.671,0.59
232706,2003,379,290,89,158,30,128,44.14,0.441,0.417,0.337
232937,2003,1080,593,487,123,41,82,13.83,0.138,0.114,0.084
232982,2003,2001,1139,862,457,136,321,28.18,0.282,0.228,0.158
233277,2003,1800,1097,703,719,214,505,46.03,0.46,0.399,0.304
233374,2003,835,440,395,688,313,375,85.23,0.852,0.824,0.792
233426,2003,519,282,237,301,130,171,60.64,0.606,0.58,0.549
233541,2003,328,185,143,106,34,72,38.92,0.389,0.323,0.238
233897,2003,349,177,172,109,39,70,39.55,0.395,0.312,0.227
233921,2003,4923,2092,2831,2588,1213,1375,65.73,0.657,0.526,0.428
234030,2003,3230,1912,1318,779,218,561,29.34,0.293,0.241,0.165
234085,2003,384,36,348,246,223,23,63.89,0.639,0.641,0.641
234155,2003,959,563,396,240,62,178,31.62,0.316,0.25,0.157
234164,2003,512,318,194,99,16,83,26.1,0.261,0.193,0.082
235097,2003,1374,843,531,295,81,214,25.39,0.254,0.215,0.153
235167,2003,454,246,208,193,98,95,38.62,0.386,0.425,0.471
236230,2003,693,426,267,361,118,243,57.04,0.57,0.521,0.442
236328,2003,639,358,281,438,164,274,76.54,0.765,0.685,0.584
236577,2003,683,485,198,410,105,305,62.89,0.629,0.6,0.53
236595,2003,619,418,201,323,75,248,59.33,0.593,0.522,0.373
236896,2003,326,157,169,66,31,35,22.29,0.223,0.202,0.183
236939,2003,2997,1613,1384,1204,417,787,48.79,0.488,0.402,0.301
236948,2003,4948,2654,2294,2665,1106,1559,58.74,0.587,0.539,0.482
237011,2003,2194,1266,928,778,233,545,43.05,0.43,0.355,0.251
237057,2003,362,182,180,294,144,150,82.42,0.824,0.812,0.8
237066,2003,438,259,179,267,105,162,62.55,0.625,0.61,0.587
237215,2003,273,155,118,15,7,8,5.16,0.052,0.055,0.059
237330,2003,508,286,222,98,29,69,24.13,0.241,0.193,0.131
237358,2003,104,60,44,27,8,19,31.67,0.317,0.26,0.182
237367,2003,631,317,314,85,31,54,17.03,0.17,0.135,0.099
237792,2003,768,440,328,134,48,86,19.55,0.196,0.174,0.146
237899,2003,333,187,146,20,6,14,7.49,0.075,0.06,0.041
237932,2003,453,248,205,69,16,53,21.37,0.214,0.152,0.078
237969,2003,457,257,200,197,64,133,51.75,0.517,0.431,0.32
238032,2003,4366,2104,2262,1387,583,804,38.21,0.382,0.318,0.258
238333,2003,346,217,129,251,88,163,75.12,0.751,0.725,0.682
238430,2003,205,136,69,28,11,17,12.5,0.125,0.137,0.159
238458,2003,501,329,172,220,62,158,48.02,0.48,0.439,0.36
238476,2003,575,307,268,249,103,146,47.56,0.476,0.433,0.384
238616,2003,352,192,160,111,35,76,39.58,0.396,0.315,0.219
238661,2003,307,229,78,85,14,71,31,0.31,0.277,0.179
239080,2003,251,170,81,72,17,55,32.35,0.324,0.287,0.21
239105,2003,1882,1042,840,1125,462,663,63.63,0.636,0.598,0.55
239628,2003,259,130,129,156,72,84,64.62,0.646,0.602,0.558
239716,2003,529,289,240,336,128,208,71.97,0.72,0.635,0.533
240107,2003,355,261,94,107,18,89,34.1,0.341,0.301,0.191
240189,2003,1825,975,850,459,199,260,26.67,0.267,0.252,0.234
240277,2003,960,640,320,241,70,171,26.72,0.267,0.251,0.219
240329,2003,1506,984,522,507,153,354,35.98,0.36,0.337,0.293
240338,2003,207,126,81,110,31,79,62.7,0.627,0.531,0.383
240365,2003,1765,1077,688,261,67,194,18.01,0.18,0.148,0.097
240374,2003,863,469,394,68,27,41,8.74,0.087,0.079,0.069
240417,2003,1267,654,613,244,75,169,25.84,0.258,0.193,0.122
240426,2003,336,213,123,66,14,52,24.41,0.244,0.196,0.114
240444,2003,5553,2968,2585,2689,1114,1575,53.07,0.531,0.484,0.431
240453,2003,3716,2023,1693,552,217,335,16.56,0.166,0.149,0.128
240462,2003,1116,406,710,203,105,98,24.14,0.241,0.182,0.148
240471,2003,1220,757,463,305,98,207,27.34,0.273,0.25,0.212
240480,2003,1498,853,645,335,101,234,27.43,0.274,0.224,0.157
240727,2003,1388,709,679,310,102,208,29.34,0.293,0.223,0.15
243443,2003,425,274,151,10,3,7,2.55,0.025,0.024,0.02
243780,2003,6459,2559,3900,2254,1121,1133,44.28,0.443,0.349,0.287
100654,2004,1198,611,587,146,31,115,18.82,0.188,0.122,0.053
100663,2004,1536,973,563,284,82,202,20.76,0.208,0.185,0.146
100751,2004,3290,1853,1437,1248,426,822,44.36,0.444,0.379,0.296
100858,2004,3579,1849,1730,1279,445,834,45.11,0.451,0.357,0.257
101435,2004,192,72,120,71,38,33,45.83,0.458,0.37,0.317
101480,2004,1017,555,462,91,20,71,12.79,0.128,0.089,0.043
101675,2004,427,203,224,49,9,40,19.7,0.197,0.115,0.04
101879,2004,856,469,387,107,27,80,17.06,0.171,0.125,0.07
102049,2004,665,423,242,359,111,248,58.63,0.586,0.54,0.459
102094,2004,1278,725,553,180,60,120,16.55,0.166,0.141,0.108
102234,2004,309,203,106,156,44,112,55.17,0.552,0.505,0.415
102368,2004,1450,788,662,230,67,163,20.69,0.207,0.159,0.101
102377,2004,701,389,312,123,35,88,22.62,0.226,0.175,0.112
104151,2004,7293,3998,3295,2324,816,1508,37.72,0.377,0.319,0.248
104179,2004,5566,3008,2558,1880,723,1157,38.46,0.385,0.338,0.283
105330,2004,2274,1309,965,652,190,462,35.29,0.353,0.287,0.197
106245,2004,759,452,307,54,18,36,7.96,0.08,0.071,0.059
106342,2004,141,66,75,62,37,25,37.88,0.379,0.44,0.493
106397,2004,2420,1222,1198,835,329,506,41.41,0.414,0.345,0.275
106412,2004,690,365,325,47,14,33,9.04,0.09,0.068,0.043
106458,2004,1296,749,547,212,71,141,18.83,0.188,0.164,0.13
106467,2004,1398,728,670,199,72,127,17.45,0.174,0.142,0.107
106485,2004,629,327,302,60,25,35,10.7,0.107,0.095,0.083
106704,2004,2216,1313,903,468,131,337,25.67,0.257,0.211,0.145
107044,2004,961,516,445,387,161,226,43.8,0.438,0.403,0.362
107080,2004,295,165,130,159,69,90,54.55,0.545,0.539,0.531
107141,2004,296,156,140,155,67,88,56.41,0.564,0.524,0.479
107512,2004,380,223,157,170,49,121,54.26,0.543,0.447,0.312
107558,2004,134,74,60,44,18,26,35.14,0.351,0.328,0.3
110097,2004,691,443,248,346,120,226,51.02,0.51,0.501,0.484
110404,2004,207,59,148,167,117,50,84.75,0.848,0.807,0.791
110422,2004,2900,1169,1731,767,304,463,39.61,0.396,0.264,0.176
110486,2004,745,483,262,128,32,96,19.88,0.199,0.172,0.122
110495,2004,653,456,197,153,41,112,24.56,0.246,0.234,0.208
110510,2004,1587,1099,488,208,53,155,14.1,0.141,0.131,0.109
110529,2004,2115,921,1194,412,188,224,24.32,0.243,0.195,0.157
110538,2004,2198,1266,932,436,102,334,26.38,0.264,0.198,0.109
110547,2004,673,459,214,35,10,25,5.45,0.054,0.052,0.047
110556,2004,2243,1351,892,378,102,276,20.43,0.204,0.169,0.114
110565,2004,3539,2094,1445,583,148,435,20.77,0.208,0.165,0.102
110574,2004,840,516,324,122,38,84,16.28,0.163,0.145,0.117
110583,2004,3300,2222,1078,406,103,303,13.64,0.136,0.123,0.096
110592,2004,1087,687,400,87,22,65,9.46,0.095,0.08,0.055
110617,2004,2268,1375,893,240,57,183,13.31,0.133,0.106,0.064
113698,2004,276,205,71,119,24,95,46.34,0.463,0.431,0.338
115755,2004,760,427,333,66,18,48,11.24,0.112,0.087,0.054
119173,2004,364,352,12,93,4,89,25.28,0.253,0.255,0.333
120184,2004,161,108,53,68,19,49,45.37,0.454,0.422,0.358
121309,2004,535,339,196,395,141,254,74.93,0.749,0.738,0.719
121345,2004,393,196,197,356,181,175,89.29,0.893,0.906,0.919
122409,2004,3527,2128,1399,1073,307,766,36,0.36,0.304,0.219
122436,2004,1174,705,469,706,259,447,63.4,0.634,0.601,0.552
122597,2004,2739,1770,969,390,114,276,15.59,0.156,0.142,0.118
122612,2004,929,614,315,518,151,367,59.77,0.598,0.558,0.479
122931,2004,1171,658,513,941,392,549,83.43,0.834,0.804,0.764
123554,2004,603,388,215,319,102,217,55.93,0.559,0.529,0.474
123572,2004,1102,713,389,344,76,268,37.59,0.376,0.312,0.195
126562,2004,686,387,299,101,34,67,17.31,0.173,0.147,0.114
126580,2004,939,562,377,198,54,144,25.62,0.256,0.211,0.143
126614,2004,5124,2484,2640,2093,909,1184,47.67,0.477,0.408,0.344
126818,2004,4047,2216,1831,1484,522,962,43.41,0.434,0.367,0.285
127060,2004,1124,588,536,633,286,347,59.01,0.59,0.563,0.534
127185,2004,930,448,482,181,67,114,25.45,0.254,0.195,0.139
127565,2004,1815,937,878,86,34,52,5.55,0.056,0.047,0.039
127741,2004,2412,1459,953,648,190,458,31.39,0.314,0.269,0.199
128106,2004,753,423,330,118,34,84,19.86,0.199,0.157,0.103
128744,2004,241,134,107,47,19,28,20.9,0.209,0.195,0.178
128771,2004,1278,596,682,213,80,133,22.32,0.223,0.167,0.117
129020,2004,3229,1789,1440,2104,830,1274,71.21,0.712,0.652,0.576
129242,2004,856,475,381,679,282,397,83.58,0.836,0.793,0.74
129941,2004,571,264,307,197,111,86,32.58,0.326,0.345,0.362
130253,2004,876,521,355,528,196,332,63.72,0.637,0.603,0.552
130314,2004,189,189,0,56,0,56,29.63,0.296,0.296,NA
130493,2004,1396,899,497,219,46,173,19.24,0.192,0.157,0.093
130590,2004,569,283,286,442,213,229,80.92,0.809,0.777,0.745
130697,2004,728,385,343,649,300,349,90.65,0.907,0.891,0.875
130776,2004,755,382,373,120,53,67,17.54,0.175,0.159,0.142
130794,2004,1306,632,674,1161,589,572,90.51,0.905,0.889,0.874
130934,2004,687,400,287,133,23,110,27.5,0.275,0.194,0.08
130943,2004,3769,2173,1596,2131,776,1355,62.36,0.624,0.565,0.486
131159,2004,1210,776,434,902,306,596,76.8,0.768,0.745,0.705
131283,2004,719,387,332,429,182,247,63.82,0.638,0.597,0.548
131450,2004,227,121,106,18,8,10,8.26,0.083,0.079,0.075
131469,2004,2623,1441,1182,1957,830,1127,78.21,0.782,0.746,0.702
131496,2004,1523,855,668,1358,574,784,91.7,0.917,0.892,0.859
131520,2004,1445,987,458,691,151,540,54.71,0.547,0.478,0.33
132471,2004,553,349,204,101,29,72,20.63,0.206,0.183,0.142
132602,2004,818,503,315,118,29,89,17.69,0.177,0.144,0.092
132903,2004,5710,3041,2669,1986,723,1263,41.53,0.415,0.348,0.271
133492,2004,471,272,199,297,119,178,65.44,0.654,0.631,0.598
133553,2004,933,139,794,282,231,51,36.69,0.367,0.302,0.291
133650,2004,2105,1242,863,268,73,195,15.7,0.157,0.127,0.085
133669,2004,2278,1231,1047,364,122,242,19.66,0.197,0.16,0.117
133711,2004,500,296,204,250,98,152,51.35,0.514,0.5,0.48
133881,2004,551,181,370,218,132,86,47.51,0.475,0.396,0.357
133951,2004,3370,1906,1464,647,198,449,23.56,0.236,0.192,0.135
134079,2004,553,342,211,227,70,157,45.91,0.459,0.41,0.332
134097,2004,6198,3727,2471,3112,1029,2083,55.89,0.559,0.502,0.416
134130,2004,6621,3706,2915,3933,1418,2515,67.86,0.679,0.594,0.486
134945,2004,462,197,265,118,59,59,29.95,0.3,0.255,0.223
135726,2004,2025,1157,868,1381,551,830,71.74,0.717,0.682,0.635
136172,2004,2199,1252,947,447,116,331,26.44,0.264,0.203,0.122
136950,2004,486,284,202,285,116,169,59.51,0.595,0.586,0.574
137546,2004,598,354,244,303,100,203,57.34,0.573,0.507,0.41
138354,2004,859,475,384,168,57,111,23.37,0.234,0.196,0.148
138716,2004,602,399,203,98,22,76,19.05,0.19,0.163,0.108
138789,2004,776,449,327,70,21,49,10.91,0.109,0.09,0.064
139144,2004,514,349,165,261,76,185,53.01,0.53,0.508,0.461
139366,2004,972,584,388,116,31,85,14.55,0.146,0.119,0.08
139393,2004,260,156,104,123,41,82,52.56,0.526,0.473,0.394
139658,2004,1587,911,676,1044,436,608,66.74,0.667,0.658,0.645
139719,2004,456,227,229,66,18,48,21.15,0.212,0.145,0.079
139755,2004,2572,766,1806,845,514,331,43.21,0.432,0.329,0.285
139764,2004,359,247,112,40,6,34,13.77,0.138,0.111,0.054
139861,2004,918,582,336,322,90,232,39.86,0.399,0.351,0.268
139931,2004,2982,1393,1589,546,158,388,27.85,0.278,0.183,0.099
139940,2004,2272,1338,934,389,132,257,19.21,0.192,0.171,0.141
139959,2004,4500,2724,1776,2335,774,1561,57.31,0.573,0.519,0.436
140447,2004,632,373,259,270,90,180,48.26,0.483,0.427,0.347
140960,2004,568,316,252,73,22,51,16.14,0.161,0.129,0.087
140988,2004,226,128,98,95,31,64,50,0.5,0.42,0.316
141185,2004,161,98,63,67,20,47,47.96,0.48,0.416,0.317
141264,2004,1690,969,721,279,78,201,20.74,0.207,0.165,0.108
141334,2004,1702,976,726,202,67,135,13.83,0.138,0.119,0.092
141486,2004,247,167,80,62,21,41,24.55,0.246,0.251,0.262
141565,2004,412,225,187,50,18,32,14.22,0.142,0.121,0.096
141574,2004,1892,1039,853,325,109,216,20.79,0.208,0.172,0.128
142276,2004,983,522,461,63,18,45,8.62,0.086,0.064,0.039
142285,2004,1602,755,847,383,147,236,31.26,0.313,0.239,0.174
142461,2004,247,159,88,99,28,71,44.65,0.446,0.401,0.318
143084,2004,599,321,278,426,178,248,77.26,0.773,0.711,0.64
143288,2004,176,87,89,55,23,32,36.78,0.368,0.312,0.258
144005,2004,563,367,196,17,13,4,1.09,0.011,0.03,0.066
144281,2004,1744,873,871,449,217,232,26.58,0.266,0.257,0.249
144740,2004,2304,1367,937,1097,377,720,52.67,0.527,0.476,0.402
144892,2004,1725,1032,693,594,177,417,40.41,0.404,0.344,0.255
144962,2004,386,225,161,215,66,149,66.22,0.662,0.557,0.41
144971,2004,116,57,59,35,15,20,35.09,0.351,0.302,0.254
145600,2004,2671,1488,1183,681,278,403,27.08,0.271,0.255,0.235
145619,2004,301,151,150,121,53,68,45.03,0.45,0.402,0.353
145637,2004,7225,3555,3670,4848,2215,2633,74.06,0.741,0.671,0.604
145691,2004,258,136,122,135,49,86,63.24,0.632,0.523,0.402
145813,2004,2824,1739,1085,1280,392,888,51.06,0.511,0.453,0.361
146481,2004,405,247,158,257,83,174,70.45,0.705,0.635,0.525
146612,2004,509,275,234,186,81,105,38.18,0.382,0.365,0.346
146719,2004,1787,1176,611,856,296,560,47.62,0.476,0.479,0.484
146825,2004,152,74,78,37,17,20,27.03,0.27,0.243,0.218
147013,2004,337,134,203,122,55,67,50,0.5,0.362,0.271
147244,2004,530,302,228,268,99,169,55.96,0.56,0.506,0.434
147341,2004,389,227,162,169,59,110,48.46,0.485,0.434,0.364
147703,2004,2933,1585,1348,807,334,473,29.84,0.298,0.275,0.248
147767,2004,1914,1030,884,1652,728,924,89.71,0.897,0.863,0.824
147776,2004,972,580,392,37,7,30,5.17,0.052,0.038,0.018
147828,2004,699,427,272,338,97,241,56.44,0.564,0.484,0.357
148131,2004,228,124,104,75,27,48,38.71,0.387,0.329,0.26
148496,2004,271,181,90,156,41,115,63.54,0.635,0.576,0.456
148584,2004,157,94,63,64,21,43,45.74,0.457,0.408,0.333
148627,2004,406,259,147,130,44,86,33.2,0.332,0.32,0.299
149222,2004,2545,1053,1492,646,308,338,32.1,0.321,0.254,0.206
149231,2004,1695,986,709,485,162,323,32.76,0.328,0.286,0.228
149772,2004,2056,1025,1031,681,301,380,37.07,0.371,0.331,0.292
149781,2004,595,318,277,469,202,267,83.96,0.84,0.788,0.729
150066,2004,579,340,239,248,92,156,45.88,0.459,0.428,0.385
150136,2004,3662,1951,1711,1141,390,751,38.49,0.385,0.312,0.228
150145,2004,306,174,132,125,38,87,50,0.5,0.408,0.288
150163,2004,925,571,354,458,143,315,55.17,0.552,0.495,0.404
150400,2004,661,367,294,546,229,317,86.38,0.864,0.826,0.779
150534,2004,634,382,252,357,131,226,59.16,0.592,0.563,0.52
150668,2004,168,95,73,84,38,46,48.42,0.484,0.5,0.521
150941,2004,203,123,80,108,44,64,52.03,0.52,0.532,0.55
151102,2004,1553,859,694,103,29,74,8.61,0.086,0.066,0.042
151111,2004,2294,1371,923,226,80,146,10.65,0.107,0.099,0.087
151306,2004,2004,1196,808,269,71,198,16.56,0.166,0.134,0.088
151324,2004,1813,901,912,341,128,213,23.64,0.236,0.188,0.14
151333,2004,356,237,119,18,5,13,5.49,0.055,0.051,0.042
151342,2004,704,432,272,29,11,18,4.17,0.042,0.041,0.04
151351,2004,6300,3407,2893,3110,1273,1837,53.92,0.539,0.494,0.44
151360,2004,604,375,229,28,10,18,4.8,0.048,0.046,0.044
151379,2004,714,420,294,63,12,51,12.14,0.121,0.088,0.041
151388,2004,270,182,88,14,3,11,6.04,0.06,0.052,0.034
151777,2004,278,154,124,113,34,79,51.3,0.513,0.406,0.274
151786,2004,245,166,79,84,26,58,34.94,0.349,0.343,0.329
152080,2004,1987,947,1040,1789,914,875,92.4,0.924,0.9,0.879
152248,2004,954,492,462,55,24,31,6.3,0.063,0.058,0.052
152363,2004,246,145,101,128,37,91,62.76,0.628,0.52,0.366
152530,2004,476,265,211,334,134,200,75.47,0.755,0.702,0.635
152600,2004,746,376,370,446,201,245,65.16,0.652,0.598,0.543
153001,2004,331,173,158,150,63,87,50.29,0.503,0.453,0.399
153108,2004,441,223,218,260,118,142,63.68,0.637,0.59,0.541
153269,2004,782,462,320,408,162,246,53.25,0.532,0.522,0.506
153384,2004,434,237,197,363,155,208,87.76,0.878,0.836,0.787
153603,2004,3674,1618,2056,1348,572,776,47.96,0.48,0.367,0.278
153834,2004,661,387,274,435,183,252,65.12,0.651,0.658,0.668
154095,2004,1652,995,657,581,172,409,41.11,0.411,0.352,0.262
155089,2004,207,112,95,27,14,13,11.61,0.116,0.13,0.147
155317,2004,4182,2148,2034,1345,527,818,38.08,0.381,0.322,0.259
155335,2004,216,112,104,43,17,26,23.21,0.232,0.199,0.163
155399,2004,3282,1691,1591,823,270,553,32.7,0.327,0.251,0.17
155520,2004,249,117,132,84,40,44,37.61,0.376,0.337,0.303
155627,2004,79,30,49,23,11,12,40,0.4,0.291,0.224
155937,2004,136,52,84,36,19,17,32.69,0.327,0.265,0.226
156213,2004,302,183,119,160,68,92,50.27,0.503,0.53,0.571
156286,2004,407,271,136,225,58,167,61.62,0.616,0.553,0.426
156295,2004,400,209,191,201,84,117,55.98,0.56,0.502,0.44
156365,2004,381,178,203,102,39,63,35.39,0.354,0.268,0.192
156541,2004,418,190,228,104,36,68,35.79,0.358,0.249,0.158
156745,2004,354,192,162,205,73,132,68.75,0.688,0.579,0.451
157058,2004,346,196,150,37,8,29,14.8,0.148,0.107,0.053
157076,2004,210,93,117,64,25,39,41.94,0.419,0.305,0.214
157085,2004,3935,2097,1838,1276,486,790,37.67,0.377,0.324,0.264
157289,2004,2303,1197,1106,489,164,325,27.15,0.272,0.212,0.148
157386,2004,1307,737,570,125,39,86,11.67,0.117,0.096,0.068
157401,2004,1414,804,610,531,176,355,44.15,0.442,0.376,0.289
157447,2004,1915,1123,792,151,43,108,9.62,0.096,0.079,0.054
157535,2004,175,103,72,31,8,23,22.33,0.223,0.177,0.111
157951,2004,2918,1647,1271,456,155,301,18.28,0.183,0.156,0.122
158477,2004,282,190,92,145,42,103,54.21,0.542,0.514,0.457
159009,2004,1132,675,457,115,33,82,12.15,0.122,0.102,0.072
159391,2004,5692,3099,2593,1492,539,953,30.75,0.308,0.262,0.208
159647,2004,1644,730,914,432,189,243,33.29,0.333,0.263,0.207
159717,2004,1603,923,680,196,61,135,14.63,0.146,0.122,0.09
159966,2004,1574,939,635,146,44,102,10.86,0.109,0.093,0.069
160038,2004,1793,1084,709,187,55,132,12.18,0.122,0.104,0.078
160612,2004,2137,1250,887,210,68,142,11.36,0.114,0.098,0.077
160621,2004,1575,931,644,115,30,85,9.13,0.091,0.073,0.047
160658,2004,2643,1517,1126,345,101,244,16.08,0.161,0.131,0.09
161004,2004,470,235,235,421,212,209,88.94,0.889,0.896,0.902
161226,2004,510,342,168,196,46,150,43.86,0.439,0.384,0.274
161235,2004,166,85,81,17,2,15,17.65,0.176,0.102,0.025
161244,2004,80,54,26,14,3,11,20.37,0.204,0.175,0.115
161253,2004,1607,777,830,550,236,314,40.41,0.404,0.342,0.284
161554,2004,871,524,347,146,39,107,20.42,0.204,0.168,0.112
162007,2004,627,408,219,94,16,78,19.12,0.191,0.15,0.073
162210,2004,208,130,78,26,4,22,16.92,0.169,0.125,0.051
162283,2004,588,446,142,27,5,22,4.93,0.049,0.046,0.035
162584,2004,955,427,528,207,78,129,30.21,0.302,0.217,0.148
162654,2004,401,270,131,241,62,179,66.3,0.663,0.601,0.473
162760,2004,242,189,53,160,31,129,68.25,0.682,0.661,0.585
162928,2004,1127,525,602,928,480,448,85.33,0.853,0.823,0.797
163046,2004,951,579,372,726,277,449,77.55,0.775,0.763,0.745
163268,2004,1403,560,843,472,249,223,39.82,0.398,0.336,0.295
163286,2004,4174,2055,2119,2607,1173,1434,69.78,0.698,0.625,0.554
163453,2004,1336,750,586,153,32,121,16.13,0.161,0.115,0.055
163462,2004,391,243,148,270,99,171,70.37,0.704,0.691,0.669
163851,2004,981,536,445,457,148,309,57.65,0.577,0.466,0.333
163912,2004,431,233,198,303,122,181,77.68,0.777,0.703,0.616
164076,2004,2082,1376,706,835,229,606,44.04,0.44,0.401,0.324
164173,2004,561,378,183,252,81,171,45.24,0.452,0.449,0.443
164216,2004,304,185,119,205,71,134,72.43,0.724,0.674,0.597
164270,2004,357,196,161,237,100,137,69.9,0.699,0.664,0.621
164447,2004,321,167,154,83,35,48,28.74,0.287,0.259,0.227
164492,2004,189,107,82,69,32,37,34.58,0.346,0.365,0.39
164562,2004,633,364,269,447,170,277,76.1,0.761,0.706,0.632
165015,2004,761,417,344,655,287,368,88.25,0.883,0.861,0.834
165024,2004,1266,713,553,306,99,207,29.03,0.29,0.242,0.179
165334,2004,523,328,195,383,137,246,75,0.75,0.732,0.703
165662,2004,700,402,298,533,242,291,72.39,0.724,0.761,0.812
165671,2004,455,332,123,237,58,179,53.92,0.539,0.521,0.472
165820,2004,713,386,327,153,52,101,26.17,0.262,0.215,0.159
165866,2004,642,434,208,187,49,138,31.8,0.318,0.291,0.236
165936,2004,401,264,137,235,75,160,60.61,0.606,0.586,0.547
166027,2004,1638,823,815,1427,688,739,89.79,0.898,0.871,0.844
166124,2004,703,389,314,635,274,361,92.8,0.928,0.903,0.873
166513,2004,996,333,663,286,134,152,45.65,0.456,0.287,0.202
166629,2004,4311,2126,2185,2196,968,1228,57.76,0.578,0.509,0.443
166638,2004,543,323,220,61,12,49,15.17,0.152,0.112,0.055
166683,2004,1076,457,619,909,507,402,87.96,0.88,0.845,0.819
167288,2004,263,161,102,99,28,71,44.1,0.441,0.376,0.275
167987,2004,1456,715,741,416,147,269,37.62,0.376,0.286,0.198
167996,2004,614,384,230,494,171,323,84.11,0.841,0.805,0.743
168005,2004,1014,589,425,350,123,227,38.54,0.385,0.345,0.289
168148,2004,1273,635,638,1101,537,564,88.82,0.888,0.865,0.842
168254,2004,798,302,496,353,197,156,51.66,0.517,0.442,0.397
168281,2004,443,280,163,310,114,196,70,0.7,0.7,0.699
168342,2004,532,272,260,484,234,250,91.91,0.919,0.91,0.9
168546,2004,559,310,249,358,149,209,67.42,0.674,0.64,0.598
168786,2004,316,199,117,119,45,74,37.19,0.372,0.377,0.385
169080,2004,899,467,432,524,245,279,59.74,0.597,0.583,0.567
169798,2004,2281,1329,952,280,85,195,14.67,0.147,0.123,0.089
169910,2004,1924,834,1090,127,60,67,8.03,0.08,0.066,0.055
170082,2004,3324,2123,1201,875,270,605,28.5,0.285,0.263,0.225
170301,2004,780,463,317,531,194,337,72.79,0.728,0.681,0.612
170532,2004,310,188,122,240,86,154,81.91,0.819,0.774,0.705
170639,2004,527,242,285,67,27,40,16.53,0.165,0.127,0.095
170976,2004,6016,3033,2983,4334,1990,2344,77.28,0.773,0.72,0.667
171100,2004,7426,4073,3353,3531,1334,2197,53.94,0.539,0.475,0.398
171128,2004,1219,243,976,327,221,106,43.62,0.436,0.268,0.226
171137,2004,656,311,345,106,45,61,19.61,0.196,0.162,0.13
171146,2004,474,293,181,53,17,36,12.29,0.123,0.112,0.094
171599,2004,198,72,126,51,26,25,34.72,0.347,0.258,0.206
172051,2004,1209,720,489,129,32,97,13.47,0.135,0.107,0.065
172699,2004,3725,1872,1853,802,301,501,26.76,0.268,0.215,0.162
173160,2004,669,386,283,385,160,225,58.29,0.583,0.575,0.565
173258,2004,487,263,224,432,195,237,90.11,0.901,0.887,0.871
173328,2004,176,102,74,64,24,40,39.22,0.392,0.364,0.324
173647,2004,651,361,290,468,221,247,68.42,0.684,0.719,0.762
173902,2004,485,284,201,410,164,246,86.62,0.866,0.845,0.816
174066,2004,5562,3081,2481,2549,994,1555,50.47,0.505,0.458,0.401
174233,2004,2205,1153,1052,568,208,360,31.22,0.312,0.258,0.198
174251,2004,383,235,148,205,73,132,56.17,0.562,0.535,0.493
174491,2004,409,245,164,194,67,127,51.84,0.518,0.474,0.409
174792,2004,512,0,512,338,338,0,NA,NA,0.66,0.66
174844,2004,777,446,331,631,258,373,83.63,0.836,0.812,0.779
174899,2004,437,300,137,227,66,161,53.67,0.537,0.519,0.482
174914,2004,1161,608,553,710,312,398,65.46,0.655,0.612,0.564
175342,2004,572,309,263,116,33,83,26.86,0.269,0.203,0.125
175421,2004,237,144,93,94,28,66,45.83,0.458,0.397,0.301
175616,2004,381,211,170,76,24,52,24.64,0.246,0.199,0.141
175856,2004,995,587,408,200,50,150,25.55,0.256,0.201,0.123
175980,2004,278,136,142,170,83,87,63.97,0.64,0.612,0.585
176017,2004,2248,1185,1063,761,292,469,39.58,0.396,0.339,0.275
176035,2004,242,207,35,55,1,54,26.09,0.261,0.227,0.029
176044,2004,372,184,188,51,15,36,19.57,0.196,0.137,0.08
176080,2004,1735,829,906,492,193,299,36.07,0.361,0.284,0.213
176406,2004,278,190,88,68,16,52,27.37,0.274,0.245,0.182
176628,2004,129,88,41,39,3,36,40.91,0.409,0.302,0.073
176947,2004,193,86,107,64,21,43,50,0.5,0.332,0.196
176965,2004,1434,798,636,369,120,249,31.2,0.312,0.257,0.189
177418,2004,190,132,58,52,16,36,27.27,0.273,0.274,0.276
178059,2004,313,248,65,160,29,131,52.82,0.528,0.511,0.446
178341,2004,695,368,327,97,33,64,17.39,0.174,0.14,0.101
178387,2004,1021,573,448,109,26,83,14.49,0.145,0.107,0.058
178396,2004,4625,2442,2183,1993,765,1228,50.29,0.503,0.431,0.35
178402,2004,904,540,364,160,50,110,20.37,0.204,0.177,0.137
178411,2004,836,169,667,211,162,49,28.99,0.29,0.252,0.243
178420,2004,398,235,163,82,25,57,24.26,0.243,0.206,0.153
178615,2004,1477,872,605,631,228,403,46.22,0.462,0.427,0.377
179043,2004,305,176,129,184,76,108,61.36,0.614,0.603,0.589
179159,2004,1456,864,592,892,336,556,64.35,0.643,0.613,0.568
179557,2004,1386,823,563,334,98,236,28.68,0.287,0.241,0.174
179566,2004,2663,1572,1091,755,234,521,33.14,0.331,0.284,0.214
179867,2004,1436,725,711,1233,592,641,88.41,0.884,0.859,0.833
179894,2004,448,256,192,229,89,140,54.69,0.547,0.511,0.464
179946,2004,231,108,123,105,54,51,47.22,0.472,0.455,0.439
180179,2004,502,338,164,64,18,46,13.61,0.136,0.127,0.11
180461,2004,1998,836,1162,341,159,182,21.77,0.218,0.171,0.137
180522,2004,175,57,118,19,12,7,12.28,0.123,0.109,0.102
180984,2004,278,146,132,103,28,75,51.37,0.514,0.371,0.212
181002,2004,968,584,384,633,246,387,66.27,0.663,0.654,0.641
181020,2004,303,172,131,162,67,95,55.23,0.552,0.535,0.511
181127,2004,289,140,149,152,60,92,65.71,0.657,0.526,0.403
181215,2004,1061,589,472,238,85,153,25.98,0.26,0.224,0.18
181394,2004,1577,878,699,201,78,123,14.01,0.14,0.127,0.112
181446,2004,428,238,190,223,101,122,51.26,0.513,0.521,0.532
181464,2004,3236,1559,1677,950,394,556,35.66,0.357,0.294,0.235
181534,2004,217,114,103,21,5,16,14.04,0.14,0.097,0.049
181783,2004,552,310,242,128,39,89,28.71,0.287,0.232,0.161
182281,2004,3108,1760,1348,428,134,294,16.7,0.167,0.138,0.099
182290,2004,2132,1157,975,289,104,185,15.99,0.16,0.136,0.107
182634,2004,263,179,84,140,42,98,54.75,0.547,0.532,0.5
182795,2004,568,285,283,232,97,135,47.37,0.474,0.408,0.343
183062,2004,1068,649,419,425,148,277,42.68,0.427,0.398,0.353
183080,2004,1052,524,528,356,156,200,38.17,0.382,0.338,0.295
183239,2004,516,284,232,370,149,221,77.82,0.778,0.717,0.642
183822,2004,361,233,128,32,14,18,7.73,0.077,0.089,0.109
183974,2004,258,169,89,123,38,85,50.3,0.503,0.477,0.427
184348,2004,418,243,175,264,98,166,68.31,0.683,0.632,0.56
184603,2004,504,282,222,150,61,89,31.56,0.316,0.298,0.275
184612,2004,232,170,62,38,13,25,14.71,0.147,0.164,0.21
184782,2004,1247,622,625,546,255,291,46.78,0.468,0.438,0.408
185129,2004,512,300,212,40,12,28,9.33,0.093,0.078,0.057
185572,2004,946,514,432,341,120,221,43,0.43,0.36,0.278
185590,2004,1737,1015,722,534,164,370,36.45,0.365,0.307,0.227
185828,2004,663,130,533,108,74,34,26.15,0.262,0.163,0.139
186131,2004,1170,548,622,1054,549,505,92.15,0.922,0.901,0.883
186201,2004,746,451,295,486,165,321,71.18,0.712,0.651,0.559
186283,2004,890,514,376,456,190,266,51.75,0.517,0.512,0.505
186584,2004,1234,672,562,626,269,357,53.12,0.531,0.507,0.479
186876,2004,819,435,384,331,127,204,46.9,0.469,0.404,0.331
187134,2004,1230,681,549,876,357,519,76.21,0.762,0.712,0.65
187444,2004,1430,801,629,245,85,160,19.98,0.2,0.171,0.135
187985,2004,3018,1720,1298,370,98,272,15.81,0.158,0.123,0.076
188030,2004,2061,1125,936,260,92,168,14.93,0.149,0.126,0.098
188429,2004,801,549,252,463,119,344,62.66,0.627,0.578,0.472
188641,2004,505,226,279,218,99,119,52.65,0.526,0.432,0.355
190044,2004,658,142,516,364,275,89,62.68,0.627,0.553,0.533
190099,2004,738,396,342,616,277,339,85.61,0.856,0.835,0.81
190150,2004,1366,632,734,1133,604,529,83.7,0.837,0.829,0.823
190248,2004,143,61,82,38,13,25,40.98,0.41,0.266,0.159
190415,2004,3051,1494,1557,2621,1289,1332,89.16,0.892,0.859,0.828
190512,2004,1693,865,828,569,233,336,38.84,0.388,0.336,0.281
190549,2004,1170,653,517,268,90,178,27.26,0.273,0.229,0.174
190558,2004,2020,1147,873,67,12,55,4.8,0.048,0.033,0.014
190567,2004,1168,531,637,106,45,61,11.49,0.115,0.091,0.071
190594,2004,1824,1235,589,312,81,231,18.7,0.187,0.171,0.138
190637,2004,852,571,281,100,27,73,12.78,0.128,0.117,0.096
190664,2004,1352,815,537,352,102,250,30.67,0.307,0.26,0.19
190691,2004,727,453,274,27,8,19,4.19,0.042,0.037,0.029
190725,2004,264,198,66,62,11,51,25.76,0.258,0.235,0.167
191241,2004,1674,997,677,1269,486,783,78.54,0.785,0.758,0.718
191515,2004,457,236,221,385,180,205,86.86,0.869,0.842,0.814
191533,2004,409,219,190,189,80,109,49.77,0.498,0.462,0.421
191630,2004,482,255,227,337,142,195,76.47,0.765,0.699,0.626
191649,2004,1713,885,828,750,303,447,50.51,0.505,0.438,0.366
191676,2004,320,212,108,186,56,130,61.32,0.613,0.581,0.519
191931,2004,854,458,396,448,175,273,59.61,0.596,0.525,0.442
191968,2004,1458,831,627,1013,411,602,72.44,0.724,0.695,0.656
192192,2004,245,170,75,120,29,91,53.53,0.535,0.49,0.387
192323,2004,473,277,196,305,115,190,68.59,0.686,0.645,0.587
192439,2004,912,629,283,39,12,27,4.29,0.043,0.043,0.042
192703,2004,657,343,314,420,182,238,69.39,0.694,0.639,0.58
192749,2004,450,312,138,261,78,183,58.65,0.587,0.58,0.565
192819,2004,955,536,419,699,282,417,77.8,0.778,0.732,0.673
192925,2004,296,179,117,85,36,49,27.37,0.274,0.287,0.308
193016,2004,649,421,228,79,18,61,14.49,0.145,0.122,0.079
193292,2004,311,231,80,105,17,88,38.1,0.381,0.338,0.212
193353,2004,419,314,105,180,45,135,42.99,0.43,0.43,0.429
193399,2004,355,229,126,166,53,113,49.34,0.493,0.468,0.421
193584,2004,449,335,114,285,60,225,67.16,0.672,0.635,0.526
193645,2004,952,815,137,152,11,141,17.3,0.173,0.16,0.08
193654,2004,815,612,203,371,86,285,46.57,0.466,0.455,0.424
193900,2004,4568,2792,1776,2860,1121,1739,62.29,0.623,0.626,0.631
193973,2004,725,467,258,443,141,302,64.67,0.647,0.611,0.547
194161,2004,260,162,98,78,29,49,30.25,0.302,0.3,0.296
194310,2004,1437,900,537,577,194,383,42.56,0.426,0.402,0.361
194824,2004,1079,259,820,696,521,175,67.57,0.676,0.645,0.635
195003,2004,2233,562,1671,577,316,261,46.44,0.464,0.258,0.189
195030,2004,1083,496,587,808,409,399,80.44,0.804,0.746,0.697
195164,2004,574,304,270,305,134,171,56.25,0.562,0.531,0.496
195173,2004,473,228,245,148,67,81,35.53,0.355,0.313,0.273
195216,2004,566,298,268,444,203,241,80.87,0.809,0.784,0.757
195234,2004,563,408,155,387,91,296,72.55,0.726,0.687,0.587
195243,2004,349,168,181,112,56,56,33.33,0.333,0.321,0.309
195304,2004,329,253,76,233,50,183,72.33,0.723,0.708,0.658
195474,2004,715,412,303,532,212,320,77.67,0.777,0.744,0.7
195526,2004,676,383,293,539,229,310,80.94,0.809,0.797,0.782
195544,2004,593,420,173,311,68,243,57.86,0.579,0.524,0.393
195809,2004,2996,1696,1300,1035,384,651,38.38,0.384,0.345,0.295
196413,2004,2662,1505,1157,1907,766,1141,75.81,0.758,0.716,0.662
196592,2004,1863,1278,585,246,86,160,12.52,0.125,0.132,0.147
197045,2004,484,248,236,143,68,75,30.24,0.302,0.295,0.288
197133,2004,654,419,235,586,198,388,92.6,0.926,0.896,0.843
197869,2004,2507,1247,1260,941,357,584,46.83,0.468,0.375,0.283
197984,2004,174,96,78,47,20,27,28.12,0.281,0.27,0.256
198385,2004,462,238,224,410,192,218,91.6,0.916,0.887,0.857
198464,2004,3451,2143,1308,1009,294,715,33.36,0.334,0.292,0.225
198507,2004,554,295,259,107,30,77,26.1,0.261,0.193,0.116
198516,2004,1230,775,455,918,319,599,77.29,0.773,0.746,0.701
198835,2004,322,196,126,123,35,88,44.9,0.449,0.382,0.278
198969,2004,435,143,292,71,25,46,32.17,0.322,0.163,0.086
199102,2004,2212,1147,1065,335,86,249,21.71,0.217,0.151,0.081
199111,2004,694,418,276,208,59,149,35.65,0.356,0.3,0.214
199120,2004,3584,2099,1485,2685,1027,1658,78.99,0.79,0.749,0.692
199139,2004,2599,1416,1183,707,249,458,32.34,0.323,0.272,0.21
199148,2004,2159,1525,634,625,124,501,32.85,0.328,0.289,0.196
199157,2004,1138,732,406,205,51,154,21.04,0.21,0.18,0.126
199193,2004,3935,1702,2233,1585,682,903,53.06,0.531,0.403,0.305
199218,2004,1891,1154,737,841,272,569,49.31,0.493,0.445,0.369
199281,2004,741,393,348,113,44,69,17.56,0.176,0.152,0.126
199306,2004,191,88,103,54,17,37,42.05,0.42,0.283,0.165
199412,2004,223,154,69,98,28,70,45.45,0.454,0.439,0.406
199582,2004,324,140,184,45,15,30,21.43,0.214,0.139,0.082
199643,2004,417,227,190,61,16,45,19.82,0.198,0.146,0.084
199847,2004,1109,552,557,921,438,483,87.5,0.875,0.83,0.786
199962,2004,358,174,184,155,66,89,51.15,0.511,0.433,0.359
199999,2004,891,619,272,117,35,82,13.25,0.132,0.131,0.129
200004,2004,1571,805,766,447,154,293,36.4,0.364,0.285,0.201
200059,2004,332,170,162,37,15,22,12.94,0.129,0.111,0.093
200156,2004,229,135,94,63,33,30,22.22,0.222,0.275,0.351
200217,2004,430,251,179,156,46,110,43.82,0.438,0.363,0.257
200226,2004,162,72,90,25,5,20,27.78,0.278,0.154,0.056
200253,2004,431,254,177,72,20,52,20.47,0.205,0.167,0.113
200280,2004,2178,1016,1162,459,216,243,23.92,0.239,0.211,0.186
200332,2004,2089,949,1140,481,220,261,27.5,0.275,0.23,0.193
200572,2004,167,71,96,39,16,23,32.39,0.324,0.234,0.167
201104,2004,571,340,231,245,70,175,51.47,0.515,0.429,0.303
201371,2004,266,130,136,136,61,75,57.69,0.577,0.511,0.449
201548,2004,517,298,219,253,96,157,52.68,0.527,0.489,0.438
201645,2004,782,306,476,508,282,226,73.86,0.739,0.65,0.592
201690,2004,583,270,313,46,11,35,12.96,0.13,0.079,0.035
202134,2004,922,463,459,79,31,48,10.37,0.104,0.086,0.068
202480,2004,1805,905,900,1048,437,611,67.51,0.675,0.581,0.486
202523,2004,616,362,254,501,200,301,83.15,0.832,0.813,0.787
202763,2004,580,387,193,248,60,188,48.58,0.486,0.428,0.311
203085,2004,354,159,195,132,47,85,53.46,0.535,0.373,0.241
203128,2004,220,106,114,137,62,75,70.75,0.708,0.623,0.544
203368,2004,734,383,351,466,207,259,67.62,0.676,0.635,0.59
203517,2004,3841,2428,1413,969,271,698,28.75,0.288,0.252,0.192
203535,2004,467,237,230,396,189,207,87.34,0.873,0.848,0.822
203580,2004,141,104,37,48,10,38,36.54,0.365,0.34,0.27
203775,2004,400,239,161,181,53,128,53.56,0.536,0.452,0.329
203845,2004,439,215,224,200,78,122,56.74,0.567,0.456,0.348
204024,2004,3475,1950,1525,2354,961,1393,71.44,0.714,0.677,0.63
204185,2004,547,256,291,292,128,164,64.06,0.641,0.534,0.44
204194,2004,303,184,119,130,44,86,46.74,0.467,0.429,0.37
204617,2004,415,202,213,143,57,86,42.57,0.426,0.345,0.268
204796,2004,6031,2891,3140,2930,1241,1689,58.42,0.584,0.486,0.395
204857,2004,3734,2050,1684,1703,616,1087,53.02,0.53,0.456,0.366
206330,2004,177,70,107,38,18,20,28.57,0.286,0.215,0.168
206589,2004,478,239,239,334,147,187,78.24,0.782,0.699,0.615
206604,2004,2289,1302,987,418,156,262,20.12,0.201,0.183,0.158
206622,2004,878,470,408,611,268,343,72.98,0.73,0.696,0.657
206695,2004,2025,1081,944,247,91,156,14.43,0.144,0.122,0.096
206914,2004,762,409,353,31,10,21,5.13,0.051,0.041,0.028
207209,2004,530,245,285,16,6,10,4.08,0.041,0.03,0.021
207306,2004,292,156,136,40,12,28,17.95,0.18,0.137,0.088
207324,2004,545,291,254,117,50,67,23.02,0.23,0.215,0.197
207388,2004,3126,1601,1525,991,360,631,39.41,0.394,0.317,0.236
207500,2004,3537,1876,1661,1122,397,725,38.65,0.386,0.317,0.239
207722,2004,244,148,96,45,13,32,21.62,0.216,0.184,0.135
207847,2004,609,310,299,59,29,30,9.68,0.097,0.097,0.097
207865,2004,941,493,448,130,41,89,18.05,0.181,0.138,0.092
208822,2004,397,259,138,235,79,156,60.23,0.602,0.592,0.572
209056,2004,537,329,208,366,143,223,67.78,0.678,0.682,0.688
209065,2004,432,222,210,249,106,143,64.41,0.644,0.576,0.505
209542,2004,2803,1367,1436,860,320,540,39.5,0.395,0.307,0.223
209551,2004,3138,1734,1404,1377,539,838,48.33,0.483,0.439,0.384
209612,2004,294,181,113,164,62,102,56.35,0.564,0.558,0.549
209807,2004,1173,627,546,167,51,116,18.5,0.185,0.142,0.093
209922,2004,333,186,147,199,78,121,65.05,0.65,0.598,0.531
210146,2004,744,409,335,100,30,70,17.11,0.171,0.134,0.09
210401,2004,510,284,226,361,155,206,72.54,0.725,0.708,0.686
210429,2004,795,447,348,138,55,83,18.57,0.186,0.174,0.158
210571,2004,505,319,186,268,86,182,57.05,0.571,0.531,0.462
210669,2004,647,341,306,465,206,259,75.95,0.76,0.719,0.673
210775,2004,310,197,113,123,29,94,47.72,0.477,0.397,0.257
211088,2004,476,343,133,247,67,180,52.48,0.525,0.519,0.504
211158,2004,1533,947,586,631,198,433,45.72,0.457,0.412,0.338
211291,2004,906,447,459,813,397,416,93.06,0.931,0.897,0.865
211352,2004,390,257,133,155,45,110,42.8,0.428,0.397,0.338
211361,2004,1038,519,519,293,127,166,31.98,0.32,0.282,0.245
211431,2004,231,226,5,87,1,86,38.05,0.38,0.377,0.2
211440,2004,1359,510,849,940,579,361,70.78,0.708,0.692,0.682
211468,2004,237,237,0,114,0,114,48.1,0.481,0.481,NA
211556,2004,90,90,0,50,0,50,55.56,0.556,0.556,NA
211583,2004,197,115,82,62,24,38,33.04,0.33,0.315,0.293
211608,2004,422,225,197,56,20,36,16,0.16,0.133,0.102
211644,2004,1203,683,520,296,103,193,28.26,0.283,0.246,0.198
211981,2004,450,257,193,186,48,138,53.7,0.537,0.413,0.249
212009,2004,605,329,276,472,197,275,83.59,0.836,0.78,0.714
212054,2004,2069,732,1337,477,193,284,38.8,0.388,0.231,0.144
212106,2004,1208,700,508,656,251,405,57.86,0.579,0.543,0.494
212115,2004,1165,709,456,420,122,298,42.03,0.42,0.361,0.268
212133,2004,450,294,156,243,82,161,54.76,0.548,0.54,0.526
212160,2004,1232,712,520,272,81,191,26.83,0.268,0.221,0.156
212197,2004,535,344,191,385,125,260,75.58,0.756,0.72,0.654
212577,2004,529,241,288,424,219,205,85.06,0.851,0.802,0.76
212601,2004,522,317,205,248,84,164,51.74,0.517,0.475,0.41
212832,2004,280,218,62,87,23,64,29.36,0.294,0.311,0.371
212911,2004,330,179,151,291,130,161,89.94,0.899,0.882,0.861
213020,2004,2645,1567,1078,768,234,534,34.08,0.341,0.29,0.217
213251,2004,390,213,177,273,129,144,67.61,0.676,0.7,0.729
213321,2004,449,178,271,268,139,129,72.47,0.725,0.597,0.513
213349,2004,2049,1217,832,680,191,489,40.18,0.402,0.332,0.23
213358,2004,214,141,73,46,10,36,25.53,0.255,0.215,0.137
213367,2004,829,419,410,441,195,246,58.71,0.587,0.532,0.476
213385,2004,609,315,294,529,249,280,88.89,0.889,0.869,0.847
213507,2004,416,221,195,287,121,166,75.11,0.751,0.69,0.621
213543,2004,1054,463,591,814,417,397,85.75,0.858,0.772,0.706
213613,2004,1191,702,489,348,129,219,31.2,0.312,0.292,0.264
213668,2004,399,217,182,249,109,140,64.52,0.645,0.624,0.599
213783,2004,689,402,287,168,54,114,28.36,0.284,0.244,0.188
213826,2004,332,262,70,149,24,125,47.71,0.477,0.449,0.343
213996,2004,690,453,237,484,159,325,71.74,0.717,0.701,0.671
214041,2004,1396,791,605,512,177,335,42.35,0.424,0.367,0.293
214069,2004,317,225,92,171,41,130,57.78,0.578,0.539,0.446
214157,2004,382,215,167,261,103,158,73.49,0.735,0.683,0.617
214175,2004,559,337,222,456,178,278,82.49,0.825,0.816,0.802
214272,2004,462,304,158,135,41,94,30.92,0.309,0.292,0.259
214777,2004,5905,2884,3021,3681,1674,2007,69.59,0.696,0.623,0.554
215062,2004,2359,1191,1168,2090,999,1091,91.6,0.916,0.886,0.855
215743,2004,321,198,123,175,48,127,64.14,0.641,0.545,0.39
215798,2004,331,186,145,226,93,133,71.51,0.715,0.683,0.641
215929,2004,965,559,406,658,248,410,73.35,0.733,0.682,0.611
216010,2004,1458,748,710,629,251,378,50.53,0.505,0.431,0.354
216038,2004,1530,890,640,551,196,355,39.89,0.399,0.36,0.306
216287,2004,365,189,176,324,153,171,90.48,0.905,0.888,0.869
216339,2004,3788,2184,1604,1216,468,748,34.25,0.342,0.321,0.292
216524,2004,393,200,193,303,142,161,80.5,0.805,0.771,0.736
216694,2004,367,189,178,175,70,105,55.56,0.556,0.477,0.393
216764,2004,1870,1214,656,734,177,557,45.88,0.459,0.393,0.27
216807,2004,378,235,143,225,72,153,65.11,0.651,0.595,0.503
216852,2004,736,342,394,247,97,150,43.86,0.439,0.336,0.246
216931,2004,550,296,254,287,128,159,53.72,0.537,0.522,0.504
217059,2004,1037,612,425,423,151,272,44.44,0.444,0.408,0.355
217156,2004,1429,744,685,1224,580,644,86.56,0.866,0.857,0.847
217402,2004,1036,549,487,859,406,453,82.51,0.825,0.829,0.834
217536,2004,558,397,161,358,99,259,65.24,0.652,0.642,0.615
217776,2004,161,98,63,40,15,25,25.51,0.255,0.248,0.238
217819,2004,1940,1323,617,1039,268,771,58.28,0.583,0.536,0.434
217882,2004,2994,1369,1625,1488,597,891,65.08,0.651,0.497,0.367
217998,2004,179,106,73,97,39,58,54.72,0.547,0.542,0.534
218061,2004,745,463,282,139,34,105,22.68,0.227,0.187,0.121
218229,2004,647,440,207,140,32,108,24.55,0.246,0.216,0.155
218238,2004,203,95,108,41,15,26,27.37,0.274,0.202,0.139
218399,2004,232,141,91,19,3,16,11.35,0.114,0.082,0.033
218414,2004,231,90,141,73,28,45,50,0.5,0.316,0.199
218663,2004,3330,1841,1489,1524,593,931,50.57,0.506,0.458,0.398
218724,2004,1320,669,651,288,104,184,27.5,0.275,0.218,0.16
218733,2004,945,523,422,164,41,123,23.52,0.235,0.174,0.097
218742,2004,643,398,245,145,51,94,23.62,0.236,0.226,0.208
218973,2004,323,144,179,253,129,124,86.11,0.861,0.783,0.721
219000,2004,392,231,161,197,70,127,54.98,0.55,0.503,0.435
219046,2004,581,350,231,46,11,35,10,0.1,0.079,0.048
219082,2004,249,114,135,44,18,26,22.81,0.228,0.177,0.133
219198,2004,150,111,39,51,13,38,34.23,0.342,0.34,0.333
219259,2004,384,238,146,53,12,41,17.23,0.172,0.138,0.082
219356,2004,1993,1011,982,485,194,291,28.78,0.288,0.243,0.198
219471,2004,945,538,407,220,80,140,26.02,0.26,0.233,0.197
219602,2004,1196,714,482,173,64,109,15.27,0.153,0.145,0.133
219709,2004,727,442,285,429,168,261,59.05,0.591,0.59,0.589
219718,2004,252,97,155,40,15,25,25.77,0.258,0.159,0.097
219949,2004,203,104,99,37,15,22,21.15,0.212,0.182,0.152
220075,2004,1479,846,633,259,76,183,21.63,0.216,0.175,0.12
220215,2004,371,205,166,145,54,91,44.39,0.444,0.391,0.325
220613,2004,723,430,293,223,67,156,36.28,0.363,0.308,0.229
220631,2004,201,138,63,50,18,32,23.19,0.232,0.249,0.286
220710,2004,317,169,148,155,56,99,58.58,0.586,0.489,0.378
221351,2004,474,269,205,360,144,216,80.3,0.803,0.759,0.702
221519,2004,397,207,190,309,142,167,80.68,0.807,0.778,0.747
221731,2004,163,102,61,49,11,38,37.25,0.372,0.301,0.18
221847,2004,1476,611,865,312,122,190,31.1,0.311,0.211,0.141
221892,2004,237,119,118,84,38,46,38.66,0.387,0.354,0.322
222178,2004,1018,553,465,377,127,250,45.21,0.452,0.37,0.273
222983,2004,370,193,177,274,121,153,79.27,0.793,0.741,0.684
223232,2004,2772,1674,1098,1398,488,910,54.36,0.544,0.504,0.444
224004,2004,149,84,65,21,10,11,13.1,0.131,0.141,0.154
224323,2004,243,126,117,153,65,88,69.84,0.698,0.63,0.556
225432,2004,964,541,423,10,5,5,0.92,0.009,0.01,0.012
225548,2004,285,126,159,62,29,33,26.19,0.262,0.218,0.182
225627,2004,474,331,143,61,12,49,14.8,0.148,0.129,0.084
226231,2004,327,92,235,98,58,40,43.48,0.435,0.3,0.247
226833,2004,611,301,310,35,13,22,7.31,0.073,0.057,0.042
227216,2004,3216,1872,1344,611,180,431,23.02,0.23,0.19,0.134
227331,2004,216,171,45,30,3,27,15.79,0.158,0.139,0.067
227526,2004,1573,823,750,156,56,100,12.15,0.122,0.099,0.075
227757,2004,725,380,345,574,259,315,82.89,0.829,0.792,0.751
227845,2004,600,371,229,291,97,194,52.29,0.523,0.485,0.424
227863,2004,297,189,108,80,24,56,29.63,0.296,0.269,0.222
228042,2004,204,122,82,53,20,33,27.05,0.27,0.26,0.244
228149,2004,463,277,186,159,51,108,38.99,0.39,0.343,0.274
228246,2004,1313,717,596,789,310,479,66.81,0.668,0.601,0.52
228343,2004,366,221,145,228,68,160,72.4,0.724,0.623,0.469
228431,2004,1736,1091,645,381,95,286,26.21,0.262,0.219,0.147
228459,2004,2783,1616,1167,691,187,504,31.19,0.312,0.248,0.16
228501,2004,275,113,162,25,11,14,12.39,0.124,0.091,0.068
228529,2004,1178,655,523,200,59,141,21.53,0.215,0.17,0.113
228705,2004,741,328,413,80,29,51,15.55,0.156,0.108,0.07
228723,2004,6645,3465,3180,3071,1049,2022,58.35,0.584,0.462,0.33
228769,2004,2009,1068,941,325,115,210,19.66,0.197,0.162,0.122
228778,2004,6741,3693,3048,3540,1426,2114,57.24,0.572,0.525,0.468
228787,2004,1129,429,700,473,255,218,50.82,0.508,0.419,0.364
228796,2004,2296,1205,1091,174,58,116,9.63,0.096,0.076,0.053
228875,2004,1605,988,617,866,276,590,59.72,0.597,0.54,0.447
228981,2004,399,202,197,105,40,65,32.18,0.322,0.263,0.203
229018,2004,258,136,122,39,16,23,16.91,0.169,0.151,0.131
229027,2004,4193,2129,2064,315,103,212,9.96,0.1,0.075,0.05
229115,2004,3833,1894,1939,1419,554,865,45.67,0.457,0.37,0.286
229780,2004,212,109,103,59,26,33,30.28,0.303,0.278,0.252
229814,2004,790,424,366,151,42,109,25.71,0.257,0.191,0.115
230603,2004,656,445,211,130,18,112,25.17,0.252,0.198,0.085
230728,2004,1591,1048,543,433,70,363,34.64,0.346,0.272,0.129
230764,2004,1997,1133,864,453,152,301,26.57,0.266,0.227,0.176
230782,2004,1559,882,677,94,28,66,7.48,0.075,0.06,0.041
231059,2004,518,280,238,378,165,213,76.07,0.761,0.73,0.693
231174,2004,1953,1079,874,1188,476,712,65.99,0.66,0.608,0.545
231420,2004,191,68,123,53,25,28,41.18,0.412,0.277,0.203
231554,2004,135,82,53,38,14,24,29.27,0.293,0.281,0.264
231624,2004,1335,683,652,1097,494,603,88.29,0.883,0.822,0.758
231712,2004,1174,638,536,498,151,347,54.39,0.544,0.424,0.282
232025,2004,260,142,118,125,48,77,54.23,0.542,0.481,0.407
232043,2004,207,134,73,91,33,58,43.28,0.433,0.44,0.452
232089,2004,287,114,173,53,21,32,28.07,0.281,0.185,0.121
232186,2004,2210,1203,1007,869,311,558,46.38,0.464,0.393,0.309
232265,2004,1345,863,482,514,131,383,44.38,0.444,0.382,0.272
232423,2004,3281,2112,1169,2216,690,1526,72.25,0.723,0.675,0.59
232557,2004,2173,1178,995,647,251,396,33.62,0.336,0.298,0.252
232566,2004,972,631,341,386,111,275,43.58,0.436,0.397,0.326
232609,2004,568,328,240,275,87,188,57.32,0.573,0.484,0.362
232681,2004,869,569,300,590,183,407,71.53,0.715,0.679,0.61
232706,2004,414,310,104,180,45,135,43.55,0.436,0.435,0.433
232937,2004,970,580,390,103,20,83,14.31,0.143,0.106,0.051
232982,2004,1917,1053,864,474,136,338,32.1,0.321,0.247,0.157
233277,2004,1828,1135,693,708,209,499,43.96,0.44,0.387,0.302
233374,2004,763,391,372,620,298,322,82.35,0.824,0.813,0.801
233426,2004,483,288,195,314,114,200,69.44,0.694,0.65,0.585
233541,2004,325,160,165,98,39,59,36.88,0.369,0.302,0.236
233897,2004,373,180,193,130,61,69,38.33,0.383,0.349,0.316
233921,2004,4923,2042,2881,2599,1252,1347,65.96,0.66,0.528,0.435
234030,2004,3271,1960,1311,749,220,529,26.99,0.27,0.229,0.168
234085,2004,363,24,339,216,205,11,45.83,0.458,0.595,0.605
234155,2004,1025,656,369,250,54,196,29.88,0.299,0.244,0.146
234164,2004,431,247,184,78,17,61,24.7,0.247,0.181,0.092
235097,2004,1403,813,590,297,102,195,23.99,0.24,0.212,0.173
235167,2004,479,250,229,185,87,98,39.2,0.392,0.386,0.38
236230,2004,697,462,235,327,96,231,50,0.5,0.469,0.409
236328,2004,671,390,281,471,190,281,72.05,0.721,0.702,0.676
236577,2004,633,414,219,341,115,226,54.59,0.546,0.539,0.525
236595,2004,719,447,272,407,138,269,60.18,0.602,0.566,0.507
236896,2004,352,173,179,83,33,50,28.9,0.289,0.236,0.184
236939,2004,3089,1622,1467,1251,495,756,46.61,0.466,0.405,0.337
236948,2004,4867,2639,2228,2625,1075,1550,58.73,0.587,0.539,0.482
237011,2004,2425,1405,1020,876,287,589,41.92,0.419,0.361,0.281
237057,2004,385,222,163,308,124,184,82.88,0.829,0.8,0.761
237066,2004,469,266,203,308,127,181,68.05,0.68,0.657,0.626
237215,2004,244,138,106,14,8,6,4.35,0.044,0.057,0.075
237330,2004,488,262,226,75,30,45,17.18,0.172,0.154,0.133
237358,2004,142,77,65,57,26,31,40.26,0.403,0.401,0.4
237367,2004,602,321,281,90,27,63,19.63,0.196,0.15,0.096
237792,2004,774,427,347,119,44,75,17.56,0.176,0.154,0.127
237899,2004,331,175,156,18,8,10,5.71,0.057,0.054,0.051
237932,2004,459,238,221,92,35,57,23.95,0.24,0.2,0.158
237969,2004,348,181,167,148,59,89,49.17,0.492,0.425,0.353
238032,2004,4308,2032,2276,1416,571,845,41.58,0.416,0.329,0.251
238333,2004,323,176,147,218,97,121,68.75,0.688,0.675,0.66
238430,2004,157,120,37,63,8,55,45.83,0.458,0.401,0.216
238458,2004,616,405,211,234,61,173,42.72,0.427,0.38,0.289
238476,2004,579,344,235,277,101,176,51.16,0.512,0.478,0.43
238616,2004,363,198,165,145,57,88,44.44,0.444,0.399,0.345
238661,2004,298,214,84,95,20,75,35.05,0.35,0.319,0.238
239080,2004,270,191,79,84,16,68,35.6,0.356,0.311,0.203
239105,2004,1802,979,823,1118,454,664,67.82,0.678,0.62,0.552
239628,2004,202,114,88,115,53,62,54.39,0.544,0.569,0.602
239716,2004,520,298,222,364,138,226,75.84,0.758,0.7,0.622
240107,2004,308,210,98,82,19,63,30,0.3,0.266,0.194
240189,2004,1745,836,909,427,193,234,27.99,0.28,0.245,0.212
240277,2004,989,636,353,228,71,157,24.69,0.247,0.231,0.201
240329,2004,1539,958,581,498,157,341,35.59,0.356,0.324,0.27
240338,2004,186,112,74,79,28,51,45.54,0.455,0.425,0.378
240365,2004,1708,1033,675,250,78,172,16.65,0.166,0.146,0.116
240374,2004,890,491,399,87,34,53,10.79,0.108,0.098,0.085
240417,2004,1277,649,628,254,67,187,28.81,0.288,0.199,0.107
240426,2004,329,190,139,54,20,34,17.89,0.179,0.164,0.144
240444,2004,5617,3124,2493,2792,1096,1696,54.29,0.543,0.497,0.44
240453,2004,3714,2000,1714,555,216,339,16.95,0.169,0.149,0.126
240462,2004,1164,398,766,205,90,115,28.89,0.289,0.176,0.117
240471,2004,1197,722,475,311,109,202,27.98,0.28,0.26,0.229
240480,2004,1525,857,668,322,118,204,23.8,0.238,0.211,0.177
240727,2004,1496,754,742,336,133,203,26.92,0.269,0.225,0.179
243443,2004,519,340,179,50,11,39,11.47,0.115,0.096,0.061
243780,2004,6766,2781,3985,2419,1066,1353,48.65,0.486,0.358,0.268
100654,2005,1088,572,516,116,27,89,15.56,0.156,0.107,0.052
100663,2005,1515,895,620,350,110,240,26.82,0.268,0.231,0.177
100751,2005,3642,2038,1604,1373,491,882,43.28,0.433,0.377,0.306
100858,2005,4179,2180,1999,1491,511,980,44.95,0.45,0.357,0.256
101435,2005,185,90,95,78,34,44,48.89,0.489,0.422,0.358
101480,2005,1120,595,525,120,37,83,13.95,0.139,0.107,0.07
101675,2005,389,177,212,25,4,21,11.86,0.119,0.064,0.019
101879,2005,982,526,456,2,1,1,0.19,0.002,0.002,0.002
102049,2005,699,457,242,358,93,265,57.99,0.58,0.512,0.384
102094,2005,1198,689,509,199,62,137,19.88,0.199,0.166,0.122
102234,2005,274,173,101,139,49,90,52.02,0.52,0.507,0.485
102368,2005,1434,789,645,201,64,137,17.36,0.174,0.14,0.099
102377,2005,730,385,345,112,30,82,21.3,0.213,0.153,0.087
104151,2005,7927,4267,3660,2561,996,1565,36.68,0.367,0.323,0.272
104179,2005,5785,3115,2670,2104,820,1284,41.22,0.412,0.364,0.307
105330,2005,2101,1268,833,645,174,471,37.15,0.372,0.307,0.209
106245,2005,762,445,317,64,24,40,8.99,0.09,0.084,0.076
106342,2005,111,61,50,45,20,25,40.98,0.41,0.405,0.4
106397,2005,2662,1324,1338,913,375,538,40.63,0.406,0.343,0.28
106412,2005,714,349,365,74,24,50,14.33,0.143,0.104,0.066
106458,2005,1483,826,657,288,108,180,21.79,0.218,0.194,0.164
106467,2005,1457,714,743,253,104,149,20.87,0.209,0.174,0.14
106485,2005,625,337,288,55,20,35,10.39,0.104,0.088,0.069
106704,2005,2429,1376,1053,467,136,331,24.06,0.241,0.192,0.129
107044,2005,955,527,428,396,132,264,50.09,0.501,0.415,0.308
107080,2005,280,156,124,179,73,106,67.95,0.679,0.639,0.589
107141,2005,262,132,130,143,71,72,54.55,0.545,0.546,0.546
107512,2005,365,213,152,181,66,115,53.99,0.54,0.496,0.434
107558,2005,168,89,79,48,19,29,32.58,0.326,0.286,0.241
110097,2005,670,416,254,337,111,226,54.33,0.543,0.503,0.437
110404,2005,233,69,164,178,127,51,73.91,0.739,0.764,0.774
110422,2005,3318,1599,1719,1021,345,676,42.28,0.423,0.308,0.201
110486,2005,766,503,263,114,21,93,18.49,0.185,0.149,0.08
110495,2005,741,511,230,151,31,120,23.48,0.235,0.204,0.135
110510,2005,1645,1092,553,212,75,137,12.55,0.126,0.129,0.136
110529,2005,3089,1296,1793,380,157,223,17.21,0.172,0.123,0.088
110538,2005,2300,1237,1063,439,118,321,25.95,0.26,0.191,0.111
110547,2005,705,476,229,42,9,33,6.93,0.069,0.06,0.039
110556,2005,2356,1403,953,323,106,217,15.47,0.155,0.137,0.111
110565,2005,3816,2241,1575,524,134,390,17.4,0.174,0.137,0.085
110574,2005,686,414,272,110,39,71,17.15,0.171,0.16,0.143
110583,2005,4241,2666,1575,524,153,371,13.92,0.139,0.124,0.097
110592,2005,1253,823,430,111,31,80,9.72,0.097,0.089,0.072
110617,2005,2436,1483,953,256,73,183,12.34,0.123,0.105,0.077
113698,2005,227,168,59,98,22,76,45.24,0.452,0.432,0.373
115755,2005,813,461,352,99,32,67,14.53,0.145,0.122,0.091
119173,2005,393,378,15,68,3,65,17.2,0.172,0.173,0.2
120184,2005,144,95,49,59,14,45,47.37,0.474,0.41,0.286
121309,2005,562,339,223,348,125,223,65.78,0.658,0.619,0.561
121345,2005,382,193,189,347,169,178,92.23,0.922,0.908,0.894
122409,2005,3439,2039,1400,1011,323,688,33.74,0.337,0.294,0.231
122436,2005,1131,710,421,726,238,488,68.73,0.687,0.642,0.565
122597,2005,2999,1942,1057,360,105,255,13.13,0.131,0.12,0.099
122612,2005,932,665,267,542,131,411,61.8,0.618,0.582,0.491
122931,2005,1197,667,530,917,384,533,79.91,0.799,0.766,0.725
123554,2005,659,399,260,313,107,206,51.63,0.516,0.475,0.412
123572,2005,1043,697,346,309,69,240,34.43,0.344,0.296,0.199
126562,2005,744,414,330,108,30,78,18.84,0.188,0.145,0.091
126580,2005,947,595,352,210,50,160,26.89,0.269,0.222,0.142
126614,2005,5007,2364,2643,2007,900,1107,46.83,0.468,0.401,0.341
126818,2005,3622,2036,1586,1278,406,872,42.83,0.428,0.353,0.256
127060,2005,1089,608,481,655,251,404,66.45,0.665,0.601,0.522
127185,2005,860,386,474,161,70,91,23.58,0.236,0.187,0.148
127565,2005,1840,939,901,79,32,47,5.01,0.05,0.043,0.036
127741,2005,2483,1479,1004,620,173,447,30.22,0.302,0.25,0.172
128106,2005,665,361,304,125,54,71,19.67,0.197,0.188,0.178
128744,2005,352,212,140,64,20,44,20.75,0.208,0.182,0.143
128771,2005,1333,663,670,188,82,106,15.99,0.16,0.141,0.122
129020,2005,3239,1789,1450,2176,881,1295,72.39,0.724,0.672,0.608
129242,2005,940,551,389,744,297,447,81.13,0.811,0.791,0.763
129941,2005,653,322,331,256,117,139,43.17,0.432,0.392,0.353
130253,2005,886,542,344,544,186,358,66.05,0.66,0.614,0.541
130314,2005,206,206,0,88,0,88,42.72,0.427,0.427,NA
130493,2005,1313,866,447,192,43,149,17.21,0.172,0.146,0.096
130590,2005,573,289,284,469,221,248,85.81,0.858,0.818,0.778
130697,2005,705,360,345,614,305,309,85.83,0.858,0.871,0.884
130776,2005,773,396,377,124,52,72,18.18,0.182,0.16,0.138
130794,2005,1320,651,669,1172,574,598,91.86,0.919,0.888,0.858
130934,2005,885,514,371,164,40,124,24.12,0.241,0.185,0.108
130943,2005,3830,2252,1578,2250,803,1447,64.25,0.642,0.587,0.509
131159,2005,1216,778,438,898,319,579,74.42,0.744,0.738,0.728
131283,2005,786,455,331,482,187,295,64.84,0.648,0.613,0.565
131450,2005,280,151,129,28,7,21,13.91,0.139,0.1,0.054
131469,2005,2408,1375,1033,1823,732,1091,79.35,0.793,0.757,0.709
131496,2005,1530,774,756,1378,669,709,91.6,0.916,0.901,0.885
131520,2005,1410,944,466,635,166,469,49.68,0.497,0.45,0.356
132471,2005,563,356,207,117,35,82,23.03,0.23,0.208,0.169
132602,2005,913,525,388,140,52,88,16.76,0.168,0.153,0.134
132903,2005,6041,3216,2825,2025,720,1305,40.58,0.406,0.335,0.255
133492,2005,501,297,204,275,102,173,58.25,0.583,0.549,0.5
133553,2005,975,152,823,307,246,61,40.13,0.401,0.315,0.299
133650,2005,1636,925,711,183,61,122,13.19,0.132,0.112,0.086
133669,2005,2080,1111,969,363,126,237,21.33,0.213,0.175,0.13
133711,2005,459,283,176,216,77,139,49.12,0.491,0.471,0.438
133881,2005,603,154,449,242,172,70,45.45,0.454,0.401,0.383
133951,2005,3967,2261,1706,634,188,446,19.73,0.197,0.16,0.11
134079,2005,462,274,188,190,60,130,47.45,0.475,0.411,0.319
134097,2005,6052,3554,2498,2995,1066,1929,54.28,0.543,0.495,0.427
134130,2005,7217,4080,3137,4230,1533,2697,66.1,0.661,0.586,0.489
134945,2005,544,252,292,127,59,68,26.98,0.27,0.233,0.202
135726,2005,2258,1168,1090,1480,670,810,69.35,0.694,0.655,0.615
136172,2005,2288,1296,992,518,179,339,26.16,0.262,0.226,0.18
136950,2005,463,275,188,284,105,179,65.09,0.651,0.613,0.559
137546,2005,547,312,235,308,135,173,55.45,0.554,0.563,0.574
138354,2005,830,490,340,194,65,129,26.33,0.263,0.234,0.191
138716,2005,596,388,208,93,16,77,19.85,0.198,0.156,0.077
138789,2005,700,453,247,70,14,56,12.36,0.124,0.1,0.057
139144,2005,513,316,197,226,65,161,50.95,0.51,0.441,0.33
139366,2005,1067,641,426,129,33,96,14.98,0.15,0.121,0.077
139393,2005,270,138,132,122,48,74,53.62,0.536,0.452,0.364
139658,2005,1631,933,698,1032,450,582,62.38,0.624,0.633,0.645
139719,2005,317,169,148,48,11,37,21.89,0.219,0.151,0.074
139755,2005,2415,714,1701,756,431,325,45.52,0.455,0.313,0.253
139764,2005,358,200,158,36,9,27,13.5,0.135,0.101,0.057
139861,2005,1032,631,401,342,101,241,38.19,0.382,0.331,0.252
139931,2005,3123,1472,1651,623,195,428,29.08,0.291,0.199,0.118
139940,2005,2325,1322,1003,408,164,244,18.46,0.185,0.175,0.164
139959,2005,4654,2812,1842,2505,845,1660,59.03,0.59,0.538,0.459
140447,2005,666,408,258,267,86,181,44.36,0.444,0.401,0.333
140960,2005,806,427,379,73,16,57,13.35,0.134,0.091,0.042
140988,2005,291,133,158,101,40,61,45.86,0.459,0.347,0.253
141185,2005,223,135,88,84,27,57,42.22,0.422,0.377,0.307
141264,2005,1775,1072,703,299,69,230,21.46,0.215,0.168,0.098
141334,2005,1640,966,674,212,47,165,17.08,0.171,0.129,0.07
141486,2005,260,182,78,57,12,45,24.73,0.247,0.219,0.154
141565,2005,409,215,194,50,15,35,16.28,0.163,0.122,0.077
141574,2005,1923,1060,863,354,128,226,21.32,0.213,0.184,0.148
142276,2005,909,519,390,74,22,52,10.02,0.1,0.081,0.056
142285,2005,1673,823,850,386,156,230,27.95,0.28,0.231,0.184
142461,2005,249,168,81,88,24,64,38.1,0.381,0.353,0.296
143084,2005,679,383,296,474,193,281,73.37,0.734,0.698,0.652
143288,2005,183,92,91,66,30,36,39.13,0.391,0.361,0.33
144005,2005,405,268,137,15,4,11,4.1,0.041,0.037,0.029
144281,2005,1795,933,862,504,219,285,30.55,0.306,0.281,0.254
144740,2005,2392,1411,981,1168,450,718,50.89,0.509,0.488,0.459
144892,2005,1645,967,678,521,168,353,36.5,0.365,0.317,0.248
144962,2005,466,282,184,252,84,168,59.57,0.596,0.541,0.457
144971,2005,138,74,64,66,29,37,50,0.5,0.478,0.453
145600,2005,2759,1534,1225,742,294,448,29.2,0.292,0.269,0.24
145619,2005,308,163,145,97,42,55,33.74,0.337,0.315,0.29
145637,2005,7565,3511,4054,4966,2375,2591,73.8,0.738,0.656,0.586
145691,2005,256,117,139,124,60,64,54.7,0.547,0.484,0.432
145813,2005,3167,1970,1197,1388,419,969,49.19,0.492,0.438,0.35
146481,2005,358,202,156,213,78,135,66.83,0.668,0.595,0.5
146612,2005,557,321,236,232,92,140,43.61,0.436,0.417,0.39
146719,2005,2080,1365,715,1053,346,707,51.79,0.518,0.506,0.484
146825,2005,159,77,82,35,10,25,32.47,0.325,0.22,0.122
147013,2005,273,126,147,94,39,55,43.65,0.436,0.344,0.265
147244,2005,572,313,259,311,119,192,61.34,0.613,0.544,0.459
147341,2005,367,180,187,140,50,90,50,0.5,0.381,0.267
147703,2005,3171,1637,1534,826,360,466,28.47,0.285,0.26,0.235
147767,2005,1952,1018,934,1669,756,913,89.69,0.897,0.855,0.809
147776,2005,960,570,390,51,16,35,6.14,0.061,0.053,0.041
147828,2005,669,404,265,294,94,200,49.5,0.495,0.439,0.355
148131,2005,202,99,103,69,28,41,41.41,0.414,0.342,0.272
148496,2005,266,178,88,147,46,101,56.74,0.567,0.553,0.523
148584,2005,190,116,74,85,27,58,50,0.5,0.447,0.365
148627,2005,410,236,174,133,50,83,35.17,0.352,0.324,0.287
149222,2005,2382,1034,1348,560,261,299,28.92,0.289,0.235,0.194
149231,2005,1721,994,727,487,166,321,32.29,0.323,0.283,0.228
149772,2005,1802,885,917,549,265,284,32.09,0.321,0.305,0.289
149781,2005,578,287,291,458,220,238,82.93,0.829,0.792,0.756
150066,2005,565,348,217,272,93,179,51.44,0.514,0.481,0.429
150136,2005,3660,1892,1768,1063,367,696,36.79,0.368,0.29,0.208
150145,2005,310,207,103,122,41,81,39.13,0.391,0.394,0.398
150163,2005,864,536,328,391,119,272,50.75,0.508,0.453,0.363
150400,2005,586,337,249,470,197,273,81.01,0.81,0.802,0.791
150534,2005,670,416,254,337,105,232,55.77,0.558,0.503,0.413
150668,2005,194,108,86,113,44,69,63.89,0.639,0.582,0.512
150941,2005,232,133,99,113,45,68,51.13,0.511,0.487,0.455
151102,2005,1534,850,684,82,31,51,6,0.06,0.053,0.045
151111,2005,2396,1414,982,234,88,146,10.33,0.103,0.098,0.09
151306,2005,2042,1195,847,306,90,216,18.08,0.181,0.15,0.106
151324,2005,1622,810,812,311,122,189,23.33,0.233,0.192,0.15
151333,2005,382,251,131,31,6,25,9.96,0.1,0.081,0.046
151342,2005,805,466,339,34,16,18,3.86,0.039,0.042,0.047
151351,2005,6903,3785,3118,3425,1383,2042,53.95,0.54,0.496,0.444
151360,2005,471,280,191,33,19,14,5,0.05,0.07,0.099
151379,2005,664,409,255,53,12,41,10.02,0.1,0.08,0.047
151388,2005,284,179,105,13,2,11,6.15,0.062,0.046,0.019
151777,2005,329,170,159,140,50,90,52.94,0.529,0.426,0.314
151786,2005,189,127,62,64,17,47,37.01,0.37,0.339,0.274
152080,2005,1990,935,1055,1800,942,858,91.76,0.918,0.905,0.893
152248,2005,1093,599,494,57,23,34,5.68,0.057,0.052,0.047
152363,2005,266,145,121,128,41,87,60,0.6,0.481,0.339
152530,2005,459,271,188,342,142,200,73.8,0.738,0.745,0.755
152600,2005,672,332,340,421,183,238,71.69,0.717,0.626,0.538
153001,2005,286,143,143,121,50,71,49.65,0.496,0.423,0.35
153108,2005,366,203,163,213,93,120,59.11,0.591,0.582,0.571
153269,2005,809,465,344,438,173,265,56.99,0.57,0.541,0.503
153384,2005,385,206,179,320,148,172,83.5,0.835,0.831,0.827
153603,2005,3737,1629,2108,1248,535,713,43.77,0.438,0.334,0.254
153834,2005,629,354,275,367,140,227,64.12,0.641,0.583,0.509
154095,2005,1693,1062,631,618,184,434,40.87,0.409,0.365,0.292
155089,2005,151,72,79,16,7,9,12.5,0.125,0.106,0.089
155317,2005,4106,2115,1991,1332,518,814,38.49,0.385,0.324,0.26
155335,2005,181,84,97,31,12,19,22.62,0.226,0.171,0.124
155399,2005,3105,1561,1544,697,255,442,28.32,0.283,0.224,0.165
155520,2005,216,109,107,61,21,40,36.7,0.367,0.282,0.196
155627,2005,113,47,66,36,19,17,36.17,0.362,0.319,0.288
155937,2005,126,57,69,38,16,22,38.6,0.386,0.302,0.232
156213,2005,276,173,103,168,64,104,60.12,0.601,0.609,0.621
156286,2005,435,282,153,224,69,155,54.96,0.55,0.515,0.451
156295,2005,378,219,159,161,67,94,42.92,0.429,0.426,0.421
156365,2005,345,174,171,83,29,54,31.03,0.31,0.241,0.17
156541,2005,424,192,232,111,48,63,32.81,0.328,0.262,0.207
156745,2005,416,216,200,209,83,126,58.33,0.583,0.502,0.415
157058,2005,408,223,185,17,4,13,5.83,0.058,0.042,0.022
157076,2005,209,100,109,67,22,45,45,0.45,0.321,0.202
157085,2005,3824,2045,1779,1291,502,789,38.58,0.386,0.338,0.282
157289,2005,2255,1144,1111,497,205,292,25.52,0.255,0.22,0.185
157386,2005,1310,745,565,162,55,107,14.36,0.144,0.124,0.097
157401,2005,1442,841,601,532,180,352,41.85,0.419,0.369,0.3
157447,2005,1759,1000,759,185,50,135,13.5,0.135,0.105,0.066
157535,2005,206,98,108,31,8,23,23.47,0.235,0.15,0.074
157951,2005,3002,1680,1322,539,189,350,20.83,0.208,0.18,0.143
158477,2005,232,145,87,104,33,71,48.97,0.49,0.448,0.379
159009,2005,1129,568,561,82,22,60,10.56,0.106,0.073,0.039
159391,2005,4966,2653,2313,1440,576,864,32.57,0.326,0.29,0.249
159647,2005,1653,762,891,446,177,269,35.3,0.353,0.27,0.199
159717,2005,1311,743,568,177,52,125,16.82,0.168,0.135,0.092
159966,2005,1171,703,468,163,62,101,14.37,0.144,0.139,0.132
160038,2005,1417,869,548,218,71,147,16.92,0.169,0.154,0.13
160612,2005,2228,1388,840,252,74,178,12.82,0.128,0.113,0.088
160621,2005,1434,797,637,290,93,197,24.72,0.247,0.202,0.146
160658,2005,2730,1538,1192,329,102,227,14.76,0.148,0.121,0.086
161004,2005,477,257,220,420,189,231,89.88,0.899,0.881,0.859
161226,2005,559,387,172,229,60,169,43.67,0.437,0.41,0.349
161235,2005,129,69,60,22,9,13,18.84,0.188,0.171,0.15
161244,2005,106,71,35,17,5,12,16.9,0.169,0.16,0.143
161253,2005,1703,842,861,615,262,353,41.92,0.419,0.361,0.304
161554,2005,911,518,393,88,31,57,11,0.11,0.097,0.079
162007,2005,923,567,356,203,53,150,26.46,0.265,0.22,0.149
162210,2005,172,113,59,23,9,14,12.39,0.124,0.134,0.153
162283,2005,661,502,159,24,4,20,3.98,0.04,0.036,0.025
162584,2005,928,448,480,181,60,121,27.01,0.27,0.195,0.125
162654,2005,340,217,123,210,68,142,65.44,0.654,0.618,0.553
162760,2005,236,156,80,142,44,98,62.82,0.628,0.602,0.55
162928,2005,1228,587,641,1036,523,513,87.39,0.874,0.844,0.816
163046,2005,898,526,372,711,291,420,79.85,0.798,0.792,0.782
163268,2005,1414,584,830,466,237,229,39.21,0.392,0.33,0.286
163286,2005,4192,2081,2111,2769,1273,1496,71.89,0.719,0.661,0.603
163453,2005,764,408,356,89,22,67,16.42,0.164,0.116,0.062
163462,2005,437,267,170,315,127,188,70.41,0.704,0.721,0.747
163851,2005,952,525,427,442,146,296,56.38,0.564,0.464,0.342
163912,2005,488,295,193,341,130,211,71.53,0.715,0.699,0.674
164076,2005,2314,1455,859,910,270,640,43.99,0.44,0.393,0.314
164173,2005,537,373,164,236,61,175,46.92,0.469,0.439,0.372
164216,2005,345,201,144,247,90,157,78.11,0.781,0.716,0.625
164270,2005,447,246,201,314,136,178,72.36,0.724,0.702,0.677
164447,2005,328,160,168,65,32,33,20.62,0.206,0.198,0.19
164492,2005,156,79,77,58,27,31,39.24,0.392,0.372,0.351
164562,2005,565,328,237,369,132,237,72.26,0.723,0.653,0.557
165015,2005,737,397,340,647,287,360,90.68,0.907,0.878,0.844
165024,2005,1314,746,568,339,113,226,30.29,0.303,0.258,0.199
165334,2005,557,338,219,422,161,261,77.22,0.772,0.758,0.735
165662,2005,715,417,298,571,243,328,78.66,0.787,0.799,0.815
165671,2005,438,327,111,237,63,174,53.21,0.532,0.541,0.568
165820,2005,599,297,302,125,54,71,23.91,0.239,0.209,0.179
165866,2005,666,461,205,210,44,166,36.01,0.36,0.315,0.215
165936,2005,414,259,155,254,79,175,67.57,0.676,0.614,0.51
166027,2005,1637,819,818,1421,698,723,88.28,0.883,0.868,0.853
166124,2005,723,399,324,645,281,364,91.23,0.912,0.892,0.867
166513,2005,1062,390,672,318,160,158,40.51,0.405,0.299,0.238
166629,2005,4510,2316,2194,2268,970,1298,56.04,0.56,0.503,0.442
166638,2005,723,419,304,100,34,66,15.75,0.158,0.138,0.112
166683,2005,995,465,530,847,436,411,88.39,0.884,0.851,0.823
167288,2005,271,177,94,104,36,68,38.42,0.384,0.384,0.383
167987,2005,1703,816,887,505,212,293,35.91,0.359,0.297,0.239
167996,2005,616,354,262,478,190,288,81.36,0.814,0.776,0.725
168005,2005,1127,682,445,416,143,273,40.03,0.4,0.369,0.321
168148,2005,1364,682,682,1159,559,600,87.98,0.88,0.85,0.82
168254,2005,662,244,418,341,188,153,62.7,0.627,0.515,0.45
168281,2005,467,301,166,341,119,222,73.75,0.738,0.73,0.717
168342,2005,536,280,256,477,226,251,89.64,0.896,0.89,0.883
168546,2005,571,315,256,372,160,212,67.3,0.673,0.651,0.625
168786,2005,364,240,124,160,49,111,46.25,0.462,0.44,0.395
169080,2005,1000,564,436,598,232,366,64.89,0.649,0.598,0.532
169798,2005,2301,1416,885,297,89,208,14.69,0.147,0.129,0.101
169910,2005,2189,1003,1186,140,59,81,8.08,0.081,0.064,0.05
170082,2005,3407,2220,1187,1011,308,703,31.67,0.317,0.297,0.259
170301,2005,774,463,311,531,194,337,72.79,0.728,0.686,0.624
170532,2005,377,196,181,286,134,152,77.55,0.775,0.759,0.74
170639,2005,474,216,258,62,31,31,14.35,0.144,0.131,0.12
170976,2005,6080,3071,3009,4431,2061,2370,77.17,0.772,0.729,0.685
171100,2005,7303,4147,3156,3470,1232,2238,53.97,0.54,0.475,0.39
171128,2005,1321,236,1085,327,243,84,35.59,0.356,0.248,0.224
171137,2005,798,381,417,128,47,81,21.26,0.213,0.16,0.113
171146,2005,509,293,216,48,18,30,10.24,0.102,0.094,0.083
171599,2005,257,103,154,77,33,44,42.72,0.427,0.3,0.214
172051,2005,1233,742,491,102,26,76,10.24,0.102,0.083,0.053
172699,2005,3702,1917,1785,919,374,545,28.43,0.284,0.248,0.21
173160,2005,683,425,258,436,149,287,67.53,0.675,0.638,0.578
173258,2005,542,278,264,478,226,252,90.65,0.907,0.882,0.856
173328,2005,163,84,79,53,21,32,38.1,0.381,0.325,0.266
173647,2005,739,439,300,588,208,380,86.56,0.866,0.796,0.693
173902,2005,491,287,204,405,158,247,86.06,0.861,0.825,0.775
174066,2005,5274,2856,2418,2488,1023,1465,51.3,0.513,0.472,0.423
174233,2005,2111,1025,1086,565,243,322,31.41,0.314,0.268,0.224
174251,2005,353,207,146,171,63,108,52.17,0.522,0.484,0.432
174491,2005,476,295,181,221,76,145,49.15,0.492,0.464,0.42
174792,2005,447,0,447,325,325,0,NA,NA,0.727,0.727
174844,2005,764,426,338,617,270,347,81.46,0.815,0.808,0.799
174899,2005,490,350,140,265,70,195,55.71,0.557,0.541,0.5
174914,2005,1325,706,619,812,342,470,66.57,0.666,0.613,0.553
175342,2005,526,274,252,100,44,56,20.44,0.204,0.19,0.175
175421,2005,201,105,96,68,16,52,49.52,0.495,0.338,0.167
175616,2005,393,222,171,67,25,42,18.92,0.189,0.17,0.146
175856,2005,1131,690,441,221,64,157,22.75,0.228,0.195,0.145
175980,2005,258,118,140,158,76,82,69.49,0.695,0.612,0.543
176017,2005,2131,1139,992,800,280,520,45.65,0.456,0.375,0.282
176035,2005,238,204,34,53,5,48,23.53,0.235,0.223,0.147
176044,2005,398,197,201,43,13,30,15.23,0.152,0.108,0.065
176080,2005,1951,1010,941,585,215,370,36.63,0.366,0.3,0.228
176406,2005,207,146,61,61,15,46,31.51,0.315,0.295,0.246
176628,2005,154,95,59,38,11,27,28.42,0.284,0.247,0.186
176947,2005,223,96,127,73,29,44,45.83,0.458,0.327,0.228
176965,2005,1484,810,674,410,164,246,30.37,0.304,0.276,0.243
177418,2005,187,136,51,44,9,35,25.74,0.257,0.235,0.176
178059,2005,322,232,90,182,42,140,60.34,0.603,0.565,0.467
178341,2005,836,466,370,106,32,74,15.88,0.159,0.127,0.086
178387,2005,1005,557,448,111,42,69,12.39,0.124,0.11,0.094
178396,2005,4662,2513,2149,2087,810,1277,50.82,0.508,0.448,0.377
178402,2005,1007,574,433,173,61,112,19.51,0.195,0.172,0.141
178411,2005,877,168,709,224,154,70,41.67,0.417,0.255,0.217
178420,2005,497,288,209,124,41,83,28.82,0.288,0.249,0.196
178615,2005,1441,830,611,626,232,394,47.47,0.475,0.434,0.38
179043,2005,370,203,167,237,110,127,62.56,0.626,0.641,0.659
179159,2005,1521,859,662,925,377,548,63.8,0.638,0.608,0.569
179557,2005,1538,918,620,369,102,267,29.08,0.291,0.24,0.165
179566,2005,2575,1490,1085,822,273,549,36.85,0.368,0.319,0.252
179867,2005,1372,715,657,1186,544,642,89.79,0.898,0.864,0.828
179894,2005,394,224,170,175,76,99,44.2,0.442,0.444,0.447
179946,2005,287,125,162,143,65,78,62.4,0.624,0.498,0.401
180179,2005,796,463,333,79,26,53,11.45,0.114,0.099,0.078
180461,2005,1980,843,1137,412,198,214,25.39,0.254,0.208,0.174
180522,2005,192,55,137,15,10,5,9.09,0.091,0.078,0.073
180984,2005,289,146,143,113,33,80,54.79,0.548,0.391,0.231
181002,2005,970,562,408,640,257,383,68.15,0.682,0.66,0.63
181020,2005,256,146,110,153,56,97,66.44,0.664,0.598,0.509
181127,2005,312,133,179,143,69,74,55.64,0.556,0.458,0.385
181215,2005,1013,584,429,228,71,157,26.88,0.269,0.225,0.166
181394,2005,1690,911,779,259,105,154,16.9,0.169,0.153,0.135
181446,2005,406,237,169,236,82,154,64.98,0.65,0.581,0.485
181464,2005,3533,1671,1862,1118,505,613,36.68,0.367,0.316,0.271
181534,2005,213,112,101,26,7,19,16.96,0.17,0.122,0.069
181783,2005,587,320,267,162,71,91,28.44,0.284,0.276,0.266
182281,2005,2964,1694,1270,402,134,268,15.82,0.158,0.136,0.106
182290,2005,2362,1300,1062,383,136,247,19,0.19,0.162,0.128
182634,2005,280,179,101,130,42,88,49.16,0.492,0.464,0.416
182795,2005,532,270,262,2,0,2,0.74,0.007,0.004,0
183062,2005,1001,565,436,434,172,262,46.37,0.464,0.434,0.394
183080,2005,999,473,526,401,193,208,43.97,0.44,0.401,0.367
183239,2005,519,296,223,372,145,227,76.69,0.767,0.717,0.65
183822,2005,367,210,157,37,15,22,10.48,0.105,0.101,0.096
183974,2005,240,160,80,115,35,80,50,0.5,0.479,0.438
184348,2005,391,218,173,240,103,137,62.84,0.628,0.614,0.595
184603,2005,425,269,156,100,31,69,25.65,0.256,0.235,0.199
184612,2005,236,163,73,38,13,25,15.34,0.153,0.161,0.178
184782,2005,1239,607,632,554,270,284,46.79,0.468,0.447,0.427
185129,2005,601,334,267,39,17,22,6.59,0.066,0.065,0.064
185572,2005,942,503,439,436,176,260,51.69,0.517,0.463,0.401
185590,2005,1868,1065,803,635,188,447,41.97,0.42,0.34,0.234
185828,2005,746,129,617,126,101,25,19.38,0.194,0.169,0.164
186131,2005,1224,558,666,1066,562,504,90.32,0.903,0.871,0.844
186201,2005,746,460,286,445,137,308,66.96,0.67,0.597,0.479
186283,2005,934,526,408,482,183,299,56.84,0.568,0.516,0.449
186584,2005,1115,582,533,576,236,340,58.42,0.584,0.517,0.443
186876,2005,808,460,348,346,104,242,52.61,0.526,0.428,0.299
187134,2005,1236,685,551,914,383,531,77.52,0.775,0.739,0.695
187444,2005,1296,652,644,235,89,146,22.39,0.224,0.181,0.138
187985,2005,3010,1717,1293,372,130,242,14.09,0.141,0.124,0.101
188030,2005,1945,1092,853,289,96,193,17.67,0.177,0.149,0.113
188429,2005,754,505,249,416,121,295,58.42,0.584,0.552,0.486
188641,2005,429,188,241,186,85,101,53.72,0.537,0.434,0.353
190044,2005,630,173,457,380,274,106,61.27,0.613,0.603,0.6
190099,2005,729,368,361,640,311,329,89.4,0.894,0.878,0.861
190150,2005,1403,660,743,1189,621,568,86.06,0.861,0.847,0.836
190248,2005,140,83,57,49,12,37,44.58,0.446,0.35,0.211
190415,2005,3071,1541,1530,2664,1286,1378,89.42,0.894,0.867,0.841
190512,2005,1625,784,841,577,266,311,39.67,0.397,0.355,0.316
190549,2005,1372,757,615,294,109,185,24.44,0.244,0.214,0.177
190558,2005,1888,1048,840,62,31,31,2.96,0.03,0.033,0.037
190567,2005,1278,592,686,78,39,39,6.59,0.066,0.061,0.057
190594,2005,1776,1199,577,356,97,259,21.6,0.216,0.2,0.168
190637,2005,788,551,237,110,33,77,13.97,0.14,0.14,0.139
190664,2005,1470,884,586,381,101,280,31.67,0.317,0.259,0.172
190691,2005,746,481,265,27,5,22,4.57,0.046,0.036,0.019
190725,2005,366,288,78,91,12,79,27.43,0.274,0.249,0.154
191241,2005,1734,983,751,1282,548,734,74.67,0.747,0.739,0.73
191515,2005,496,248,248,417,198,219,88.31,0.883,0.841,0.798
191533,2005,405,212,193,182,77,105,49.53,0.495,0.449,0.399
191630,2005,545,283,262,377,159,218,77.03,0.77,0.692,0.607
191649,2005,1759,961,798,763,281,482,50.16,0.502,0.434,0.352
191676,2005,321,211,110,180,57,123,58.29,0.583,0.561,0.518
191931,2005,776,419,357,375,150,225,53.7,0.537,0.483,0.42
191968,2005,1679,885,794,1117,521,596,67.34,0.673,0.665,0.656
192192,2005,268,179,89,111,31,80,44.69,0.447,0.414,0.348
192323,2005,519,308,211,320,123,197,63.96,0.64,0.617,0.583
192439,2005,959,643,316,51,10,41,6.38,0.064,0.053,0.032
192703,2005,700,368,332,456,198,258,70.11,0.701,0.651,0.596
192749,2005,506,327,179,264,73,191,58.41,0.584,0.522,0.408
192819,2005,1017,585,432,697,258,439,75.04,0.75,0.685,0.597
192925,2005,203,126,77,62,27,35,27.78,0.278,0.305,0.351
193016,2005,485,324,161,53,11,42,12.96,0.13,0.109,0.068
193292,2005,274,190,84,109,31,78,41.05,0.41,0.398,0.369
193353,2005,356,247,109,154,45,109,44.13,0.441,0.433,0.413
193399,2005,343,247,96,136,32,104,42.11,0.421,0.397,0.333
193584,2005,451,342,109,303,56,247,72.22,0.722,0.672,0.514
193645,2005,943,883,60,168,1,167,18.91,0.189,0.178,0.017
193654,2005,789,558,231,355,86,269,48.21,0.482,0.45,0.372
193900,2005,4639,2853,1786,2941,1168,1773,62.15,0.622,0.634,0.654
193973,2005,730,444,286,435,160,275,61.94,0.619,0.596,0.559
194161,2005,256,137,119,60,21,39,28.47,0.285,0.234,0.176
194310,2005,1474,954,520,584,186,398,41.72,0.417,0.396,0.358
194824,2005,1236,283,953,745,550,195,68.9,0.689,0.603,0.577
195003,2005,2184,656,1528,587,289,298,45.43,0.454,0.269,0.189
195030,2005,1106,563,543,808,376,432,76.73,0.767,0.731,0.692
195164,2005,477,225,252,239,112,127,56.44,0.564,0.501,0.444
195173,2005,497,224,273,140,68,72,32.14,0.321,0.282,0.249
195216,2005,534,268,266,407,190,217,80.97,0.81,0.762,0.714
195234,2005,595,411,184,330,75,255,62.04,0.62,0.555,0.408
195243,2005,327,188,139,119,43,76,40.43,0.404,0.364,0.309
195304,2005,376,285,91,237,50,187,65.61,0.656,0.63,0.549
195474,2005,763,443,320,531,225,306,69.07,0.691,0.696,0.703
195526,2005,694,433,261,567,202,365,84.3,0.843,0.817,0.774
195544,2005,605,446,159,291,57,234,52.47,0.525,0.481,0.358
195809,2005,3153,1742,1411,1098,435,663,38.06,0.381,0.348,0.308
196413,2005,3243,1849,1394,2261,903,1358,73.45,0.735,0.697,0.648
196592,2005,1839,1261,578,40,13,27,2.14,0.021,0.022,0.022
197045,2005,468,264,204,139,52,87,32.95,0.33,0.297,0.255
197133,2005,647,374,273,572,238,334,89.3,0.893,0.884,0.872
197869,2005,2536,1265,1271,974,391,583,46.09,0.461,0.384,0.308
197984,2005,224,109,115,75,23,52,47.71,0.477,0.335,0.2
198385,2005,459,234,225,400,182,218,93.16,0.932,0.871,0.809
198464,2005,3220,1973,1247,1048,345,703,35.63,0.356,0.325,0.277
198507,2005,556,328,228,99,28,71,21.65,0.216,0.178,0.123
198516,2005,1237,748,489,959,370,589,78.74,0.787,0.775,0.757
198835,2005,326,203,123,122,37,85,41.87,0.419,0.374,0.301
198969,2005,387,143,244,59,22,37,25.87,0.259,0.152,0.09
199102,2005,2237,1178,1059,369,116,253,21.48,0.215,0.165,0.11
199111,2005,471,291,180,154,51,103,35.4,0.354,0.327,0.283
199120,2005,3747,2270,1477,2819,1050,1769,77.93,0.779,0.752,0.711
199139,2005,2859,1498,1361,741,273,468,31.24,0.312,0.259,0.201
199148,2005,2399,1690,709,670,125,545,32.25,0.322,0.279,0.176
199157,2005,1195,800,395,181,45,136,17,0.17,0.151,0.114
199193,2005,4364,1918,2446,1732,716,1016,52.97,0.53,0.397,0.293
199218,2005,1933,1133,800,842,302,540,47.66,0.477,0.436,0.378
199281,2005,961,528,433,142,50,92,17.42,0.174,0.148,0.115
199306,2005,198,90,108,74,28,46,51.11,0.511,0.374,0.259
199412,2005,238,171,67,116,30,86,50.29,0.503,0.487,0.448
199582,2005,261,129,132,34,16,18,13.95,0.139,0.13,0.121
199643,2005,573,307,266,75,29,46,14.98,0.15,0.131,0.109
199847,2005,1114,565,549,918,431,487,86.19,0.862,0.824,0.785
199962,2005,371,183,188,154,54,100,54.64,0.546,0.415,0.287
199999,2005,1050,701,349,167,42,125,17.83,0.178,0.159,0.12
200004,2005,1549,775,774,453,181,272,35.1,0.351,0.292,0.234
200059,2005,317,162,155,29,11,18,11.11,0.111,0.091,0.071
200156,2005,270,139,131,67,24,43,30.94,0.309,0.248,0.183
200217,2005,392,220,172,103,28,75,34.09,0.341,0.263,0.163
200226,2005,144,63,81,28,10,18,28.57,0.286,0.194,0.123
200253,2005,431,240,191,64,19,45,18.75,0.188,0.148,0.099
200280,2005,1851,858,993,425,198,227,26.46,0.265,0.23,0.199
200332,2005,1970,940,1030,457,191,266,28.3,0.283,0.232,0.185
200572,2005,171,73,98,40,16,24,32.88,0.329,0.234,0.163
201104,2005,573,357,216,271,86,185,51.82,0.518,0.473,0.398
201371,2005,228,141,87,123,45,78,55.32,0.553,0.539,0.517
201548,2005,599,363,236,310,109,201,55.37,0.554,0.518,0.462
201645,2005,1162,456,706,702,386,316,69.3,0.693,0.604,0.547
201690,2005,343,156,187,31,15,16,10.26,0.103,0.09,0.08
202134,2005,955,507,448,87,31,56,11.05,0.111,0.091,0.069
202480,2005,1970,1004,966,1149,475,674,67.13,0.671,0.583,0.492
202523,2005,620,337,283,473,211,262,77.74,0.777,0.763,0.746
202763,2005,584,399,185,240,64,176,44.11,0.441,0.411,0.346
203085,2005,324,135,189,174,85,89,65.93,0.659,0.537,0.45
203128,2005,208,101,107,125,57,68,67.33,0.673,0.601,0.533
203368,2005,786,401,385,504,217,287,71.57,0.716,0.641,0.564
203517,2005,3727,2325,1402,970,294,676,29.08,0.291,0.26,0.21
203535,2005,439,239,200,364,165,199,83.26,0.833,0.829,0.825
203580,2005,116,88,28,49,8,41,46.59,0.466,0.422,0.286
203775,2005,357,199,158,165,61,104,52.26,0.523,0.462,0.386
203845,2005,387,179,208,162,68,94,52.51,0.525,0.419,0.327
204024,2005,3150,1708,1442,2198,902,1296,75.88,0.759,0.698,0.626
204185,2005,503,260,243,274,104,170,65.38,0.654,0.545,0.428
204194,2005,380,241,139,149,49,100,41.49,0.415,0.392,0.353
204617,2005,372,172,200,129,65,64,37.21,0.372,0.347,0.325
204796,2005,5929,3005,2924,3032,1219,1813,60.33,0.603,0.511,0.417
204857,2005,4078,2148,1930,1788,697,1091,50.79,0.508,0.438,0.361
206330,2005,240,74,166,51,27,24,32.43,0.324,0.212,0.163
206589,2005,536,267,269,362,158,204,76.4,0.764,0.675,0.587
206604,2005,2302,1331,971,413,141,272,20.44,0.204,0.179,0.145
206622,2005,765,430,335,523,206,317,73.72,0.737,0.684,0.615
206695,2005,2012,1029,983,177,61,116,11.27,0.113,0.088,0.062
206914,2005,714,430,284,37,22,15,3.49,0.035,0.052,0.077
207209,2005,670,316,354,31,3,28,8.86,0.089,0.046,0.008
207306,2005,279,150,129,37,10,27,18,0.18,0.133,0.078
207324,2005,523,270,253,144,57,87,32.22,0.322,0.275,0.225
207388,2005,3221,1662,1559,1106,436,670,40.31,0.403,0.343,0.28
207500,2005,3189,1695,1494,1107,418,689,40.65,0.406,0.347,0.28
207722,2005,233,122,111,61,30,31,25.41,0.254,0.262,0.27
207847,2005,587,298,289,62,22,40,13.42,0.134,0.106,0.076
207865,2005,766,403,363,127,43,84,20.84,0.208,0.166,0.118
208822,2005,460,287,173,241,86,155,54.01,0.54,0.524,0.497
209056,2005,490,294,196,324,125,199,67.69,0.677,0.661,0.638
209065,2005,481,260,221,293,113,180,69.23,0.692,0.609,0.511
209542,2005,2817,1385,1432,819,306,513,37.04,0.37,0.291,0.214
209551,2005,3138,1721,1417,1282,506,776,45.09,0.451,0.409,0.357
209612,2005,324,204,120,165,52,113,55.39,0.554,0.509,0.433
209807,2005,1200,636,564,172,66,106,16.67,0.167,0.143,0.117
209922,2005,348,197,151,204,80,124,62.94,0.629,0.586,0.53
210146,2005,707,417,290,110,30,80,19.18,0.192,0.156,0.103
210401,2005,440,240,200,307,130,177,73.75,0.738,0.698,0.65
210429,2005,849,511,338,132,36,96,18.79,0.188,0.155,0.107
210571,2005,450,254,196,234,85,149,58.66,0.587,0.52,0.434
210669,2005,561,311,250,424,181,243,78.14,0.781,0.756,0.724
210775,2005,262,149,113,100,35,65,43.62,0.436,0.382,0.31
211088,2005,432,315,117,232,59,173,54.92,0.549,0.537,0.504
211158,2005,1690,1050,640,693,207,486,46.29,0.463,0.41,0.323
211291,2005,920,504,416,804,352,452,89.68,0.897,0.874,0.846
211352,2005,526,385,141,257,60,197,51.17,0.512,0.489,0.426
211361,2005,1247,640,607,298,119,179,27.97,0.28,0.239,0.196
211431,2005,273,264,9,102,3,99,37.5,0.375,0.374,0.333
211440,2005,1408,533,875,1000,611,389,72.98,0.73,0.71,0.698
211468,2005,203,202,1,82,1,81,40.1,0.401,0.404,1
211556,2005,116,116,0,57,0,57,49.14,0.491,0.491,NA
211583,2005,219,150,69,73,23,50,33.33,0.333,0.333,0.333
211608,2005,397,219,178,51,21,30,13.7,0.137,0.128,0.118
211644,2005,1173,731,442,288,92,196,26.81,0.268,0.246,0.208
211981,2005,448,271,177,206,54,152,56.09,0.561,0.46,0.305
212009,2005,647,359,288,530,227,303,84.4,0.844,0.819,0.788
212054,2005,2346,916,1430,663,274,389,42.47,0.425,0.283,0.192
212106,2005,1325,811,514,711,244,467,57.58,0.576,0.537,0.475
212115,2005,1087,634,453,392,110,282,44.48,0.445,0.361,0.243
212133,2005,445,300,145,239,70,169,56.33,0.563,0.537,0.483
212160,2005,1268,719,549,297,82,215,29.9,0.299,0.234,0.149
212197,2005,500,337,163,356,104,252,74.78,0.748,0.712,0.638
212577,2005,581,298,283,468,211,257,86.24,0.862,0.806,0.746
212601,2005,619,375,244,292,104,188,50.13,0.501,0.472,0.426
212832,2005,280,210,70,21,15,6,2.86,0.029,0.075,0.214
212911,2005,316,168,148,287,131,156,92.86,0.929,0.908,0.885
213020,2005,2462,1335,1127,713,245,468,35.06,0.351,0.29,0.217
213251,2005,387,212,175,279,120,159,75,0.75,0.721,0.686
213321,2005,479,198,281,282,149,133,67.17,0.672,0.589,0.53
213349,2005,1905,1105,800,621,190,431,39,0.39,0.326,0.238
213358,2005,302,203,99,103,32,71,34.98,0.35,0.341,0.323
213367,2005,803,440,363,400,160,240,54.55,0.545,0.498,0.441
213385,2005,596,275,321,508,268,240,87.27,0.873,0.852,0.835
213507,2005,454,223,231,304,138,166,74.44,0.744,0.67,0.597
213543,2005,1223,512,711,956,521,435,84.96,0.85,0.782,0.733
213613,2005,1215,695,520,314,110,204,29.35,0.294,0.258,0.212
213668,2005,357,219,138,216,74,142,64.84,0.648,0.605,0.536
213783,2005,662,406,256,216,62,154,37.93,0.379,0.326,0.242
213826,2005,301,230,71,153,30,123,53.48,0.535,0.508,0.423
213996,2005,707,439,268,500,177,323,73.58,0.736,0.707,0.66
214041,2005,1306,774,532,501,172,329,42.51,0.425,0.384,0.323
214069,2005,324,222,102,181,52,129,58.11,0.581,0.559,0.51
214157,2005,382,204,178,280,123,157,76.96,0.77,0.733,0.691
214175,2005,576,322,254,454,180,274,85.09,0.851,0.788,0.709
214272,2005,522,334,188,163,46,117,35.03,0.35,0.312,0.245
214777,2005,6499,2976,3523,4096,1969,2127,71.47,0.715,0.63,0.559
215062,2005,2479,1260,1219,2162,1033,1129,89.6,0.896,0.872,0.847
215743,2005,364,220,144,190,59,131,59.55,0.596,0.522,0.41
215798,2005,481,254,227,308,141,167,65.75,0.657,0.64,0.621
215929,2005,943,551,392,629,248,381,69.15,0.692,0.667,0.633
216010,2005,1495,775,720,622,233,389,50.19,0.502,0.416,0.324
216038,2005,1457,800,657,556,216,340,42.5,0.425,0.382,0.329
216287,2005,389,198,191,355,171,184,92.93,0.929,0.913,0.895
216339,2005,3841,2175,1666,1247,483,764,35.13,0.351,0.325,0.29
216524,2005,411,222,189,309,136,173,77.93,0.779,0.752,0.72
216694,2005,340,208,132,171,58,113,54.33,0.543,0.503,0.439
216764,2005,1898,1219,679,812,216,596,48.89,0.489,0.428,0.318
216807,2005,360,231,129,223,75,148,64.07,0.641,0.619,0.581
216852,2005,646,332,314,258,98,160,48.19,0.482,0.399,0.312
216931,2005,562,297,265,270,114,156,52.53,0.525,0.48,0.43
217059,2005,1078,591,487,442,175,267,45.18,0.452,0.41,0.359
217156,2005,1439,735,704,1197,577,620,84.35,0.843,0.832,0.82
217402,2005,1064,593,471,857,367,490,82.63,0.826,0.805,0.779
217536,2005,562,418,144,382,82,300,71.77,0.718,0.68,0.569
217776,2005,176,110,66,46,18,28,25.45,0.254,0.261,0.273
217819,2005,1984,1342,642,1031,291,740,55.14,0.551,0.52,0.453
217882,2005,2893,1426,1467,1565,611,954,66.9,0.669,0.541,0.416
217998,2005,181,90,91,82,33,49,54.44,0.544,0.453,0.363
218061,2005,797,517,280,158,40,118,22.82,0.228,0.198,0.143
218229,2005,555,369,186,110,34,76,20.6,0.206,0.198,0.183
218238,2005,201,99,102,40,10,30,30.3,0.303,0.199,0.098
218399,2005,207,130,77,30,9,21,16.15,0.161,0.145,0.117
218414,2005,275,96,179,67,34,33,34.38,0.344,0.244,0.19
218663,2005,3677,2087,1590,1881,682,1199,57.45,0.575,0.512,0.429
218724,2005,1493,775,718,375,130,245,31.61,0.316,0.251,0.181
218733,2005,1002,544,458,140,50,90,16.54,0.165,0.14,0.109
218742,2005,718,469,249,153,41,112,23.88,0.239,0.213,0.165
218973,2005,320,144,176,241,123,118,81.94,0.819,0.753,0.699
219000,2005,390,256,134,192,54,138,53.91,0.539,0.492,0.403
219046,2005,584,353,231,74,22,52,14.73,0.147,0.127,0.095
219082,2005,280,135,145,29,14,15,11.11,0.111,0.104,0.097
219198,2005,139,91,48,54,15,39,42.86,0.429,0.388,0.312
219259,2005,368,197,171,47,13,34,17.26,0.173,0.128,0.076
219356,2005,1784,893,891,528,213,315,35.27,0.353,0.296,0.239
219471,2005,1030,621,409,236,74,162,26.09,0.261,0.229,0.181
219602,2005,1226,708,518,175,70,105,14.83,0.148,0.143,0.135
219709,2005,791,488,303,483,180,303,62.09,0.621,0.611,0.594
219718,2005,234,108,126,29,9,20,18.52,0.185,0.124,0.071
219949,2005,217,107,110,44,17,27,25.23,0.252,0.203,0.155
220075,2005,1565,897,668,308,102,206,22.97,0.23,0.197,0.153
220215,2005,373,203,170,139,61,78,38.42,0.384,0.373,0.359
220613,2005,755,454,301,297,99,198,43.61,0.436,0.393,0.329
220631,2005,139,90,49,25,6,19,21.11,0.211,0.18,0.122
220710,2005,333,163,170,158,67,91,55.83,0.558,0.474,0.394
221351,2005,440,255,185,313,131,182,71.37,0.714,0.711,0.708
221519,2005,420,241,179,337,144,193,80.08,0.801,0.802,0.804
221731,2005,167,100,67,52,14,38,38,0.38,0.311,0.209
221847,2005,1409,623,786,321,121,200,32.1,0.321,0.228,0.154
221892,2005,239,124,115,95,40,55,44.35,0.444,0.397,0.348
222178,2005,1030,560,470,393,150,243,43.39,0.434,0.382,0.319
222983,2005,347,171,176,239,103,136,79.53,0.795,0.689,0.585
223232,2005,3158,1867,1291,1641,582,1059,56.72,0.567,0.52,0.451
224004,2005,196,96,100,40,12,28,29.17,0.292,0.204,0.12
224323,2005,256,165,91,160,53,107,64.85,0.648,0.625,0.582
225432,2005,889,487,402,20,8,12,2.46,0.025,0.022,0.02
225548,2005,281,146,135,104,41,63,43.15,0.432,0.37,0.304
225627,2005,571,394,177,114,23,91,23.1,0.231,0.2,0.13
226231,2005,317,74,243,95,66,29,39.19,0.392,0.3,0.272
226833,2005,818,447,371,100,27,73,16.33,0.163,0.122,0.073
227216,2005,3557,2008,1549,760,214,546,27.19,0.272,0.214,0.138
227331,2005,269,204,65,1,1,0,0,0,0.004,0.015
227526,2005,1155,668,487,126,39,87,13.02,0.13,0.109,0.08
227757,2005,722,337,385,571,279,292,86.65,0.867,0.791,0.725
227845,2005,646,401,245,333,109,224,55.86,0.559,0.515,0.445
227863,2005,289,185,104,75,27,48,25.95,0.26,0.26,0.26
228042,2005,167,92,75,50,19,31,33.7,0.337,0.299,0.253
228149,2005,494,314,180,147,38,109,34.71,0.347,0.298,0.211
228246,2005,1401,754,647,846,345,501,66.45,0.665,0.604,0.533
228343,2005,327,192,135,223,87,136,70.83,0.708,0.682,0.644
228431,2005,1967,1199,768,441,125,316,26.36,0.264,0.224,0.163
228459,2005,3053,1786,1267,825,235,590,33.03,0.33,0.27,0.185
228501,2005,329,127,202,31,19,12,9.45,0.094,0.094,0.094
228529,2005,1188,678,510,212,65,147,21.68,0.217,0.178,0.127
228705,2005,606,244,362,83,40,43,17.62,0.176,0.137,0.11
228723,2005,6713,3406,3307,3352,1259,2093,61.45,0.615,0.499,0.381
228769,2005,2075,1069,1006,347,130,217,20.3,0.203,0.167,0.129
228778,2005,6783,3630,3153,3572,1419,2153,59.31,0.593,0.527,0.45
228787,2005,1058,403,655,433,235,198,49.13,0.491,0.409,0.359
228796,2005,2154,1085,1069,210,74,136,12.53,0.125,0.097,0.069
228875,2005,1610,977,633,875,284,591,60.49,0.605,0.543,0.449
228981,2005,379,182,197,106,35,71,39.01,0.39,0.28,0.178
229018,2005,300,173,127,53,18,35,20.23,0.202,0.177,0.142
229027,2005,4360,2240,2120,348,127,221,9.87,0.099,0.08,0.06
229115,2005,3743,1829,1914,1323,530,793,43.36,0.434,0.353,0.277
229780,2005,222,124,98,44,11,33,26.61,0.266,0.198,0.112
229814,2005,768,409,359,171,66,105,25.67,0.257,0.223,0.184
230603,2005,784,527,257,137,30,107,20.3,0.203,0.175,0.117
230728,2005,1618,1065,553,415,75,340,31.92,0.319,0.256,0.136
230764,2005,1997,1106,891,415,138,277,25.05,0.25,0.208,0.155
230782,2005,1626,879,747,68,23,45,5.12,0.051,0.042,0.031
231059,2005,592,331,261,454,188,266,80.36,0.804,0.767,0.72
231174,2005,2378,1287,1091,1367,568,799,62.08,0.621,0.575,0.521
231420,2005,229,84,145,59,33,26,30.95,0.31,0.258,0.228
231554,2005,103,57,46,32,15,17,29.82,0.298,0.311,0.326
231624,2005,1339,714,625,1134,489,645,90.34,0.903,0.847,0.782
231712,2005,1245,667,578,578,203,375,56.22,0.562,0.464,0.351
232025,2005,338,155,183,177,80,97,62.58,0.626,0.524,0.437
232043,2005,202,123,79,116,40,76,61.79,0.618,0.574,0.506
232089,2005,330,110,220,53,18,35,31.82,0.318,0.161,0.082
232186,2005,2454,1339,1115,999,348,651,48.62,0.486,0.407,0.312
232265,2005,1099,701,398,445,114,331,47.22,0.472,0.405,0.286
232423,2005,3796,2421,1375,2465,803,1662,68.65,0.687,0.649,0.584
232557,2005,1915,982,933,488,204,284,28.92,0.289,0.255,0.219
232566,2005,938,632,306,379,88,291,46.04,0.46,0.404,0.288
232609,2005,553,321,232,246,84,162,50.47,0.505,0.445,0.362
232681,2005,877,581,296,552,159,393,67.64,0.676,0.629,0.537
232706,2005,422,310,112,152,34,118,38.06,0.381,0.36,0.304
232937,2005,957,551,406,138,39,99,17.97,0.18,0.144,0.096
232982,2005,2054,1160,894,474,145,329,28.36,0.284,0.231,0.162
233277,2005,1890,1101,789,725,254,471,42.78,0.428,0.384,0.322
233374,2005,775,401,374,593,268,325,81.05,0.81,0.765,0.717
233426,2005,534,310,224,316,120,196,63.23,0.632,0.592,0.536
233541,2005,369,211,158,123,44,79,37.44,0.374,0.333,0.278
233897,2005,366,186,180,94,27,67,36.02,0.36,0.257,0.15
233921,2005,5026,2190,2836,2797,1296,1501,68.54,0.685,0.557,0.457
234030,2005,3432,2052,1380,904,306,598,29.14,0.291,0.263,0.222
234085,2005,363,40,323,209,187,22,55,0.55,0.576,0.579
234155,2005,1176,775,401,234,48,186,24,0.24,0.199,0.12
234164,2005,356,197,159,57,14,43,21.83,0.218,0.16,0.088
235097,2005,1610,992,618,340,120,220,22.18,0.222,0.211,0.194
235167,2005,590,296,294,243,114,129,43.58,0.436,0.412,0.388
236230,2005,687,432,255,340,106,234,54.17,0.542,0.495,0.416
236328,2005,669,385,284,446,180,266,69.09,0.691,0.667,0.634
236577,2005,710,490,220,425,123,302,61.63,0.616,0.599,0.559
236595,2005,739,454,285,422,156,266,58.59,0.586,0.571,0.547
236896,2005,292,132,160,62,34,28,21.21,0.212,0.212,0.212
236939,2005,2855,1418,1437,1072,413,659,46.47,0.465,0.375,0.287
236948,2005,4892,2622,2270,2883,1209,1674,63.84,0.638,0.589,0.533
237011,2005,2365,1364,1001,943,302,641,46.99,0.47,0.399,0.302
237057,2005,360,180,180,288,140,148,82.22,0.822,0.8,0.778
237066,2005,451,266,185,304,125,179,67.29,0.673,0.674,0.676
237215,2005,246,133,113,5,3,2,1.5,0.015,0.02,0.027
237330,2005,639,352,287,104,35,69,19.6,0.196,0.163,0.122
237358,2005,109,67,42,25,5,20,29.85,0.299,0.229,0.119
237367,2005,653,367,286,97,35,62,16.89,0.169,0.149,0.122
237792,2005,657,352,305,134,52,82,23.3,0.233,0.204,0.17
237899,2005,306,152,154,21,11,10,6.58,0.066,0.069,0.071
237932,2005,416,234,182,94,25,69,29.49,0.295,0.226,0.137
237969,2005,307,161,146,129,38,91,56.52,0.565,0.42,0.26
238032,2005,4524,2126,2398,1457,639,818,38.48,0.385,0.322,0.266
238333,2005,326,198,128,216,71,145,73.23,0.732,0.663,0.555
238430,2005,182,139,43,19,4,15,10.79,0.108,0.104,0.093
238458,2005,598,383,215,231,63,168,43.86,0.439,0.386,0.293
238476,2005,593,315,278,281,120,161,51.11,0.511,0.474,0.432
238616,2005,386,207,179,134,52,82,39.61,0.396,0.347,0.291
238661,2005,281,210,71,77,21,56,26.67,0.267,0.274,0.296
239080,2005,262,190,72,78,17,61,32.11,0.321,0.298,0.236
239105,2005,1775,967,808,1083,448,635,65.67,0.657,0.61,0.554
239628,2005,261,119,142,148,70,78,65.55,0.655,0.567,0.493
239716,2005,504,282,222,328,147,181,64.18,0.642,0.651,0.662
240107,2005,289,207,82,82,11,71,34.3,0.343,0.284,0.134
240189,2005,1701,823,878,437,196,241,29.28,0.293,0.257,0.223
240277,2005,904,587,317,198,45,153,26.06,0.261,0.219,0.142
240329,2005,1755,1056,699,579,176,403,38.16,0.382,0.33,0.252
240338,2005,180,110,70,81,33,48,43.64,0.436,0.45,0.471
240365,2005,1617,982,635,234,81,153,15.58,0.156,0.145,0.128
240374,2005,783,442,341,61,27,34,7.69,0.077,0.078,0.079
240417,2005,1699,863,836,322,103,219,25.38,0.254,0.19,0.123
240426,2005,336,208,128,61,11,50,24.04,0.24,0.182,0.086
240444,2005,6118,3434,2684,3174,1255,1919,55.88,0.559,0.519,0.468
240453,2005,4218,2233,1985,604,258,346,15.49,0.155,0.143,0.13
240462,2005,1218,426,792,187,83,104,24.41,0.244,0.154,0.105
240471,2005,1192,734,458,268,80,188,25.61,0.256,0.225,0.175
240480,2005,1521,832,689,365,136,229,27.52,0.275,0.24,0.197
240727,2005,1399,739,660,320,107,213,28.82,0.288,0.229,0.162
243443,2005,796,500,296,66,8,58,11.6,0.116,0.083,0.027
243780,2005,7167,2860,4307,2547,1189,1358,47.48,0.475,0.355,0.276
100654,2006,1133,584,549,110,29,81,13.87,0.139,0.097,0.053
100663,2006,1485,895,590,378,124,254,28.38,0.284,0.255,0.21
100751,2006,4275,2377,1898,1757,660,1097,46.15,0.462,0.411,0.348
100858,2006,4072,2168,1904,1556,549,1007,46.45,0.464,0.382,0.288
101435,2006,214,85,129,72,36,36,42.35,0.424,0.336,0.279
101480,2006,1106,626,480,106,23,83,13.26,0.133,0.096,0.048
101675,2006,352,159,193,15,3,12,7.55,0.076,0.043,0.016
101879,2006,1019,575,444,112,26,86,14.96,0.15,0.11,0.059
102049,2006,644,392,252,326,99,227,57.91,0.579,0.506,0.393
102094,2006,1355,777,578,190,55,135,17.37,0.174,0.14,0.095
102234,2006,345,226,119,189,62,127,56.19,0.562,0.548,0.521
102368,2006,1666,964,702,238,77,161,16.7,0.167,0.143,0.11
102377,2006,688,395,293,151,33,118,29.87,0.299,0.219,0.113
104151,2006,8533,4556,3977,2837,1145,1692,37.14,0.371,0.332,0.288
104179,2006,5788,3092,2696,2085,813,1272,41.14,0.411,0.36,0.302
105330,2006,2527,1488,1039,756,224,532,35.75,0.358,0.299,0.216
106245,2006,603,317,286,40,19,21,6.62,0.066,0.066,0.066
106342,2006,128,61,67,56,27,29,47.54,0.475,0.438,0.403
106397,2006,2719,1346,1373,945,398,547,40.64,0.406,0.348,0.29
106412,2006,688,340,348,55,18,37,10.88,0.109,0.08,0.052
106458,2006,1659,946,713,345,124,221,23.36,0.234,0.208,0.174
106467,2006,1426,711,715,234,83,151,21.24,0.212,0.164,0.116
106485,2006,630,335,295,71,28,43,12.84,0.128,0.113,0.095
106704,2006,2352,1340,1012,538,187,351,26.19,0.262,0.229,0.185
107044,2006,901,477,424,365,134,231,48.43,0.484,0.405,0.316
107080,2006,396,222,174,251,99,152,68.47,0.685,0.634,0.569
107141,2006,326,168,158,190,78,112,66.67,0.667,0.583,0.494
107512,2006,367,190,177,185,73,112,58.95,0.59,0.504,0.412
107558,2006,164,80,84,59,29,30,37.5,0.375,0.36,0.345
110097,2006,799,521,278,364,102,262,50.29,0.503,0.456,0.367
110404,2006,210,60,150,166,113,53,88.33,0.883,0.79,0.753
110422,2006,3761,1648,2113,1044,362,682,41.38,0.414,0.278,0.171
110486,2006,854,553,301,120,29,91,16.46,0.165,0.141,0.096
110495,2006,846,570,276,148,37,111,19.47,0.195,0.175,0.134
110510,2006,1774,1157,617,201,55,146,12.62,0.126,0.113,0.089
110529,2006,3138,1357,1781,341,128,213,15.7,0.157,0.109,0.072
110538,2006,2430,1326,1104,420,103,317,23.91,0.239,0.173,0.093
110547,2006,984,716,268,41,8,33,4.61,0.046,0.042,0.03
110556,2006,2528,1501,1027,344,108,236,15.72,0.157,0.136,0.105
110565,2006,3736,2262,1474,500,122,378,16.71,0.167,0.134,0.083
110574,2006,881,506,375,131,48,83,16.4,0.164,0.149,0.128
110583,2006,4334,2757,1577,550,175,375,13.6,0.136,0.127,0.111
110592,2006,1542,961,581,113,36,77,8.01,0.08,0.073,0.062
110617,2006,2590,1570,1020,263,79,184,11.72,0.117,0.102,0.077
113698,2006,263,193,70,100,18,82,42.49,0.425,0.38,0.257
115755,2006,966,550,416,132,46,86,15.64,0.156,0.137,0.111
119173,2006,345,336,9,76,1,75,22.32,0.223,0.22,0.111
120184,2006,134,93,41,51,15,36,38.71,0.387,0.381,0.366
121309,2006,537,342,195,352,118,234,68.42,0.684,0.655,0.605
121345,2006,378,190,188,337,162,175,92.11,0.921,0.892,0.862
122409,2006,4109,2458,1651,1309,382,927,37.71,0.377,0.319,0.231
122436,2006,1103,703,400,714,214,500,71.12,0.711,0.647,0.535
122597,2006,3117,2017,1100,418,128,290,14.38,0.144,0.134,0.116
122612,2006,1073,733,340,582,166,416,56.75,0.568,0.542,0.488
122931,2006,1340,740,600,1055,448,607,82.03,0.82,0.787,0.747
123554,2006,600,384,216,292,105,187,48.7,0.487,0.487,0.486
123572,2006,1513,1033,480,410,104,306,29.62,0.296,0.271,0.217
126562,2006,885,510,375,155,52,103,20.2,0.202,0.175,0.139
126580,2006,914,531,383,216,75,141,26.55,0.266,0.236,0.196
126614,2006,5606,2688,2918,2336,1016,1320,49.11,0.491,0.417,0.348
126818,2006,3825,2166,1659,1448,441,1007,46.49,0.465,0.379,0.266
127060,2006,1135,615,520,692,290,402,65.37,0.654,0.61,0.558
127185,2006,821,367,454,161,59,102,27.79,0.278,0.196,0.13
127565,2006,1711,925,786,102,33,69,7.46,0.075,0.06,0.042
127741,2006,2491,1442,1049,659,204,455,31.55,0.316,0.265,0.194
128106,2006,628,350,278,112,42,70,20,0.2,0.178,0.151
128744,2006,303,176,127,70,20,50,28.41,0.284,0.231,0.157
128771,2006,1282,603,679,272,117,155,25.7,0.257,0.212,0.172
129020,2006,3222,1631,1591,2148,962,1186,72.72,0.727,0.667,0.605
129242,2006,896,534,362,696,269,427,79.96,0.8,0.777,0.743
129941,2006,690,325,365,305,157,148,45.54,0.455,0.442,0.43
130253,2006,931,603,328,536,172,364,60.36,0.604,0.576,0.524
130314,2006,133,133,0,50,0,50,37.59,0.376,0.376,NA
130493,2006,1516,987,529,262,54,208,21.07,0.211,0.173,0.102
130590,2006,608,294,314,466,229,237,80.61,0.806,0.766,0.729
130697,2006,716,352,364,624,316,308,87.5,0.875,0.872,0.868
130776,2006,843,413,430,167,64,103,24.94,0.249,0.198,0.149
130794,2006,1313,654,659,1169,578,591,90.37,0.904,0.89,0.877
130934,2006,818,463,355,126,37,89,19.22,0.192,0.154,0.104
130943,2006,3563,2127,1436,2175,777,1398,65.73,0.657,0.61,0.541
131159,2006,1385,923,462,1007,321,686,74.32,0.743,0.727,0.695
131283,2006,856,459,397,527,219,308,67.1,0.671,0.616,0.552
131450,2006,209,96,113,15,5,10,10.42,0.104,0.072,0.044
131469,2006,2440,1348,1092,1804,756,1048,77.74,0.777,0.739,0.692
131496,2006,1588,877,711,1419,630,789,89.97,0.9,0.894,0.886
131520,2006,1512,1022,490,629,155,474,46.38,0.464,0.416,0.316
132471,2006,387,255,132,82,24,58,22.75,0.228,0.212,0.182
132602,2006,901,497,404,142,64,78,15.69,0.157,0.158,0.158
132903,2006,6389,3389,3000,2257,754,1503,44.35,0.444,0.353,0.251
133492,2006,544,315,229,308,113,195,61.9,0.619,0.566,0.493
133553,2006,1101,161,940,363,290,73,45.34,0.453,0.33,0.309
133650,2006,1614,925,689,156,36,120,12.97,0.13,0.097,0.052
133669,2006,2193,1208,985,339,115,224,18.54,0.185,0.155,0.117
133711,2006,463,284,179,235,77,158,55.63,0.556,0.508,0.43
133881,2006,597,160,437,222,144,78,48.75,0.488,0.372,0.33
133951,2006,3889,2099,1790,736,243,493,23.49,0.235,0.189,0.136
134079,2006,420,267,153,198,59,139,52.06,0.521,0.471,0.386
134097,2006,6191,3597,2594,3310,1201,2109,58.63,0.586,0.535,0.463
134130,2006,6674,3783,2891,4294,1572,2722,71.95,0.72,0.643,0.544
134945,2006,493,213,280,134,62,72,33.8,0.338,0.272,0.221
135726,2006,2046,1055,991,1421,644,777,73.65,0.737,0.695,0.65
136172,2006,2304,1301,1003,462,131,331,25.44,0.254,0.201,0.131
136950,2006,501,287,214,312,119,193,67.25,0.672,0.623,0.556
137546,2006,565,338,227,317,113,204,60.36,0.604,0.561,0.498
138354,2006,861,495,366,209,65,144,29.09,0.291,0.243,0.178
138716,2006,702,467,235,74,14,60,12.85,0.128,0.105,0.06
138789,2006,757,472,285,63,14,49,10.38,0.104,0.083,0.049
139144,2006,427,302,125,221,56,165,54.64,0.546,0.518,0.448
139366,2006,1054,640,414,139,37,102,15.94,0.159,0.132,0.089
139393,2006,297,166,131,163,62,101,60.84,0.608,0.549,0.473
139658,2006,1648,938,710,1108,477,631,67.27,0.673,0.672,0.672
139719,2006,486,253,233,51,9,42,16.6,0.166,0.105,0.039
139755,2006,2838,890,1948,953,548,405,45.51,0.455,0.336,0.281
139764,2006,399,236,163,52,11,41,17.37,0.174,0.13,0.067
139861,2006,1137,707,430,403,101,302,42.72,0.427,0.354,0.235
139931,2006,2731,1294,1437,617,214,403,31.14,0.311,0.226,0.149
139940,2006,2174,1313,861,439,135,304,23.15,0.231,0.202,0.157
139959,2006,5059,3161,1898,2732,900,1832,57.96,0.58,0.54,0.474
140447,2006,582,300,282,253,98,155,51.67,0.517,0.435,0.348
140960,2006,697,377,320,60,12,48,12.73,0.127,0.086,0.038
140988,2006,311,138,173,104,42,62,44.93,0.449,0.334,0.243
141185,2006,190,104,86,62,18,44,42.31,0.423,0.326,0.209
141264,2006,2015,1195,820,300,78,222,18.58,0.186,0.149,0.095
141334,2006,1694,1002,692,254,67,187,18.66,0.187,0.15,0.097
141486,2006,264,185,79,54,17,37,20,0.2,0.205,0.215
141565,2006,448,267,181,48,9,39,14.61,0.146,0.107,0.05
141574,2006,1679,922,757,293,107,186,20.17,0.202,0.175,0.141
142276,2006,994,525,469,85,23,62,11.81,0.118,0.086,0.049
142285,2006,1582,749,833,369,150,219,29.24,0.292,0.233,0.18
142461,2006,247,128,119,86,37,49,38.28,0.383,0.348,0.311
143084,2006,692,392,300,505,216,289,73.72,0.737,0.73,0.72
143288,2006,177,111,66,63,17,46,41.44,0.414,0.356,0.258
144005,2006,359,254,105,16,2,14,5.51,0.055,0.045,0.019
144281,2006,1972,1025,947,547,247,300,29.27,0.293,0.277,0.261
144740,2006,2531,1428,1103,1280,482,798,55.88,0.559,0.506,0.437
144892,2006,1760,1062,698,583,164,419,39.45,0.394,0.331,0.235
144962,2006,484,296,188,275,100,175,59.12,0.591,0.568,0.532
144971,2006,137,74,63,54,26,28,37.84,0.378,0.394,0.413
145600,2006,2830,1554,1276,878,380,498,32.05,0.32,0.31,0.298
145619,2006,379,189,190,139,57,82,43.39,0.434,0.367,0.3
145637,2006,7152,3518,3634,4881,2256,2625,74.62,0.746,0.682,0.621
145691,2006,293,154,139,148,49,99,64.29,0.643,0.505,0.353
145813,2006,3188,1915,1273,1496,471,1025,53.52,0.535,0.469,0.37
146481,2006,386,224,162,241,96,145,64.73,0.647,0.624,0.593
146612,2006,568,323,245,223,94,129,39.94,0.399,0.393,0.384
146719,2006,2134,1426,708,1104,357,747,52.38,0.524,0.517,0.504
146825,2006,166,86,80,41,14,27,31.4,0.314,0.247,0.175
147013,2006,343,162,181,114,40,74,45.68,0.457,0.332,0.221
147244,2006,475,261,214,214,89,125,47.89,0.479,0.451,0.416
147341,2006,392,215,177,172,64,108,50.23,0.502,0.439,0.362
147703,2006,3260,1641,1619,903,427,476,29.01,0.29,0.277,0.264
147767,2006,2060,1089,971,1768,799,969,88.98,0.89,0.858,0.823
147776,2006,1022,600,422,40,18,22,3.67,0.037,0.039,0.043
147828,2006,751,414,337,332,126,206,49.76,0.498,0.442,0.374
148131,2006,161,88,73,67,27,40,45.45,0.454,0.416,0.37
148496,2006,362,256,106,203,52,151,58.98,0.59,0.561,0.491
148584,2006,181,104,77,62,21,41,39.42,0.394,0.343,0.273
148627,2006,525,370,155,172,47,125,33.78,0.338,0.328,0.303
149222,2006,2278,1005,1273,586,266,320,31.84,0.318,0.257,0.209
149231,2006,1770,1025,745,527,163,364,35.51,0.355,0.298,0.219
149772,2006,1907,909,998,583,303,280,30.8,0.308,0.306,0.304
149781,2006,572,278,294,435,219,216,77.7,0.777,0.76,0.745
150066,2006,447,245,202,206,83,123,50.2,0.502,0.461,0.411
150136,2006,3947,2027,1920,1155,425,730,36.01,0.36,0.293,0.221
150145,2006,303,190,113,136,41,95,50,0.5,0.449,0.363
150163,2006,965,604,361,479,150,329,54.47,0.545,0.496,0.416
150400,2006,595,334,261,442,186,256,76.65,0.767,0.743,0.713
150534,2006,643,379,264,359,139,220,58.05,0.581,0.558,0.527
150668,2006,206,122,84,114,44,70,57.38,0.574,0.553,0.524
150941,2006,250,140,110,126,52,74,52.86,0.529,0.504,0.473
151102,2006,1608,859,749,61,20,41,4.77,0.048,0.038,0.027
151111,2006,2516,1549,967,317,109,208,13.43,0.134,0.126,0.113
151306,2006,2021,1253,768,321,70,251,20.03,0.2,0.159,0.091
151324,2006,1657,827,830,335,125,210,25.39,0.254,0.202,0.151
151333,2006,329,210,119,26,6,20,9.52,0.095,0.079,0.05
151342,2006,772,427,345,31,16,15,3.51,0.035,0.04,0.046
151351,2006,7208,3875,3333,3949,1681,2268,58.53,0.585,0.548,0.504
151360,2006,561,352,209,31,8,23,6.53,0.065,0.055,0.038
151379,2006,727,430,297,63,24,39,9.07,0.091,0.087,0.081
151388,2006,225,135,90,9,3,6,4.44,0.044,0.04,0.033
151777,2006,311,137,174,136,62,74,54.01,0.54,0.437,0.356
151786,2006,277,148,129,108,32,76,51.35,0.514,0.39,0.248
152080,2006,2029,928,1101,1800,962,838,90.3,0.903,0.887,0.874
152248,2006,1036,546,490,52,19,33,6.04,0.06,0.05,0.039
152363,2006,251,111,140,100,49,51,45.95,0.46,0.398,0.35
152530,2006,492,266,226,341,146,195,73.31,0.733,0.693,0.646
152600,2006,760,394,366,469,206,263,66.75,0.667,0.617,0.563
153001,2006,265,133,132,111,51,60,45.11,0.451,0.419,0.386
153108,2006,413,218,195,256,103,153,70.18,0.702,0.62,0.528
153269,2006,779,470,309,429,173,256,54.47,0.545,0.551,0.56
153384,2006,405,206,199,348,166,182,88.35,0.883,0.859,0.834
153603,2006,3933,1780,2153,1525,649,876,49.21,0.492,0.388,0.301
153834,2006,610,350,260,417,180,237,67.71,0.677,0.684,0.692
154095,2006,1684,1010,674,648,200,448,44.36,0.444,0.385,0.297
155089,2006,139,64,75,12,8,4,6.25,0.062,0.086,0.107
155317,2006,4092,2092,2000,1500,607,893,42.69,0.427,0.367,0.304
155335,2006,167,96,71,48,18,30,31.25,0.312,0.287,0.254
155399,2006,3140,1602,1538,832,288,544,33.96,0.34,0.265,0.187
155520,2006,239,118,121,82,36,46,38.98,0.39,0.343,0.298
155627,2006,90,38,52,19,6,13,34.21,0.342,0.211,0.115
155937,2006,197,79,118,40,10,30,37.97,0.38,0.203,0.085
156213,2006,276,161,115,178,67,111,68.94,0.689,0.645,0.583
156286,2006,429,279,150,206,60,146,52.33,0.523,0.48,0.4
156295,2006,388,220,168,185,78,107,48.64,0.486,0.477,0.464
156365,2006,346,182,164,81,32,49,26.92,0.269,0.234,0.195
156541,2006,349,177,172,99,34,65,36.72,0.367,0.284,0.198
156745,2006,363,226,137,185,53,132,58.41,0.584,0.51,0.387
157058,2006,569,277,292,21,6,15,5.42,0.054,0.037,0.021
157076,2006,326,127,199,82,41,41,32.28,0.323,0.252,0.206
157085,2006,4113,2201,1912,1253,443,810,36.8,0.368,0.305,0.232
157289,2006,2380,1230,1150,628,257,371,30.16,0.302,0.264,0.223
157386,2006,1330,741,589,201,65,136,18.35,0.184,0.151,0.11
157401,2006,1390,822,568,391,123,268,32.6,0.326,0.281,0.217
157447,2006,1908,1069,839,230,83,147,13.75,0.138,0.121,0.099
157535,2006,220,105,115,26,4,22,20.95,0.21,0.118,0.035
157951,2006,3118,1768,1350,649,217,432,24.43,0.244,0.208,0.161
158477,2006,241,136,105,104,45,59,43.38,0.434,0.432,0.429
159009,2006,1119,609,510,108,33,75,12.32,0.123,0.097,0.065
159391,2006,4503,2449,2054,1530,584,946,38.63,0.386,0.34,0.284
159647,2006,1625,753,872,426,185,241,32.01,0.32,0.262,0.212
159717,2006,1272,741,531,195,60,135,18.22,0.182,0.153,0.113
159966,2006,1069,650,419,170,44,126,19.38,0.194,0.159,0.105
160038,2006,1324,854,470,214,62,152,17.8,0.178,0.162,0.132
160612,2006,2665,1604,1061,320,93,227,14.15,0.142,0.12,0.088
160621,2006,1136,659,477,132,33,99,15.02,0.15,0.116,0.069
160658,2006,2799,1604,1195,362,108,254,15.84,0.158,0.129,0.09
161004,2006,474,253,221,430,193,237,93.68,0.937,0.907,0.873
161226,2006,511,351,160,209,49,160,45.58,0.456,0.409,0.306
161235,2006,116,67,49,2,1,1,1.49,0.015,0.017,0.02
161244,2006,99,59,40,10,6,4,6.78,0.068,0.101,0.15
161253,2006,1807,875,932,648,296,352,40.23,0.402,0.359,0.318
161554,2006,888,511,377,84,25,59,11.55,0.116,0.095,0.066
162007,2006,765,475,290,83,20,63,13.26,0.133,0.108,0.069
162210,2006,144,84,60,18,5,13,15.48,0.155,0.125,0.083
162283,2006,494,390,104,28,3,25,6.41,0.064,0.057,0.029
162584,2006,1011,459,552,175,65,110,23.97,0.24,0.173,0.118
162654,2006,450,303,147,255,70,185,61.06,0.611,0.567,0.476
162760,2006,278,185,93,137,38,99,53.51,0.535,0.493,0.409
162928,2006,1304,643,661,1127,563,564,87.71,0.877,0.864,0.852
163046,2006,946,596,350,749,263,486,81.54,0.815,0.792,0.751
163268,2006,1419,626,793,523,233,290,46.33,0.463,0.369,0.294
163286,2006,3944,1896,2048,2493,1179,1314,69.3,0.693,0.632,0.576
163453,2006,1368,773,595,165,46,119,15.39,0.154,0.121,0.077
163462,2006,426,244,182,265,97,168,68.85,0.689,0.622,0.533
163851,2006,1028,588,440,502,171,331,56.29,0.563,0.488,0.389
163912,2006,428,249,179,309,118,191,76.71,0.767,0.722,0.659
164076,2006,2688,1697,991,1047,307,740,43.61,0.436,0.39,0.31
164173,2006,643,454,189,315,85,230,50.66,0.507,0.49,0.45
164216,2006,312,179,133,202,80,122,68.16,0.682,0.647,0.602
164270,2006,476,260,216,324,126,198,76.15,0.762,0.681,0.583
164447,2006,282,148,134,81,29,52,35.14,0.351,0.287,0.216
164492,2006,181,105,76,71,24,47,44.76,0.448,0.392,0.316
164562,2006,675,397,278,484,183,301,75.82,0.758,0.717,0.658
165015,2006,764,416,348,656,291,365,87.74,0.877,0.859,0.836
165024,2006,1321,737,584,368,135,233,31.61,0.316,0.279,0.231
165334,2006,563,345,218,425,159,266,77.1,0.771,0.755,0.729
165662,2006,728,409,319,578,254,324,79.22,0.792,0.794,0.796
165671,2006,467,344,123,233,55,178,51.74,0.517,0.499,0.447
165820,2006,728,383,345,172,63,109,28.46,0.285,0.236,0.183
165866,2006,714,496,218,242,57,185,37.3,0.373,0.339,0.261
165936,2006,380,250,130,225,71,154,61.6,0.616,0.592,0.546
166027,2006,1679,878,801,1448,664,784,89.29,0.893,0.862,0.829
166124,2006,751,415,336,675,293,382,92.05,0.92,0.899,0.872
166513,2006,1208,451,757,355,190,165,36.59,0.366,0.294,0.251
166629,2006,4265,2174,2091,2259,1002,1257,57.82,0.578,0.53,0.479
166638,2006,846,484,362,109,29,80,16.53,0.165,0.129,0.08
166683,2006,1001,447,554,837,457,380,85.01,0.85,0.836,0.825
167288,2006,299,175,124,94,33,61,34.86,0.349,0.314,0.266
167987,2006,1763,866,897,559,248,311,35.91,0.359,0.317,0.276
167996,2006,594,363,231,469,173,296,81.54,0.815,0.79,0.749
168005,2006,1286,735,551,520,197,323,43.95,0.44,0.404,0.358
168148,2006,1280,648,632,1120,543,577,89.04,0.89,0.875,0.859
168254,2006,719,259,460,367,211,156,60.23,0.602,0.51,0.459
168281,2006,410,239,171,317,125,192,80.33,0.803,0.773,0.731
168342,2006,533,280,253,484,223,261,93.21,0.932,0.908,0.881
168546,2006,480,260,220,297,118,179,68.85,0.689,0.619,0.536
168786,2006,387,252,135,192,67,125,49.6,0.496,0.496,0.496
169080,2006,1020,551,469,615,268,347,62.98,0.63,0.603,0.571
169798,2006,2272,1315,957,276,97,179,13.61,0.136,0.121,0.101
169910,2006,1895,860,1035,167,82,85,9.88,0.099,0.088,0.079
170082,2006,3556,2276,1280,1116,346,770,33.83,0.338,0.314,0.27
170301,2006,778,461,317,524,189,335,72.67,0.727,0.674,0.596
170532,2006,379,211,168,279,110,169,80.09,0.801,0.736,0.655
170639,2006,454,232,222,58,23,35,15.09,0.151,0.128,0.104
170976,2006,5356,2704,2652,4072,1880,2192,81.07,0.811,0.76,0.709
171100,2006,7306,4103,3203,3800,1448,2352,57.32,0.573,0.52,0.452
171128,2006,1163,283,880,328,221,107,37.81,0.378,0.282,0.251
171137,2006,761,394,367,136,56,80,20.3,0.203,0.179,0.153
171146,2006,483,274,209,46,14,32,11.68,0.117,0.095,0.067
171599,2006,195,73,122,52,28,24,32.88,0.329,0.267,0.23
172051,2006,1434,840,594,123,36,87,10.36,0.104,0.086,0.061
172699,2006,3531,1800,1731,852,359,493,27.39,0.274,0.241,0.207
173160,2006,629,351,278,392,157,235,66.95,0.67,0.623,0.565
173258,2006,504,272,232,458,209,249,91.54,0.915,0.909,0.901
173328,2006,199,108,91,51,19,32,29.63,0.296,0.256,0.209
173647,2006,684,396,288,553,226,327,82.58,0.826,0.808,0.785
173902,2006,501,281,220,429,181,248,88.26,0.883,0.856,0.823
174066,2006,5418,2970,2448,2734,1150,1584,53.33,0.533,0.505,0.47
174233,2006,2283,1105,1178,629,270,359,32.49,0.325,0.276,0.229
174251,2006,377,214,163,179,66,113,52.8,0.528,0.475,0.405
174491,2006,498,302,196,256,89,167,55.3,0.553,0.514,0.454
174792,2006,506,0,506,347,347,0,NA,NA,0.686,0.686
174844,2006,792,436,356,660,288,372,85.32,0.853,0.833,0.809
174899,2006,493,331,162,283,79,204,61.63,0.616,0.574,0.488
174914,2006,1298,644,654,816,392,424,65.84,0.658,0.629,0.599
175342,2006,545,302,243,79,34,45,14.9,0.149,0.145,0.14
175421,2006,248,133,115,76,31,45,33.83,0.338,0.306,0.27
175616,2006,468,288,180,85,33,52,18.06,0.181,0.182,0.183
175856,2006,889,513,376,191,57,134,26.12,0.261,0.215,0.152
175980,2006,225,122,103,149,63,86,70.49,0.705,0.662,0.612
176017,2006,2521,1320,1201,920,352,568,43.03,0.43,0.365,0.293
176035,2006,256,243,13,53,3,50,20.58,0.206,0.207,0.231
176044,2006,443,216,227,55,14,41,18.98,0.19,0.124,0.062
176080,2006,1897,947,950,575,233,342,36.11,0.361,0.303,0.245
176406,2006,243,172,71,74,15,59,34.3,0.343,0.305,0.211
176628,2006,138,78,60,34,11,23,29.49,0.295,0.246,0.183
176947,2006,207,111,96,81,28,53,47.75,0.478,0.391,0.292
176965,2006,1505,871,634,416,134,282,32.38,0.324,0.276,0.211
177418,2006,187,98,89,30,11,19,19.39,0.194,0.16,0.124
178059,2006,290,237,53,152,26,126,53.16,0.532,0.524,0.491
178341,2006,851,484,367,106,40,66,13.64,0.136,0.125,0.109
178387,2006,936,516,420,102,39,63,12.21,0.122,0.109,0.093
178396,2006,4783,2562,2221,2234,835,1399,54.61,0.546,0.467,0.376
178402,2006,928,545,383,220,86,134,24.59,0.246,0.237,0.225
178411,2006,929,216,713,258,176,82,37.96,0.38,0.278,0.247
178420,2006,476,273,203,106,33,73,26.74,0.267,0.223,0.163
178615,2006,1365,826,539,781,258,523,63.32,0.633,0.572,0.479
179043,2006,396,260,136,237,73,164,63.08,0.631,0.598,0.537
179159,2006,1567,940,627,946,358,588,62.55,0.625,0.604,0.571
179557,2006,1383,853,530,318,92,226,26.49,0.265,0.23,0.174
179566,2006,2732,1622,1110,854,306,548,33.79,0.338,0.313,0.276
179867,2006,1456,714,742,1284,628,656,91.88,0.919,0.882,0.846
179894,2006,418,240,178,198,69,129,53.75,0.537,0.474,0.388
179946,2006,278,139,139,163,73,90,64.75,0.647,0.586,0.525
180179,2006,646,339,307,59,17,42,12.39,0.124,0.091,0.055
180461,2006,1940,814,1126,381,173,208,25.55,0.256,0.196,0.154
180522,2006,193,66,127,12,5,7,10.61,0.106,0.062,0.039
180984,2006,302,153,149,114,43,71,46.41,0.464,0.377,0.289
181002,2006,965,591,374,653,257,396,67.01,0.67,0.677,0.687
181020,2006,247,147,100,149,54,95,64.63,0.646,0.603,0.54
181127,2006,262,111,151,122,57,65,58.56,0.586,0.466,0.377
181215,2006,937,521,416,202,80,122,23.42,0.234,0.216,0.192
181394,2006,1637,864,773,231,95,136,15.74,0.157,0.141,0.123
181446,2006,413,212,201,212,94,118,55.66,0.557,0.513,0.468
181464,2006,3828,1805,2023,1126,503,623,34.52,0.345,0.294,0.249
181534,2006,204,95,109,37,17,20,21.05,0.211,0.181,0.156
181783,2006,606,335,271,166,53,113,33.73,0.337,0.274,0.196
182281,2006,2532,1410,1122,368,130,238,16.88,0.169,0.145,0.116
182290,2006,2358,1300,1058,407,146,261,20.08,0.201,0.173,0.138
182634,2006,220,151,69,95,22,73,48.34,0.483,0.432,0.319
182795,2006,553,260,293,226,103,123,47.31,0.473,0.409,0.352
183062,2006,1139,718,421,559,194,365,50.84,0.508,0.491,0.461
183080,2006,1008,446,562,402,191,211,47.31,0.473,0.399,0.34
183239,2006,568,343,225,410,151,259,75.51,0.755,0.722,0.671
183822,2006,316,183,133,47,18,29,15.85,0.158,0.149,0.135
183974,2006,303,211,92,147,41,106,50.24,0.502,0.485,0.446
184348,2006,479,316,163,315,103,212,67.09,0.671,0.658,0.632
184603,2006,452,254,198,119,37,82,32.28,0.323,0.263,0.187
184612,2006,251,172,79,58,20,38,22.09,0.221,0.231,0.253
184782,2006,1216,602,614,593,271,322,53.49,0.535,0.488,0.441
185129,2006,646,379,267,45,13,32,8.44,0.084,0.07,0.049
185572,2006,959,535,424,425,168,257,48.04,0.48,0.443,0.396
185590,2006,2018,1197,821,702,214,488,40.77,0.408,0.348,0.261
185828,2006,795,146,649,150,102,48,32.88,0.329,0.189,0.157
186131,2006,1228,576,652,1078,561,517,89.76,0.898,0.878,0.86
186201,2006,811,475,336,488,182,306,64.42,0.644,0.602,0.542
186283,2006,1016,619,397,576,206,370,59.77,0.598,0.567,0.519
186584,2006,1054,602,452,574,231,343,56.98,0.57,0.545,0.511
186876,2006,791,425,366,319,123,196,46.12,0.461,0.403,0.336
187134,2006,1270,756,514,919,339,580,76.72,0.767,0.724,0.66
187444,2006,1218,669,549,170,62,108,16.14,0.161,0.14,0.113
187985,2006,2955,1619,1336,356,124,232,14.33,0.143,0.12,0.093
188030,2006,2073,1105,968,286,80,206,18.64,0.186,0.138,0.083
188429,2006,826,587,239,446,108,338,57.58,0.576,0.54,0.452
188641,2006,490,257,233,229,86,143,55.64,0.556,0.467,0.369
190044,2006,646,176,470,354,246,108,61.36,0.614,0.548,0.523
190099,2006,743,417,326,630,278,352,84.41,0.844,0.848,0.853
190150,2006,1353,646,707,1191,604,587,90.87,0.909,0.88,0.854
190248,2006,171,90,81,57,26,31,34.44,0.344,0.333,0.321
190415,2006,3186,1538,1648,2779,1375,1404,91.29,0.913,0.872,0.834
190512,2006,1493,650,843,497,248,249,38.31,0.383,0.333,0.294
190549,2006,1354,766,588,355,120,235,30.68,0.307,0.262,0.204
190558,2006,2072,1124,948,108,41,67,5.96,0.06,0.052,0.043
190567,2006,1529,760,769,114,43,71,9.34,0.093,0.075,0.056
190594,2006,1813,1202,611,349,86,263,21.88,0.219,0.192,0.141
190637,2006,911,674,237,131,24,107,15.88,0.159,0.144,0.101
190664,2006,1627,991,636,418,113,305,30.78,0.308,0.257,0.178
190691,2006,668,428,240,27,10,17,3.97,0.04,0.04,0.042
190725,2006,368,284,84,100,22,78,27.46,0.275,0.272,0.262
191241,2006,1697,929,768,1300,578,722,77.72,0.777,0.766,0.753
191515,2006,501,267,234,424,195,229,85.77,0.858,0.846,0.833
191533,2006,464,270,194,235,88,147,54.44,0.544,0.506,0.454
191630,2006,597,319,278,428,182,246,77.12,0.771,0.717,0.655
191649,2006,1706,865,841,768,335,433,50.06,0.501,0.45,0.398
191676,2006,306,195,111,177,58,119,61.03,0.61,0.578,0.523
191931,2006,903,504,399,506,181,325,64.48,0.645,0.56,0.454
191968,2006,1519,819,700,1059,466,593,72.41,0.724,0.697,0.666
192192,2006,232,147,85,106,44,62,42.18,0.422,0.457,0.518
192323,2006,544,330,214,329,120,209,63.33,0.633,0.605,0.561
192439,2006,1079,730,349,56,14,42,5.75,0.058,0.052,0.04
192703,2006,710,353,357,466,234,232,65.72,0.657,0.656,0.655
192749,2006,507,329,178,274,91,183,55.62,0.556,0.54,0.511
192819,2006,1038,573,465,737,309,428,74.69,0.747,0.71,0.665
192925,2006,320,198,122,87,38,49,24.75,0.248,0.272,0.311
193016,2006,614,390,224,79,22,57,14.62,0.146,0.129,0.098
193292,2006,269,196,73,90,22,68,34.69,0.347,0.335,0.301
193353,2006,400,295,105,162,41,121,41.02,0.41,0.405,0.39
193399,2006,390,294,96,159,37,122,41.5,0.415,0.408,0.385
193584,2006,481,364,117,293,62,231,63.46,0.635,0.609,0.53
193645,2006,821,757,64,133,6,127,16.78,0.168,0.162,0.094
193654,2006,883,622,261,409,110,299,48.07,0.481,0.463,0.421
193900,2006,4704,2895,1809,2879,1141,1738,60.03,0.6,0.612,0.631
193973,2006,705,421,284,437,169,268,63.66,0.637,0.62,0.595
194161,2006,308,178,130,85,30,55,30.9,0.309,0.276,0.231
194310,2006,1131,738,393,441,126,315,42.68,0.427,0.39,0.321
194824,2006,1269,362,907,766,544,222,61.33,0.613,0.604,0.6
195003,2006,2355,675,1680,589,315,274,40.59,0.406,0.25,0.188
195030,2006,1219,561,658,906,467,439,78.25,0.782,0.743,0.71
195164,2006,459,234,225,235,105,130,55.56,0.556,0.512,0.467
195173,2006,474,253,221,137,61,76,30.04,0.3,0.289,0.276
195216,2006,608,325,283,463,210,253,77.85,0.778,0.762,0.742
195234,2006,630,423,207,328,88,240,56.74,0.567,0.521,0.425
195243,2006,323,185,138,113,39,74,40,0.4,0.35,0.283
195304,2006,381,286,95,261,62,199,69.58,0.696,0.685,0.653
195474,2006,688,393,295,478,190,288,73.28,0.733,0.695,0.644
195526,2006,672,388,284,565,231,334,86.08,0.861,0.841,0.813
195544,2006,597,424,173,309,68,241,56.84,0.568,0.518,0.393
195809,2006,3260,1713,1547,1198,494,704,41.1,0.411,0.367,0.319
196413,2006,3045,1686,1359,2099,839,1260,74.73,0.747,0.689,0.617
196592,2006,1479,988,491,60,25,35,3.54,0.035,0.041,0.051
197045,2006,495,277,218,164,62,102,36.82,0.368,0.331,0.284
197133,2006,668,412,256,534,173,361,87.62,0.876,0.799,0.676
197869,2006,2707,1403,1304,1080,402,678,48.33,0.483,0.399,0.308
197984,2006,279,142,137,94,34,60,42.25,0.422,0.337,0.248
198385,2006,461,233,228,410,197,213,91.42,0.914,0.889,0.864
198464,2006,3784,2331,1453,1240,347,893,38.31,0.383,0.328,0.239
198507,2006,534,313,221,90,20,70,22.36,0.224,0.169,0.09
198516,2006,1283,740,543,991,378,613,82.84,0.828,0.772,0.696
198835,2006,347,195,152,117,40,77,39.49,0.395,0.337,0.263
198969,2006,449,135,314,75,31,44,32.59,0.326,0.167,0.099
199102,2006,2068,1102,966,340,81,259,23.5,0.235,0.164,0.084
199111,2006,567,328,239,180,57,123,37.5,0.375,0.317,0.238
199120,2006,3796,2276,1520,2893,1107,1786,78.47,0.785,0.762,0.728
199139,2006,2764,1475,1289,728,280,448,30.37,0.304,0.263,0.217
199148,2006,2400,1698,702,706,128,578,34.04,0.34,0.294,0.182
199157,2006,975,631,344,145,30,115,18.23,0.182,0.149,0.087
199193,2006,4667,2067,2600,1781,761,1020,49.35,0.494,0.382,0.293
199218,2006,1980,1140,840,973,335,638,55.96,0.56,0.491,0.399
199281,2006,929,475,454,148,54,94,19.79,0.198,0.159,0.119
199306,2006,196,85,111,72,38,34,40,0.4,0.367,0.342
199412,2006,235,173,62,104,22,82,47.4,0.474,0.443,0.355
199582,2006,363,146,217,58,23,35,23.97,0.24,0.16,0.106
199643,2006,674,423,251,82,23,59,13.95,0.139,0.122,0.092
199847,2006,1119,576,543,927,432,495,85.94,0.859,0.828,0.796
199962,2006,385,198,187,152,57,95,47.98,0.48,0.395,0.305
199999,2006,976,692,284,144,36,108,15.61,0.156,0.148,0.127
200004,2006,1558,784,774,434,163,271,34.57,0.346,0.279,0.211
200059,2006,333,160,173,50,22,28,17.5,0.175,0.15,0.127
200156,2006,238,129,109,75,21,54,41.86,0.419,0.315,0.193
200217,2006,343,187,156,19,10,9,4.81,0.048,0.055,0.064
200226,2006,137,59,78,29,7,22,37.29,0.373,0.212,0.09
200253,2006,461,263,198,58,13,45,17.11,0.171,0.126,0.066
200280,2006,1868,869,999,438,199,239,27.5,0.275,0.234,0.199
200332,2006,2040,920,1120,486,221,265,28.8,0.288,0.238,0.197
200572,2006,177,70,107,44,20,24,34.29,0.343,0.249,0.187
201104,2006,554,313,241,238,78,160,51.12,0.511,0.43,0.324
201371,2006,241,122,119,119,50,69,56.56,0.566,0.494,0.42
201548,2006,690,410,280,342,130,212,51.71,0.517,0.496,0.464
201645,2006,1015,441,574,636,325,311,70.52,0.705,0.627,0.566
201690,2006,535,266,269,65,21,44,16.54,0.165,0.121,0.078
202134,2006,947,520,427,95,31,64,12.31,0.123,0.1,0.073
202480,2006,1738,864,874,1041,450,591,68.4,0.684,0.599,0.515
202523,2006,573,335,238,481,190,291,86.87,0.869,0.839,0.798
202763,2006,616,441,175,243,58,185,41.95,0.42,0.394,0.331
203085,2006,267,131,136,105,38,67,51.15,0.511,0.393,0.279
203128,2006,298,143,155,174,80,94,65.73,0.657,0.584,0.516
203368,2006,712,385,327,469,205,264,68.57,0.686,0.659,0.627
203517,2006,3610,2214,1396,977,295,682,30.8,0.308,0.271,0.211
203535,2006,457,226,231,397,190,207,91.59,0.916,0.869,0.823
203580,2006,131,89,42,48,13,35,39.33,0.393,0.366,0.31
203775,2006,341,208,133,159,58,101,48.56,0.486,0.466,0.436
203845,2006,385,191,194,206,83,123,64.4,0.644,0.535,0.428
204024,2006,3630,2017,1613,2472,1010,1462,72.48,0.725,0.681,0.626
204185,2006,636,284,352,343,149,194,68.31,0.683,0.539,0.423
204194,2006,346,201,145,160,66,94,46.77,0.468,0.462,0.455
204617,2006,354,177,177,107,51,56,31.64,0.316,0.302,0.288
204796,2006,6262,3104,3158,3295,1373,1922,61.92,0.619,0.526,0.435
204857,2006,4009,2063,1946,1766,693,1073,52.01,0.52,0.441,0.356
206330,2006,238,91,147,61,19,42,46.15,0.462,0.256,0.129
206589,2006,494,242,252,345,163,182,75.21,0.752,0.698,0.647
206604,2006,2178,1211,967,422,155,267,22.05,0.22,0.194,0.16
206622,2006,812,459,353,574,244,330,71.9,0.719,0.707,0.691
206695,2006,2169,1095,1074,187,74,113,10.32,0.103,0.086,0.069
206914,2006,686,402,284,40,16,24,5.97,0.06,0.058,0.056
207209,2006,533,271,262,32,8,24,8.86,0.089,0.06,0.031
207306,2006,243,121,122,29,9,20,16.53,0.165,0.119,0.074
207324,2006,512,260,252,166,76,90,34.62,0.346,0.324,0.302
207388,2006,3132,1658,1474,1068,383,685,41.31,0.413,0.341,0.26
207500,2006,3285,1732,1553,1190,457,733,42.32,0.423,0.362,0.294
207722,2006,208,139,69,58,16,42,30.22,0.302,0.279,0.232
207847,2006,586,313,273,67,26,41,13.1,0.131,0.114,0.095
207865,2006,844,485,359,129,31,98,20.21,0.202,0.153,0.086
208822,2006,415,262,153,223,81,142,54.2,0.542,0.537,0.529
209056,2006,508,318,190,349,129,220,69.18,0.692,0.687,0.679
209065,2006,445,243,202,265,104,161,66.26,0.663,0.596,0.515
209542,2006,2898,1413,1485,872,341,531,37.58,0.376,0.301,0.23
209551,2006,3349,1821,1528,1468,575,893,49.04,0.49,0.438,0.376
209612,2006,360,206,154,194,72,122,59.22,0.592,0.539,0.468
209807,2006,1283,695,588,200,67,133,19.14,0.191,0.156,0.114
209922,2006,371,207,164,222,91,131,63.29,0.633,0.598,0.555
210146,2006,707,401,306,110,31,79,19.7,0.197,0.156,0.101
210401,2006,482,260,222,333,139,194,74.62,0.746,0.691,0.626
210429,2006,750,485,265,150,40,110,22.68,0.227,0.2,0.151
210571,2006,458,233,225,210,87,123,52.79,0.528,0.459,0.387
210669,2006,570,322,248,398,159,239,74.22,0.742,0.698,0.641
210775,2006,300,188,112,114,43,71,37.77,0.378,0.38,0.384
211088,2006,572,452,120,336,72,264,58.41,0.584,0.587,0.6
211158,2006,1630,987,643,696,221,475,48.13,0.481,0.427,0.344
211291,2006,921,458,463,792,383,409,89.3,0.893,0.86,0.827
211352,2006,529,337,192,232,63,169,50.15,0.501,0.439,0.328
211361,2006,1260,685,575,313,124,189,27.59,0.276,0.248,0.216
211431,2006,262,250,12,114,3,111,44.4,0.444,0.435,0.25
211440,2006,1421,552,869,1033,630,403,73.01,0.73,0.727,0.725
211468,2006,254,251,3,124,1,123,49,0.49,0.488,0.333
211556,2006,147,147,0,75,0,75,51.02,0.51,0.51,NA
211583,2006,214,155,59,78,22,56,36.13,0.361,0.364,0.373
211608,2006,437,238,199,47,15,32,13.45,0.134,0.108,0.075
211644,2006,1295,758,537,323,110,213,28.1,0.281,0.249,0.205
211981,2006,447,264,183,220,68,152,57.58,0.576,0.492,0.372
212009,2006,617,360,257,499,199,300,83.33,0.833,0.809,0.774
212054,2006,2256,930,1326,598,219,379,40.75,0.408,0.265,0.165
212106,2006,1321,779,542,700,268,432,55.46,0.555,0.53,0.494
212115,2006,1239,716,523,454,147,307,42.88,0.429,0.366,0.281
212133,2006,494,336,158,230,70,160,47.62,0.476,0.466,0.443
212160,2006,1212,671,541,230,63,167,24.89,0.249,0.19,0.116
212197,2006,528,345,183,372,125,247,71.59,0.716,0.705,0.683
212577,2006,523,274,249,413,196,217,79.2,0.792,0.79,0.787
212601,2006,600,352,248,280,97,183,51.99,0.52,0.467,0.391
212832,2006,272,202,70,54,19,35,17.33,0.173,0.199,0.271
212911,2006,314,174,140,281,123,158,90.8,0.908,0.895,0.879
213020,2006,2538,1400,1138,726,225,501,35.79,0.358,0.286,0.198
213251,2006,362,195,167,257,111,146,74.87,0.749,0.71,0.665
213321,2006,478,202,276,295,153,142,70.3,0.703,0.617,0.554
213349,2006,1930,1177,753,612,163,449,38.15,0.382,0.317,0.216
213358,2006,259,164,95,92,32,60,36.59,0.366,0.355,0.337
213367,2006,884,512,372,467,180,287,56.05,0.56,0.528,0.484
213385,2006,629,290,339,561,299,262,90.34,0.903,0.892,0.882
213507,2006,447,241,206,300,114,186,77.18,0.772,0.671,0.553
213543,2006,1217,511,706,950,523,427,83.56,0.836,0.781,0.741
213613,2006,1079,608,471,266,106,160,26.32,0.263,0.247,0.225
213668,2006,375,193,182,213,87,126,65.28,0.653,0.568,0.478
213783,2006,603,356,247,172,53,119,33.43,0.334,0.285,0.215
213826,2006,383,278,105,197,42,155,55.76,0.558,0.514,0.4
213996,2006,735,471,264,529,179,350,74.31,0.743,0.72,0.678
214041,2006,1342,792,550,482,154,328,41.41,0.414,0.359,0.28
214069,2006,308,192,116,165,57,108,56.25,0.562,0.536,0.491
214157,2006,375,223,152,268,108,160,71.75,0.718,0.715,0.711
214175,2006,615,376,239,503,185,318,84.57,0.846,0.818,0.774
214272,2006,544,325,219,160,46,114,35.08,0.351,0.294,0.21
214777,2006,8016,3790,4226,5243,2460,2783,73.43,0.734,0.654,0.582
215062,2006,2334,1193,1141,2036,952,1084,90.86,0.909,0.872,0.834
215743,2006,384,234,150,194,66,128,54.7,0.547,0.505,0.44
215798,2006,437,217,220,272,133,139,64.06,0.641,0.622,0.605
215929,2006,980,585,395,740,289,451,77.09,0.771,0.755,0.732
216010,2006,1496,778,718,601,215,386,49.61,0.496,0.402,0.299
216038,2006,1416,832,584,545,185,360,43.27,0.433,0.385,0.317
216287,2006,370,193,177,318,143,175,90.67,0.907,0.859,0.808
216339,2006,3848,2105,1743,1377,578,799,37.96,0.38,0.358,0.332
216524,2006,405,217,188,287,126,161,74.19,0.742,0.709,0.67
216694,2006,322,172,150,174,69,105,61.05,0.61,0.54,0.46
216764,2006,1883,1200,683,803,196,607,50.58,0.506,0.426,0.287
216807,2006,311,180,131,225,87,138,76.67,0.767,0.723,0.664
216852,2006,740,354,386,317,135,182,51.41,0.514,0.428,0.35
216931,2006,570,285,285,279,133,146,51.23,0.512,0.489,0.467
217059,2006,1092,536,556,452,207,245,45.71,0.457,0.414,0.372
217156,2006,1464,740,724,1215,590,625,84.46,0.845,0.83,0.815
217402,2006,1023,585,438,860,351,509,87.01,0.87,0.841,0.801
217536,2006,568,394,174,390,113,277,70.3,0.703,0.687,0.649
217776,2006,150,86,64,61,28,33,38.37,0.384,0.407,0.438
217819,2006,1959,1332,627,1132,315,817,61.34,0.613,0.578,0.502
217882,2006,2755,1363,1392,1575,604,971,71.24,0.712,0.572,0.434
217998,2006,178,100,78,101,34,67,67,0.67,0.567,0.436
218061,2006,795,519,276,142,34,108,20.81,0.208,0.179,0.123
218229,2006,578,379,199,127,29,98,25.86,0.259,0.22,0.146
218238,2006,206,87,119,39,17,22,25.29,0.253,0.189,0.143
218399,2006,249,144,105,39,11,28,19.44,0.194,0.157,0.105
218414,2006,264,116,148,65,24,41,35.34,0.353,0.246,0.162
218663,2006,3646,2084,1562,1932,702,1230,59.02,0.59,0.53,0.449
218724,2006,1466,810,656,420,144,276,34.07,0.341,0.286,0.22
218733,2006,870,458,412,134,49,85,18.56,0.186,0.154,0.119
218742,2006,781,497,284,166,42,124,24.95,0.25,0.213,0.148
218973,2006,377,191,186,299,139,160,83.77,0.838,0.793,0.747
219000,2006,442,282,160,228,64,164,58.16,0.582,0.516,0.4
219046,2006,595,353,242,122,28,94,26.63,0.266,0.205,0.116
219082,2006,295,137,158,41,23,18,13.14,0.131,0.139,0.146
219198,2006,127,92,35,57,14,43,46.74,0.467,0.449,0.4
219259,2006,367,178,189,50,14,36,20.22,0.202,0.136,0.074
219356,2006,1833,922,911,484,173,311,33.73,0.337,0.264,0.19
219471,2006,1109,674,435,237,88,149,22.11,0.221,0.214,0.202
219602,2006,1210,731,479,188,56,132,18.06,0.181,0.155,0.117
219709,2006,763,439,324,422,160,262,59.68,0.597,0.553,0.494
219718,2006,243,94,149,26,13,13,13.83,0.138,0.107,0.087
219949,2006,189,75,114,34,8,26,34.67,0.347,0.18,0.07
220075,2006,1712,966,746,279,106,173,17.91,0.179,0.163,0.142
220215,2006,358,206,152,145,48,97,47.09,0.471,0.405,0.316
220613,2006,810,473,337,270,77,193,40.8,0.408,0.333,0.228
220631,2006,219,135,84,3,0,3,2.22,0.022,0.014,0
220710,2006,298,163,135,123,49,74,45.4,0.454,0.413,0.363
221351,2006,451,272,179,363,141,222,81.62,0.816,0.805,0.788
221519,2006,412,202,210,305,150,155,76.73,0.767,0.74,0.714
221731,2006,160,88,72,42,10,32,36.36,0.364,0.262,0.139
221847,2006,1515,653,862,301,127,174,26.65,0.266,0.199,0.147
221892,2006,240,147,93,97,32,65,44.22,0.442,0.404,0.344
222178,2006,961,526,435,394,147,247,46.96,0.47,0.41,0.338
222983,2006,340,175,165,251,113,138,78.86,0.789,0.738,0.685
223232,2006,2775,1713,1062,1550,494,1056,61.65,0.617,0.559,0.465
224004,2006,191,89,102,37,16,21,23.6,0.236,0.194,0.157
224323,2006,315,169,146,189,82,107,63.31,0.633,0.6,0.562
225432,2006,840,452,388,12,7,5,1.11,0.011,0.014,0.018
225548,2006,318,130,188,109,46,63,48.46,0.485,0.343,0.245
225627,2006,613,439,174,119,23,96,21.87,0.219,0.194,0.132
226231,2006,309,88,221,130,75,55,62.5,0.625,0.421,0.339
226833,2006,657,355,302,108,33,75,21.13,0.211,0.164,0.109
227216,2006,3599,2039,1560,784,252,532,26.09,0.261,0.218,0.162
227331,2006,262,195,67,27,6,21,10.77,0.108,0.103,0.09
227526,2006,1231,689,542,121,28,93,13.5,0.135,0.098,0.052
227757,2006,713,357,356,597,282,315,88.24,0.882,0.837,0.792
227845,2006,698,423,275,372,144,228,53.9,0.539,0.533,0.524
227863,2006,291,187,104,93,26,67,35.83,0.358,0.32,0.25
228042,2006,243,128,115,57,20,37,28.91,0.289,0.235,0.174
228149,2006,548,347,201,187,39,148,42.65,0.426,0.341,0.194
228246,2006,1369,753,616,937,377,560,74.37,0.744,0.684,0.612
228343,2006,345,221,124,231,74,157,71.04,0.71,0.67,0.597
228431,2006,2305,1420,885,538,132,406,28.59,0.286,0.233,0.149
228459,2006,2975,1746,1229,815,250,565,32.36,0.324,0.274,0.203
228501,2006,192,73,119,22,8,14,19.18,0.192,0.115,0.067
228529,2006,1256,667,589,230,94,136,20.39,0.204,0.183,0.16
228705,2006,731,297,434,95,32,63,21.21,0.212,0.13,0.074
228723,2006,7472,3774,3698,3636,1358,2278,60.36,0.604,0.487,0.367
228769,2006,1974,984,990,340,124,216,21.95,0.22,0.172,0.125
228778,2006,7369,4008,3361,3731,1482,2249,56.11,0.561,0.506,0.441
228787,2006,1053,394,659,470,252,218,55.33,0.553,0.446,0.382
228796,2006,2446,1256,1190,269,95,174,13.85,0.138,0.11,0.08
228875,2006,1654,985,669,950,328,622,63.15,0.631,0.574,0.49
228981,2006,387,197,190,105,39,66,33.5,0.335,0.271,0.205
229018,2006,315,178,137,55,18,37,20.79,0.208,0.175,0.131
229027,2006,4687,2389,2298,424,155,269,11.26,0.113,0.09,0.067
229115,2006,3862,1844,2018,1427,601,826,44.79,0.448,0.369,0.298
229780,2006,211,103,108,46,21,25,24.27,0.243,0.218,0.194
229814,2006,920,489,431,223,73,150,30.67,0.307,0.242,0.169
230603,2006,832,594,238,164,23,141,23.74,0.237,0.197,0.097
230728,2006,2429,1574,855,498,102,396,25.16,0.252,0.205,0.119
230764,2006,2037,1167,870,457,149,308,26.39,0.264,0.224,0.171
230782,2006,1289,755,534,114,28,86,11.39,0.114,0.088,0.052
231059,2006,576,333,243,446,192,254,76.28,0.763,0.774,0.79
231174,2006,2175,1251,924,1417,551,866,69.22,0.692,0.651,0.596
231420,2006,160,60,100,45,19,26,43.33,0.433,0.281,0.19
231554,2006,106,59,47,19,5,14,23.73,0.237,0.179,0.106
231624,2006,1341,693,648,1107,497,610,88.02,0.88,0.826,0.767
231712,2006,1172,644,528,594,203,391,60.71,0.607,0.507,0.384
232025,2006,267,115,152,84,36,48,41.74,0.417,0.315,0.237
232043,2006,205,119,86,93,31,62,52.1,0.521,0.454,0.36
232089,2006,417,156,261,126,65,61,39.1,0.391,0.302,0.249
232186,2006,2390,1335,1055,992,355,637,47.72,0.477,0.415,0.336
232265,2006,1098,700,398,447,119,328,46.86,0.469,0.407,0.299
232423,2006,3745,2431,1314,2357,713,1644,67.63,0.676,0.629,0.543
232557,2006,2028,1022,1006,489,209,280,27.4,0.274,0.241,0.208
232566,2006,985,627,358,411,111,300,47.85,0.479,0.417,0.31
232609,2006,552,305,247,259,88,171,56.07,0.561,0.469,0.356
232681,2006,909,614,295,625,180,445,72.48,0.725,0.688,0.61
232706,2006,365,268,97,136,28,108,40.3,0.403,0.373,0.289
232937,2006,1023,638,385,130,34,96,15.05,0.151,0.127,0.088
232982,2006,2059,1108,951,507,159,348,31.41,0.314,0.246,0.167
233277,2006,1730,1045,685,730,252,478,45.74,0.457,0.422,0.368
233374,2006,757,387,370,585,267,318,82.17,0.822,0.773,0.722
233426,2006,503,296,207,285,104,181,61.15,0.612,0.567,0.502
233541,2006,304,157,147,75,29,46,29.3,0.293,0.247,0.197
233897,2006,401,187,214,98,45,53,28.34,0.283,0.244,0.21
233921,2006,5078,2273,2805,2953,1367,1586,69.78,0.698,0.582,0.487
234030,2006,3445,1986,1459,1018,346,672,33.84,0.338,0.296,0.237
234085,2006,387,34,353,216,200,16,47.06,0.471,0.558,0.567
234155,2006,869,540,329,209,54,155,28.7,0.287,0.241,0.164
234164,2006,325,160,165,58,13,45,28.12,0.281,0.178,0.079
235097,2006,1412,855,557,280,84,196,22.92,0.229,0.198,0.151
235167,2006,577,300,277,227,103,124,41.33,0.413,0.393,0.372
236230,2006,668,418,250,401,142,259,61.96,0.62,0.6,0.568
236328,2006,677,406,271,464,173,291,71.67,0.717,0.685,0.638
236577,2006,622,413,209,350,111,239,57.87,0.579,0.563,0.531
236595,2006,731,463,268,455,165,290,62.63,0.626,0.622,0.616
236896,2006,323,164,159,62,28,34,20.73,0.207,0.192,0.176
236939,2006,2676,1349,1327,1040,417,623,46.18,0.462,0.389,0.314
236948,2006,5284,2800,2484,2939,1245,1694,60.5,0.605,0.556,0.501
237011,2006,2425,1397,1028,850,293,557,39.87,0.399,0.351,0.285
237057,2006,367,219,148,294,109,185,84.47,0.845,0.801,0.736
237066,2006,469,285,184,303,115,188,65.96,0.66,0.646,0.625
237215,2006,253,134,119,28,19,9,6.72,0.067,0.111,0.16
237330,2006,593,306,287,102,37,65,21.24,0.212,0.172,0.129
237358,2006,119,65,54,30,14,16,24.62,0.246,0.252,0.259
237367,2006,642,345,297,84,35,49,14.2,0.142,0.131,0.118
237792,2006,688,395,293,135,40,95,24.05,0.241,0.196,0.137
237899,2006,341,170,171,24,8,16,9.41,0.094,0.07,0.047
237932,2006,476,269,207,84,28,56,20.82,0.208,0.176,0.135
237969,2006,291,167,124,117,39,78,46.71,0.467,0.402,0.315
238032,2006,4777,2151,2626,1596,746,850,39.52,0.395,0.334,0.284
238333,2006,347,207,140,243,94,149,71.98,0.72,0.7,0.671
238430,2006,245,168,77,19,6,13,7.74,0.077,0.078,0.078
238458,2006,675,485,190,284,58,226,46.6,0.466,0.421,0.305
238476,2006,653,368,285,337,136,201,54.62,0.546,0.516,0.477
238616,2006,391,214,177,135,53,82,38.32,0.383,0.345,0.299
238661,2006,293,220,73,101,21,80,36.36,0.364,0.345,0.288
239080,2006,245,172,73,61,15,46,26.74,0.267,0.249,0.205
239105,2006,1842,1025,817,1096,445,651,63.51,0.635,0.595,0.545
239628,2006,264,154,110,153,57,96,62.34,0.623,0.58,0.518
239716,2006,551,305,246,356,140,216,70.82,0.708,0.646,0.569
240107,2006,308,223,85,100,21,79,35.43,0.354,0.325,0.247
240189,2006,1780,836,944,533,233,300,35.89,0.359,0.299,0.247
240277,2006,1019,667,352,226,63,163,24.44,0.244,0.222,0.179
240329,2006,1751,1098,653,633,190,443,40.35,0.404,0.362,0.291
240338,2006,198,116,82,81,31,50,43.1,0.431,0.409,0.378
240365,2006,1726,1024,702,272,83,189,18.46,0.185,0.158,0.118
240374,2006,814,442,372,60,18,42,9.5,0.095,0.074,0.048
240417,2006,1507,792,715,275,90,185,23.36,0.234,0.182,0.126
240426,2006,293,143,150,53,26,27,18.88,0.189,0.181,0.173
240444,2006,5633,3033,2600,2965,1202,1763,58.13,0.581,0.526,0.462
240453,2006,3977,2064,1913,554,247,307,14.87,0.149,0.139,0.129
240462,2006,1387,467,920,259,145,114,24.41,0.244,0.187,0.158
240471,2006,1289,773,516,281,77,204,26.39,0.264,0.218,0.149
240480,2006,1640,888,752,395,153,242,27.25,0.272,0.241,0.203
240727,2006,1543,761,782,359,118,241,31.67,0.317,0.233,0.151
243443,2006,764,532,232,66,13,53,9.96,0.1,0.086,0.056
243780,2006,7430,3019,4411,2764,1350,1414,46.84,0.468,0.372,0.306
100654,2007,882,475,407,88,21,67,14.11,0.141,0.1,0.052
100663,2007,1378,807,571,404,137,267,33.09,0.331,0.293,0.24
100751,2007,4438,2461,1977,1897,708,1189,48.31,0.483,0.427,0.358
100858,2007,4165,2207,1958,1565,548,1017,46.08,0.461,0.376,0.28
101435,2007,257,117,140,78,23,55,47.01,0.47,0.304,0.164
101480,2007,1252,696,556,127,44,83,11.93,0.119,0.101,0.079
101675,2007,486,246,240,29,7,22,8.94,0.089,0.06,0.029
101879,2007,1023,558,465,126,31,95,17.03,0.17,0.123,0.067
102049,2007,711,459,252,348,112,236,51.42,0.514,0.489,0.444
102094,2007,1457,801,656,200,68,132,16.48,0.165,0.137,0.104
102234,2007,380,243,137,179,65,114,46.91,0.469,0.471,0.474
102368,2007,1763,1011,752,222,75,147,14.54,0.145,0.126,0.1
102377,2007,796,444,352,133,31,102,22.97,0.23,0.167,0.088
104151,2007,7308,3775,3533,2753,1126,1627,43.1,0.431,0.377,0.319
104179,2007,6231,3395,2836,2485,976,1509,44.45,0.445,0.399,0.344
105330,2007,2880,1676,1204,868,261,607,36.22,0.362,0.301,0.217
106245,2007,812,471,341,57,28,29,6.16,0.062,0.07,0.082
106342,2007,143,84,59,62,19,43,51.19,0.512,0.434,0.322
106397,2007,2877,1425,1452,1055,456,599,42.04,0.42,0.367,0.314
106412,2007,786,411,375,44,10,34,8.27,0.083,0.056,0.027
106458,2007,1655,962,693,309,102,207,21.52,0.215,0.187,0.147
106467,2007,1548,762,786,278,131,147,19.29,0.193,0.18,0.167
106485,2007,617,303,314,52,19,33,10.89,0.109,0.084,0.061
106704,2007,1763,1054,709,362,118,244,23.15,0.231,0.205,0.166
107044,2007,960,549,411,388,124,264,48.09,0.481,0.404,0.302
107080,2007,365,194,171,231,99,132,68.04,0.68,0.633,0.579
107141,2007,361,206,155,200,81,119,57.77,0.578,0.554,0.523
107512,2007,372,202,170,179,60,119,58.91,0.589,0.481,0.353
107558,2007,178,102,76,61,17,44,43.14,0.431,0.343,0.224
110097,2007,789,514,275,385,118,267,51.95,0.52,0.488,0.429
110404,2007,231,86,145,190,117,73,84.88,0.849,0.823,0.807
110422,2007,4419,1885,2534,1282,460,822,43.61,0.436,0.29,0.182
110486,2007,859,578,281,129,25,104,17.99,0.18,0.15,0.089
110495,2007,910,592,318,166,34,132,22.3,0.223,0.182,0.107
110510,2007,1656,1098,558,156,43,113,10.29,0.103,0.094,0.077
110529,2007,3414,1459,1955,343,118,225,15.42,0.154,0.1,0.06
110538,2007,2710,1418,1292,458,138,320,22.57,0.226,0.169,0.107
110547,2007,913,602,311,35,11,24,3.99,0.04,0.038,0.035
110556,2007,2552,1526,1026,350,112,238,15.6,0.156,0.137,0.109
110565,2007,4040,2430,1610,550,135,415,17.08,0.171,0.136,0.084
110574,2007,1032,602,430,111,49,62,10.3,0.103,0.108,0.114
110583,2007,4134,2620,1514,581,166,415,15.84,0.158,0.141,0.11
110592,2007,1767,1106,661,119,40,79,7.14,0.071,0.067,0.061
110617,2007,2357,1426,931,194,64,130,9.12,0.091,0.082,0.069
113698,2007,297,225,72,107,23,84,37.33,0.373,0.36,0.319
115755,2007,1039,551,488,112,39,73,13.25,0.132,0.108,0.08
119173,2007,348,331,17,93,7,86,25.98,0.26,0.267,0.412
120184,2007,96,57,39,35,12,23,40.35,0.404,0.365,0.308
121309,2007,530,336,194,327,109,218,64.88,0.649,0.617,0.562
121345,2007,375,188,187,348,172,176,93.62,0.936,0.928,0.92
122409,2007,4506,2685,1821,1472,449,1023,38.1,0.381,0.327,0.247
122436,2007,1089,635,454,704,254,450,70.87,0.709,0.646,0.559
122597,2007,3341,2123,1218,424,118,306,14.41,0.144,0.127,0.097
122612,2007,1052,680,372,595,179,416,61.18,0.612,0.566,0.481
122931,2007,1201,619,582,923,431,492,79.48,0.795,0.769,0.741
123554,2007,600,366,234,283,102,181,49.45,0.495,0.472,0.436
123572,2007,1673,1073,600,434,97,337,31.41,0.314,0.259,0.162
126562,2007,1010,571,439,163,66,97,16.99,0.17,0.161,0.15
126580,2007,933,511,422,247,89,158,30.92,0.309,0.265,0.211
126614,2007,5540,2734,2806,2456,1059,1397,51.1,0.511,0.443,0.377
126818,2007,4352,2387,1965,1609,564,1045,43.78,0.438,0.37,0.287
127060,2007,1130,619,511,752,321,431,69.63,0.696,0.665,0.628
127185,2007,863,404,459,149,50,99,24.5,0.245,0.173,0.109
127565,2007,1910,1036,874,108,38,70,6.76,0.068,0.057,0.043
127741,2007,2199,1328,871,583,149,434,32.68,0.327,0.265,0.171
128106,2007,602,308,294,109,41,68,22.08,0.221,0.181,0.139
128744,2007,331,209,122,62,17,45,21.53,0.215,0.187,0.139
128771,2007,1466,676,790,294,133,161,23.82,0.238,0.201,0.168
129020,2007,3160,1682,1478,2136,921,1215,72.24,0.722,0.676,0.623
129242,2007,842,496,346,664,268,396,79.84,0.798,0.789,0.775
129941,2007,700,331,369,296,138,158,47.73,0.477,0.423,0.374
130253,2007,956,580,376,606,220,386,66.55,0.665,0.634,0.585
130314,2007,165,165,0,61,0,61,36.97,0.37,0.37,NA
130493,2007,1333,884,449,239,56,183,20.7,0.207,0.179,0.125
130590,2007,576,292,284,469,224,245,83.9,0.839,0.814,0.789
130697,2007,733,377,356,632,305,327,86.74,0.867,0.862,0.857
130776,2007,913,494,419,190,77,113,22.87,0.229,0.208,0.184
130794,2007,1313,661,652,1177,578,599,90.62,0.906,0.896,0.887
130934,2007,799,495,304,145,37,108,21.82,0.218,0.181,0.122
130943,2007,3912,2305,1607,2445,879,1566,67.94,0.679,0.625,0.547
131159,2007,1288,840,448,975,334,641,76.31,0.763,0.757,0.746
131283,2007,864,451,413,535,233,302,66.96,0.67,0.619,0.564
131450,2007,174,97,77,27,9,18,18.56,0.186,0.155,0.117
131469,2007,2123,1198,925,1604,668,936,78.13,0.781,0.756,0.722
131496,2007,1577,864,713,1387,616,771,89.24,0.892,0.88,0.864
131520,2007,1451,1028,423,574,129,445,43.29,0.433,0.396,0.305
132471,2007,472,316,156,102,28,74,23.42,0.234,0.216,0.179
132602,2007,821,511,310,136,44,92,18,0.18,0.166,0.142
132903,2007,6350,3310,3040,2277,827,1450,43.81,0.438,0.359,0.272
133492,2007,535,319,216,315,127,188,58.93,0.589,0.589,0.588
133553,2007,1014,158,856,341,277,64,40.51,0.405,0.336,0.324
133650,2007,1853,1071,782,217,74,143,13.35,0.134,0.117,0.095
133669,2007,2563,1326,1237,388,150,238,17.95,0.18,0.151,0.121
133711,2007,531,333,198,246,85,161,48.35,0.484,0.463,0.429
133881,2007,675,186,489,261,170,91,48.92,0.489,0.387,0.348
133951,2007,3230,1707,1523,661,209,452,26.48,0.265,0.205,0.137
134079,2007,423,259,164,199,77,122,47.1,0.471,0.47,0.47
134097,2007,6104,3436,2668,3458,1266,2192,63.8,0.638,0.567,0.475
134130,2007,6440,3792,2648,4197,1467,2730,71.99,0.72,0.652,0.554
134945,2007,581,274,307,141,60,81,29.56,0.296,0.243,0.195
135726,2007,1977,1049,928,1400,606,794,75.69,0.757,0.708,0.653
136172,2007,2048,1185,863,435,151,284,23.97,0.24,0.212,0.175
136950,2007,525,305,220,319,124,195,63.93,0.639,0.608,0.564
137546,2007,557,322,235,314,121,193,59.94,0.599,0.564,0.515
138354,2007,912,511,401,184,57,127,24.85,0.249,0.202,0.142
138716,2007,626,401,225,100,17,83,20.7,0.207,0.16,0.076
138789,2007,793,477,316,77,16,61,12.79,0.128,0.097,0.051
139144,2007,537,373,164,269,75,194,52.01,0.52,0.501,0.457
139366,2007,996,568,428,117,29,88,15.49,0.155,0.117,0.068
139393,2007,291,163,128,139,51,88,53.99,0.54,0.478,0.398
139658,2007,1597,863,734,1027,477,550,63.73,0.637,0.643,0.65
139719,2007,716,386,330,56,12,44,11.4,0.114,0.078,0.036
139755,2007,2622,854,1768,1072,645,427,50,0.5,0.409,0.365
139764,2007,388,252,136,59,16,43,17.06,0.171,0.152,0.118
139861,2007,1197,778,419,464,124,340,43.7,0.437,0.388,0.296
139931,2007,3028,1402,1626,773,287,486,34.66,0.347,0.255,0.177
139940,2007,2521,1486,1035,540,154,386,25.98,0.26,0.214,0.149
139959,2007,4675,2942,1733,2655,853,1802,61.25,0.613,0.568,0.492
140447,2007,602,337,265,265,87,178,52.82,0.528,0.44,0.328
140960,2007,612,343,269,51,10,41,11.95,0.12,0.083,0.037
140988,2007,276,131,145,91,35,56,42.75,0.428,0.33,0.241
141185,2007,218,128,90,75,28,47,36.72,0.367,0.344,0.311
141264,2007,2029,1233,796,316,86,230,18.65,0.186,0.156,0.108
141334,2007,1803,1051,752,311,93,218,20.74,0.207,0.172,0.124
141486,2007,242,156,86,65,18,47,30.13,0.301,0.269,0.209
141565,2007,497,299,198,41,11,30,10.03,0.1,0.082,0.056
141574,2007,1727,946,781,322,111,211,22.3,0.223,0.186,0.142
142276,2007,998,526,472,88,26,62,11.79,0.118,0.088,0.055
142285,2007,1615,764,851,402,173,229,29.97,0.3,0.249,0.203
142461,2007,220,139,81,70,22,48,34.53,0.345,0.318,0.272
143084,2007,713,418,295,525,199,326,77.99,0.78,0.736,0.675
143288,2007,175,93,82,59,23,36,38.71,0.387,0.337,0.28
144005,2007,372,255,117,15,4,11,4.31,0.043,0.04,0.034
144281,2007,2166,1148,1018,692,313,379,33.01,0.33,0.319,0.307
144740,2007,2513,1458,1055,1363,522,841,57.68,0.577,0.542,0.495
144892,2007,1641,988,653,551,171,380,38.46,0.385,0.336,0.262
144962,2007,508,304,204,300,99,201,66.12,0.661,0.591,0.485
144971,2007,122,73,49,53,15,38,52.05,0.52,0.434,0.306
145600,2007,3272,1813,1459,978,390,588,32.43,0.324,0.299,0.267
145619,2007,385,185,200,146,68,78,42.16,0.422,0.379,0.34
145637,2007,6930,3295,3635,4722,2281,2441,74.08,0.741,0.681,0.628
145691,2007,258,125,133,144,58,86,68.8,0.688,0.558,0.436
145813,2007,3140,1887,1253,1457,455,1002,53.1,0.531,0.464,0.363
146481,2007,356,214,142,208,75,133,62.15,0.622,0.584,0.528
146612,2007,634,365,269,283,131,152,41.64,0.416,0.446,0.487
146719,2007,2035,1377,658,1215,371,844,61.29,0.613,0.597,0.564
146825,2007,125,73,52,35,3,32,43.84,0.438,0.28,0.058
147013,2007,298,131,167,94,42,52,39.69,0.397,0.315,0.251
147244,2007,475,268,207,228,91,137,51.12,0.511,0.48,0.44
147341,2007,393,213,180,223,90,133,62.44,0.624,0.567,0.5
147703,2007,2997,1584,1413,793,353,440,27.78,0.278,0.265,0.25
147767,2007,1979,1057,922,1705,770,935,88.46,0.885,0.862,0.835
147776,2007,870,506,364,36,9,27,5.34,0.053,0.041,0.025
147828,2007,704,384,320,343,135,208,54.17,0.542,0.487,0.422
148131,2007,234,104,130,92,42,50,48.08,0.481,0.393,0.323
148496,2007,366,265,101,184,43,141,53.21,0.532,0.503,0.426
148584,2007,198,124,74,63,18,45,36.29,0.363,0.318,0.243
148627,2007,507,342,165,152,50,102,29.82,0.298,0.3,0.303
149222,2007,2541,1127,1414,582,268,314,27.86,0.279,0.229,0.19
149231,2007,1833,1026,807,509,179,330,32.16,0.322,0.278,0.222
149772,2007,1943,952,991,572,258,314,32.98,0.33,0.294,0.26
149781,2007,580,292,288,432,216,216,73.97,0.74,0.745,0.75
150066,2007,479,239,240,216,90,126,52.72,0.527,0.451,0.375
150136,2007,3747,2033,1714,1223,432,791,38.91,0.389,0.326,0.252
150145,2007,249,159,90,106,33,73,45.91,0.459,0.426,0.367
150163,2007,987,613,374,502,157,345,56.28,0.563,0.509,0.42
150400,2007,664,369,295,493,211,282,76.42,0.764,0.742,0.715
150534,2007,651,375,276,344,129,215,57.33,0.573,0.528,0.467
150668,2007,202,114,88,110,44,66,57.89,0.579,0.545,0.5
150941,2007,244,138,106,138,63,75,54.35,0.543,0.566,0.594
151102,2007,1804,942,862,91,33,58,6.16,0.062,0.05,0.038
151111,2007,2737,1659,1078,392,144,248,14.95,0.15,0.143,0.134
151306,2007,2074,1209,865,299,74,225,18.61,0.186,0.144,0.086
151324,2007,1820,924,896,375,138,237,25.65,0.256,0.206,0.154
151333,2007,381,234,147,27,6,21,8.97,0.09,0.071,0.041
151342,2007,876,524,352,44,26,18,3.44,0.034,0.05,0.074
151351,2007,7167,3707,3460,4169,1874,2295,61.91,0.619,0.582,0.542
151360,2007,556,356,200,38,13,25,7.02,0.07,0.068,0.065
151379,2007,783,449,334,69,21,48,10.69,0.107,0.088,0.063
151388,2007,264,157,107,22,4,18,11.46,0.115,0.083,0.037
151777,2007,316,147,169,126,55,71,48.3,0.483,0.399,0.325
151786,2007,271,142,129,76,23,53,37.32,0.373,0.28,0.178
152080,2007,1984,948,1036,1782,913,869,91.67,0.917,0.898,0.881
152248,2007,1220,630,590,104,40,64,10.16,0.102,0.085,0.068
152363,2007,300,138,162,107,50,57,41.3,0.413,0.357,0.309
152530,2007,472,272,200,306,129,177,65.07,0.651,0.648,0.645
152600,2007,713,370,343,413,193,220,59.46,0.595,0.579,0.563
153001,2007,226,122,104,97,35,62,50.82,0.508,0.429,0.337
153108,2007,422,219,203,260,111,149,68.04,0.68,0.616,0.547
153269,2007,923,557,366,484,170,314,56.37,0.564,0.524,0.464
153384,2007,426,233,193,344,152,192,82.4,0.824,0.808,0.788
153603,2007,4307,1920,2387,1622,682,940,48.96,0.49,0.377,0.286
153834,2007,659,374,285,439,177,262,70.05,0.701,0.666,0.621
154095,2007,1922,1177,745,708,237,471,40.02,0.4,0.368,0.318
155089,2007,139,72,67,14,7,7,9.72,0.097,0.101,0.104
155317,2007,4028,2084,1944,1444,582,862,41.36,0.414,0.358,0.299
155335,2007,133,72,61,44,13,31,43.06,0.431,0.331,0.213
155399,2007,3301,1629,1672,843,290,553,33.95,0.34,0.255,0.173
155520,2007,217,109,108,89,33,56,51.38,0.514,0.41,0.306
155627,2007,161,79,82,35,11,24,30.38,0.304,0.217,0.134
155937,2007,165,70,95,50,25,25,35.71,0.357,0.303,0.263
156213,2007,311,173,138,175,65,110,63.58,0.636,0.563,0.471
156286,2007,567,351,216,304,97,207,58.97,0.59,0.536,0.449
156295,2007,420,252,168,197,72,125,49.6,0.496,0.469,0.429
156365,2007,377,168,209,98,47,51,30.36,0.304,0.26,0.225
156541,2007,481,217,264,115,45,70,32.26,0.323,0.239,0.17
156745,2007,366,206,160,180,59,121,58.74,0.587,0.492,0.369
157058,2007,602,343,259,39,5,34,9.91,0.099,0.065,0.019
157076,2007,280,120,160,69,27,42,35,0.35,0.246,0.169
157085,2007,3826,2006,1820,1276,498,778,38.78,0.388,0.334,0.274
157289,2007,2525,1314,1211,634,262,372,28.31,0.283,0.251,0.216
157386,2007,1445,803,642,257,87,170,21.17,0.212,0.178,0.136
157401,2007,1393,835,558,397,128,269,32.22,0.322,0.285,0.229
157447,2007,1896,1068,828,253,84,169,15.82,0.158,0.133,0.101
157535,2007,233,103,130,35,15,20,19.42,0.194,0.15,0.115
157951,2007,3013,1716,1297,610,197,413,24.07,0.241,0.202,0.152
158477,2007,200,114,86,97,35,62,54.39,0.544,0.485,0.407
159009,2007,1184,610,574,83,24,59,9.67,0.097,0.07,0.042
159391,2007,4585,2415,2170,1737,658,1079,44.68,0.447,0.379,0.303
159647,2007,1522,704,818,432,180,252,35.8,0.358,0.284,0.22
159717,2007,1247,717,530,163,55,108,15.06,0.151,0.131,0.104
159966,2007,1156,696,460,196,59,137,19.68,0.197,0.17,0.128
160038,2007,1281,812,469,223,69,154,18.97,0.19,0.174,0.147
160612,2007,2524,1458,1066,336,102,234,16.05,0.16,0.133,0.096
160621,2007,1178,658,520,95,18,77,11.7,0.117,0.081,0.035
160658,2007,2691,1554,1137,361,111,250,16.09,0.161,0.134,0.098
161004,2007,475,250,225,416,196,220,88,0.88,0.876,0.871
161226,2007,479,327,152,181,45,136,41.59,0.416,0.378,0.296
161235,2007,110,60,50,36,18,18,30,0.3,0.327,0.36
161244,2007,110,72,38,15,6,9,12.5,0.125,0.136,0.158
161253,2007,1816,863,953,648,301,347,40.21,0.402,0.357,0.316
161554,2007,900,499,401,87,32,55,11.02,0.11,0.097,0.08
162007,2007,820,506,314,106,19,87,17.19,0.172,0.129,0.061
162210,2007,126,83,43,22,5,17,20.48,0.205,0.175,0.116
162283,2007,555,421,134,23,9,14,3.33,0.033,0.041,0.067
162584,2007,1057,520,537,233,92,141,27.12,0.271,0.22,0.171
162654,2007,399,277,122,236,67,169,61.01,0.61,0.591,0.549
162760,2007,295,193,102,163,48,115,59.59,0.596,0.553,0.471
162928,2007,1260,607,653,1095,545,550,90.61,0.906,0.869,0.835
163046,2007,979,545,434,777,320,457,83.85,0.838,0.794,0.737
163268,2007,1423,655,768,523,230,293,44.73,0.447,0.368,0.299
163286,2007,4229,2028,2201,2772,1300,1472,72.58,0.726,0.655,0.591
163453,2007,1286,698,588,143,42,101,14.47,0.145,0.111,0.071
163462,2007,448,256,192,275,114,161,62.89,0.629,0.614,0.594
163851,2007,1142,646,496,533,172,361,55.88,0.559,0.467,0.347
163912,2007,464,256,208,331,134,197,76.95,0.77,0.713,0.644
164076,2007,2649,1670,979,1069,314,755,45.21,0.452,0.404,0.321
164173,2007,604,436,168,254,61,193,44.27,0.443,0.421,0.363
164216,2007,324,197,127,210,69,141,71.57,0.716,0.648,0.543
164270,2007,439,226,213,279,118,161,71.24,0.712,0.636,0.554
164447,2007,390,202,188,111,55,56,27.72,0.277,0.285,0.293
164492,2007,258,137,121,112,45,67,48.91,0.489,0.434,0.372
164562,2007,594,331,263,417,176,241,72.81,0.728,0.702,0.669
165015,2007,701,391,310,604,264,340,86.96,0.87,0.862,0.852
165024,2007,1551,935,616,445,139,306,32.73,0.327,0.287,0.226
165334,2007,572,361,211,432,157,275,76.18,0.762,0.755,0.744
165662,2007,842,477,365,671,274,397,83.23,0.832,0.797,0.751
165671,2007,582,436,146,299,74,225,51.61,0.516,0.514,0.507
165820,2007,698,366,332,142,56,86,23.5,0.235,0.203,0.169
165866,2007,633,420,213,212,52,160,38.1,0.381,0.335,0.244
165936,2007,454,286,168,264,95,169,59.09,0.591,0.581,0.565
166027,2007,1657,839,818,1434,695,739,88.08,0.881,0.865,0.85
166124,2007,718,398,320,639,272,367,92.21,0.922,0.89,0.85
166513,2007,1220,424,796,346,179,167,39.39,0.394,0.284,0.225
166629,2007,4374,2321,2053,2504,1060,1444,62.21,0.622,0.572,0.516
166638,2007,950,558,392,144,42,102,18.28,0.183,0.152,0.107
166683,2007,1068,492,576,892,463,429,87.2,0.872,0.835,0.804
167288,2007,334,207,127,128,37,91,43.96,0.44,0.383,0.291
167987,2007,1901,859,1042,575,262,313,36.44,0.364,0.302,0.251
167996,2007,659,409,250,539,199,340,83.13,0.831,0.818,0.796
168005,2007,1308,752,556,531,218,313,41.62,0.416,0.406,0.392
168148,2007,1370,703,667,1194,570,624,88.76,0.888,0.872,0.855
168254,2007,713,293,420,372,193,179,61.09,0.611,0.522,0.46
168281,2007,418,262,156,297,98,199,75.95,0.76,0.711,0.628
168342,2007,539,258,281,483,248,235,91.09,0.911,0.896,0.883
168546,2007,500,258,242,322,144,178,68.99,0.69,0.644,0.595
168786,2007,410,269,141,124,35,89,33.09,0.331,0.302,0.248
169080,2007,1034,556,478,590,246,344,61.87,0.619,0.571,0.515
169798,2007,2365,1345,1020,294,109,185,13.75,0.138,0.124,0.107
169910,2007,2035,933,1102,182,79,103,11.04,0.11,0.089,0.072
170082,2007,3446,2201,1245,1137,346,791,35.94,0.359,0.33,0.278
170301,2007,819,495,324,554,199,355,71.72,0.717,0.676,0.614
170532,2007,363,213,150,263,100,163,76.53,0.765,0.725,0.667
170639,2007,469,230,239,66,35,31,13.48,0.135,0.141,0.146
170976,2007,5955,3019,2936,4513,2063,2450,81.15,0.812,0.758,0.703
171100,2007,7398,4099,3299,3666,1372,2294,55.96,0.56,0.496,0.416
171128,2007,1215,287,928,275,197,78,27.18,0.272,0.226,0.212
171137,2007,859,420,439,128,61,67,15.95,0.16,0.149,0.139
171146,2007,594,346,248,56,16,40,11.56,0.116,0.094,0.065
171599,2007,182,67,115,48,18,30,44.78,0.448,0.264,0.157
172051,2007,1533,883,650,155,56,99,11.21,0.112,0.101,0.086
172699,2007,3473,1750,1723,842,362,480,27.43,0.274,0.242,0.21
173160,2007,597,370,227,374,126,248,67.03,0.67,0.626,0.555
173258,2007,509,255,254,456,221,235,92.16,0.922,0.896,0.87
173328,2007,201,112,89,61,20,41,36.61,0.366,0.303,0.225
173647,2007,666,374,292,542,234,308,82.35,0.824,0.814,0.801
173902,2007,485,270,215,411,176,235,87.04,0.87,0.847,0.819
174066,2007,5256,2927,2329,2863,1182,1681,57.43,0.574,0.545,0.508
174233,2007,2196,1100,1096,649,244,405,36.82,0.368,0.296,0.223
174251,2007,358,205,153,180,65,115,56.1,0.561,0.503,0.425
174491,2007,526,315,211,264,99,165,52.38,0.524,0.502,0.469
174792,2007,516,0,516,364,364,0,NA,NA,0.705,0.705
174844,2007,751,406,345,624,287,337,83,0.83,0.831,0.832
174899,2007,487,336,151,288,76,212,63.1,0.631,0.591,0.503
174914,2007,1313,672,641,822,365,457,68.01,0.68,0.626,0.569
175342,2007,514,305,209,94,27,67,21.97,0.22,0.183,0.129
175421,2007,241,134,107,60,15,45,33.58,0.336,0.249,0.14
175616,2007,477,293,184,78,27,51,17.41,0.174,0.164,0.147
175856,2007,919,541,378,153,41,112,20.7,0.207,0.166,0.108
175980,2007,296,154,142,175,75,100,64.94,0.649,0.591,0.528
176017,2007,2434,1293,1141,885,328,557,43.08,0.431,0.364,0.287
176035,2007,235,213,22,46,6,40,18.78,0.188,0.196,0.273
176044,2007,485,256,229,51,15,36,14.06,0.141,0.105,0.066
176080,2007,2262,1105,1157,699,274,425,38.46,0.385,0.309,0.237
176406,2007,200,135,65,53,9,44,32.59,0.326,0.265,0.138
176628,2007,114,79,35,30,5,25,31.65,0.316,0.263,0.143
176947,2007,270,123,147,69,31,38,30.89,0.309,0.256,0.211
176965,2007,1426,786,640,428,148,280,35.62,0.356,0.3,0.231
177418,2007,193,110,83,5,1,4,3.64,0.036,0.026,0.012
178059,2007,294,211,83,149,43,106,50.24,0.502,0.507,0.518
178341,2007,766,416,350,110,29,81,19.47,0.195,0.144,0.083
178387,2007,935,538,397,126,36,90,16.73,0.167,0.135,0.091
178396,2007,4897,2672,2225,2305,829,1476,55.24,0.552,0.471,0.373
178402,2007,916,568,348,188,59,129,22.71,0.227,0.205,0.17
178411,2007,1018,208,810,257,180,77,37.02,0.37,0.252,0.222
178420,2007,462,280,182,94,25,69,24.64,0.246,0.203,0.137
178615,2007,1402,814,588,754,248,506,62.16,0.622,0.538,0.422
179043,2007,367,230,137,222,81,141,61.3,0.613,0.605,0.591
179159,2007,1629,933,696,988,380,608,65.17,0.652,0.607,0.546
179557,2007,1650,946,704,438,158,280,29.6,0.296,0.265,0.224
179566,2007,2610,1514,1096,796,263,533,35.2,0.352,0.305,0.24
179867,2007,1325,645,680,1169,593,576,89.3,0.893,0.882,0.872
179894,2007,483,278,205,224,80,144,51.8,0.518,0.464,0.39
179946,2007,223,95,128,115,57,58,61.05,0.61,0.516,0.445
180179,2007,724,393,331,60,16,44,11.2,0.112,0.083,0.048
180461,2007,1852,791,1061,371,162,209,26.42,0.264,0.2,0.153
180522,2007,186,69,117,19,12,7,10.14,0.101,0.102,0.103
180984,2007,264,141,123,111,41,70,49.65,0.496,0.42,0.333
181002,2007,947,577,370,638,254,384,66.55,0.665,0.674,0.686
181020,2007,259,115,144,132,65,67,58.26,0.583,0.51,0.451
181127,2007,302,117,185,131,70,61,52.14,0.521,0.434,0.378
181215,2007,915,484,431,193,74,119,24.59,0.246,0.211,0.172
181394,2007,1596,834,762,228,106,122,14.63,0.146,0.143,0.139
181446,2007,438,272,166,239,74,165,60.66,0.607,0.546,0.446
181464,2007,4214,2061,2153,1363,555,808,39.2,0.392,0.323,0.258
181534,2007,197,89,108,38,13,25,28.09,0.281,0.193,0.12
181783,2007,654,364,290,162,48,114,31.32,0.313,0.248,0.166
182281,2007,2780,1596,1184,406,117,289,18.11,0.181,0.146,0.099
182290,2007,2226,1166,1060,349,131,218,18.7,0.187,0.157,0.124
182634,2007,353,240,113,169,44,125,52.08,0.521,0.479,0.389
182795,2007,533,239,294,207,100,107,44.77,0.448,0.388,0.34
183062,2007,1295,762,533,666,252,414,54.33,0.543,0.514,0.473
183080,2007,1006,444,562,414,206,208,46.85,0.469,0.412,0.367
183239,2007,568,300,268,404,169,235,78.33,0.783,0.711,0.631
183822,2007,313,176,137,45,24,21,11.93,0.119,0.144,0.175
183974,2007,275,175,100,154,54,100,57.14,0.571,0.56,0.54
184348,2007,452,268,184,293,107,186,69.4,0.694,0.648,0.582
184603,2007,400,210,190,117,30,87,41.43,0.414,0.292,0.158
184612,2007,294,213,81,72,18,54,25.35,0.254,0.245,0.222
184782,2007,1226,506,720,561,301,260,51.38,0.514,0.458,0.418
185129,2007,649,340,309,32,16,16,4.71,0.047,0.049,0.052
185572,2007,944,538,406,393,165,228,42.38,0.424,0.416,0.406
185590,2007,2068,1276,792,711,205,506,39.66,0.397,0.344,0.259
185828,2007,730,148,582,171,117,54,36.49,0.365,0.234,0.201
186131,2007,1243,593,650,1091,553,538,90.73,0.907,0.878,0.851
186201,2007,898,519,379,527,181,346,66.67,0.667,0.587,0.478
186283,2007,990,569,421,547,201,346,60.81,0.608,0.553,0.477
186584,2007,1256,664,592,631,277,354,53.31,0.533,0.502,0.468
186876,2007,794,480,314,335,93,242,50.42,0.504,0.422,0.296
187134,2007,1297,774,523,940,334,606,78.29,0.783,0.725,0.639
187444,2007,1299,642,657,211,89,122,19,0.19,0.162,0.135
187985,2007,2850,1637,1213,415,147,268,16.37,0.164,0.146,0.121
188030,2007,2105,1123,982,329,94,235,20.93,0.209,0.156,0.096
188429,2007,883,603,280,464,134,330,54.73,0.547,0.525,0.479
188641,2007,518,239,279,231,107,124,51.88,0.519,0.446,0.384
190044,2007,682,189,493,418,289,129,68.25,0.682,0.613,0.586
190099,2007,744,382,362,644,297,347,90.84,0.908,0.866,0.82
190150,2007,1371,671,700,1173,586,587,87.48,0.875,0.856,0.837
190248,2007,127,76,51,35,9,26,34.21,0.342,0.276,0.176
190415,2007,3005,1454,1551,2601,1285,1316,90.51,0.905,0.866,0.828
190512,2007,1470,695,775,578,259,319,45.9,0.459,0.393,0.334
190549,2007,1300,743,557,305,103,202,27.19,0.272,0.235,0.185
190558,2007,2273,1272,1001,122,48,74,5.82,0.058,0.054,0.048
190567,2007,1771,916,855,166,65,101,11.03,0.11,0.094,0.076
190594,2007,1854,1226,628,402,89,313,25.53,0.255,0.217,0.142
190637,2007,874,610,264,129,35,94,15.41,0.154,0.148,0.133
190664,2007,1755,1064,691,440,112,328,30.83,0.308,0.251,0.162
190691,2007,983,636,347,50,11,39,6.13,0.061,0.051,0.032
190725,2007,361,268,93,99,19,80,29.85,0.299,0.274,0.204
191241,2007,1760,910,850,1338,645,693,76.15,0.762,0.76,0.759
191515,2007,468,247,221,419,193,226,91.5,0.915,0.895,0.873
191533,2007,452,256,196,243,92,151,58.98,0.59,0.538,0.469
191630,2007,600,338,262,444,172,272,80.47,0.805,0.74,0.656
191649,2007,1716,907,809,850,344,506,55.79,0.558,0.495,0.425
191676,2007,264,174,90,171,54,117,67.24,0.672,0.648,0.6
191931,2007,906,486,420,476,195,281,57.82,0.578,0.525,0.464
191968,2007,1794,1055,739,1241,488,753,71.37,0.714,0.692,0.66
192192,2007,274,192,82,98,28,70,36.46,0.365,0.358,0.341
192323,2007,577,348,229,362,125,237,68.1,0.681,0.627,0.546
192439,2007,1021,721,300,61,16,45,6.24,0.062,0.06,0.053
192703,2007,708,356,352,427,201,226,63.48,0.635,0.603,0.571
192749,2007,463,315,148,249,59,190,60.32,0.603,0.538,0.399
192819,2007,1019,561,458,713,295,418,74.51,0.745,0.7,0.644
192925,2007,409,255,154,131,56,75,29.41,0.294,0.32,0.364
193016,2007,532,343,189,111,21,90,26.24,0.262,0.209,0.111
193292,2007,370,282,88,140,31,109,38.65,0.386,0.378,0.352
193353,2007,364,252,112,150,31,119,47.22,0.472,0.412,0.277
193399,2007,394,272,122,144,39,105,38.6,0.386,0.365,0.32
193584,2007,456,335,121,268,60,208,62.09,0.621,0.588,0.496
193645,2007,805,733,72,126,2,124,16.92,0.169,0.157,0.028
193654,2007,999,740,259,482,118,364,49.19,0.492,0.482,0.456
193900,2007,4884,3064,1820,2973,1082,1891,61.72,0.617,0.609,0.595
193973,2007,737,435,302,440,164,276,63.45,0.635,0.597,0.543
194161,2007,304,172,132,74,22,52,30.23,0.302,0.243,0.167
194310,2007,1537,937,600,528,183,345,36.82,0.368,0.344,0.305
194824,2007,1288,389,899,836,576,260,66.84,0.668,0.649,0.641
195003,2007,2497,788,1709,648,306,342,43.4,0.434,0.26,0.179
195030,2007,1181,603,578,905,415,490,81.26,0.813,0.766,0.718
195164,2007,527,264,263,283,133,150,56.82,0.568,0.537,0.506
195173,2007,478,261,217,130,48,82,31.42,0.314,0.272,0.221
195216,2007,627,383,244,482,181,301,78.59,0.786,0.769,0.742
195234,2007,611,456,155,326,63,263,57.68,0.577,0.534,0.406
195243,2007,324,163,161,117,49,68,41.72,0.417,0.361,0.304
195304,2007,363,278,85,226,50,176,63.31,0.633,0.623,0.588
195474,2007,781,463,318,578,219,359,77.54,0.775,0.74,0.689
195526,2007,682,406,276,564,213,351,86.45,0.865,0.827,0.772
195544,2007,672,474,198,373,87,286,60.34,0.603,0.555,0.439
195809,2007,3151,1689,1462,1121,455,666,39.43,0.394,0.356,0.311
196413,2007,3092,1756,1336,2119,846,1273,72.49,0.725,0.685,0.633
196592,2007,848,545,303,80,22,58,10.64,0.106,0.094,0.073
197045,2007,492,265,227,146,60,86,32.45,0.324,0.297,0.264
197133,2007,677,409,268,607,233,374,91.44,0.914,0.897,0.869
197869,2007,2730,1401,1329,1133,431,702,50.11,0.501,0.415,0.324
197984,2007,210,90,120,69,28,41,45.56,0.456,0.329,0.233
198385,2007,464,234,230,417,198,219,93.59,0.936,0.899,0.861
198464,2007,4195,2535,1660,1294,391,903,35.62,0.356,0.308,0.236
198507,2007,642,391,251,138,39,99,25.32,0.253,0.215,0.155
198516,2007,1286,746,540,987,380,607,81.37,0.814,0.767,0.704
198835,2007,367,214,153,146,48,98,45.79,0.458,0.398,0.314
198969,2007,433,138,295,76,31,45,32.61,0.326,0.176,0.105
199102,2007,1569,819,750,251,64,187,22.83,0.228,0.16,0.085
199111,2007,571,341,230,211,67,144,42.23,0.422,0.37,0.291
199120,2007,3877,2338,1539,3124,1151,1973,84.39,0.844,0.806,0.748
199139,2007,2926,1520,1406,749,304,445,29.28,0.293,0.256,0.216
199148,2007,2431,1689,742,721,166,555,32.86,0.329,0.297,0.224
199157,2007,1236,764,472,185,47,138,18.06,0.181,0.15,0.1
199193,2007,4895,2179,2716,1975,836,1139,52.27,0.523,0.403,0.308
199218,2007,1913,1138,775,991,340,651,57.21,0.572,0.518,0.439
199281,2007,1101,585,516,170,57,113,19.32,0.193,0.154,0.11
199306,2007,189,90,99,63,28,35,38.89,0.389,0.333,0.283
199412,2007,290,198,92,126,32,94,47.47,0.475,0.434,0.348
199582,2007,417,188,229,91,31,60,31.91,0.319,0.218,0.135
199643,2007,565,321,244,89,35,54,16.82,0.168,0.158,0.143
199847,2007,1123,573,550,919,433,486,84.82,0.848,0.818,0.787
199962,2007,426,209,217,200,87,113,54.07,0.541,0.469,0.401
199999,2007,962,661,301,171,40,131,19.82,0.198,0.178,0.133
200004,2007,1249,651,598,400,142,258,39.63,0.396,0.32,0.237
200059,2007,355,191,164,48,19,29,15.18,0.152,0.135,0.116
200156,2007,264,140,124,88,26,62,44.29,0.443,0.333,0.21
200217,2007,352,206,146,99,20,79,38.35,0.384,0.281,0.137
200226,2007,89,42,47,18,5,13,30.95,0.31,0.202,0.106
200253,2007,418,231,187,60,21,39,16.88,0.169,0.144,0.112
200280,2007,1832,883,949,441,200,241,27.29,0.273,0.241,0.211
200332,2007,2125,965,1160,544,244,300,31.09,0.311,0.256,0.21
200572,2007,184,86,98,42,14,28,32.56,0.326,0.228,0.143
201104,2007,639,371,268,264,77,187,50.4,0.504,0.413,0.287
201371,2007,206,117,89,108,41,67,57.26,0.573,0.524,0.461
201548,2007,627,377,250,323,117,206,54.64,0.546,0.515,0.468
201645,2007,1132,492,640,734,368,366,74.39,0.744,0.648,0.575
201690,2007,564,278,286,59,15,44,15.83,0.158,0.105,0.052
202134,2007,1132,622,510,94,37,57,9.16,0.092,0.083,0.073
202480,2007,1763,893,870,1064,460,604,67.64,0.676,0.604,0.529
202523,2007,585,325,260,455,199,256,78.77,0.788,0.778,0.765
202763,2007,594,416,178,258,53,205,49.28,0.493,0.434,0.298
203085,2007,369,149,220,130,64,66,44.3,0.443,0.352,0.291
203128,2007,333,184,149,199,77,122,66.3,0.663,0.598,0.517
203368,2007,720,358,362,471,216,255,71.23,0.712,0.654,0.597
203517,2007,3729,2300,1429,1031,308,723,31.43,0.314,0.276,0.216
203535,2007,458,249,209,395,175,220,88.35,0.883,0.862,0.837
203580,2007,237,108,129,66,21,45,41.67,0.417,0.278,0.163
203775,2007,387,235,152,177,58,119,50.64,0.506,0.457,0.382
203845,2007,415,201,214,182,75,107,53.23,0.532,0.439,0.35
204024,2007,3456,1902,1554,2359,968,1391,73.13,0.731,0.683,0.623
204185,2007,593,282,311,316,130,186,65.96,0.66,0.533,0.418
204194,2007,350,210,140,171,56,115,54.76,0.548,0.489,0.4
204617,2007,391,207,184,112,48,64,30.92,0.309,0.286,0.261
204796,2007,6155,3039,3116,3602,1534,2068,68.05,0.68,0.585,0.492
204857,2007,3970,2059,1911,1902,781,1121,54.44,0.544,0.479,0.409
206330,2007,240,101,139,57,29,28,27.72,0.277,0.238,0.209
206589,2007,545,287,258,384,159,225,78.4,0.784,0.705,0.616
206604,2007,2371,1339,1032,447,160,287,21.43,0.214,0.189,0.155
206622,2007,858,447,411,572,268,304,68.01,0.68,0.667,0.652
206695,2007,2140,1101,1039,168,70,98,8.9,0.089,0.079,0.067
206914,2007,716,382,334,50,22,28,7.33,0.073,0.07,0.066
207209,2007,559,270,289,48,8,40,14.81,0.148,0.086,0.028
207306,2007,328,173,155,43,13,30,17.34,0.173,0.131,0.084
207324,2007,521,269,252,148,63,85,31.6,0.316,0.284,0.25
207388,2007,3111,1599,1512,1013,399,614,38.4,0.384,0.326,0.264
207500,2007,3824,2043,1781,1331,452,879,43.02,0.43,0.348,0.254
207722,2007,198,123,75,51,13,38,30.89,0.309,0.258,0.173
207847,2007,631,326,305,82,33,49,15.03,0.15,0.13,0.108
207865,2007,896,552,344,116,32,84,15.22,0.152,0.129,0.093
208822,2007,435,279,156,225,61,164,58.78,0.588,0.517,0.391
209056,2007,506,322,184,338,108,230,71.43,0.714,0.668,0.587
209065,2007,476,276,200,281,96,185,67.03,0.67,0.59,0.48
209542,2007,2974,1436,1538,879,333,546,38.02,0.38,0.296,0.217
209551,2007,3505,1839,1666,1528,629,899,48.89,0.489,0.436,0.378
209612,2007,372,242,130,194,59,135,55.79,0.558,0.522,0.454
209807,2007,1427,759,668,252,93,159,20.95,0.21,0.177,0.139
209922,2007,337,187,150,236,99,137,73.26,0.733,0.7,0.66
210146,2007,703,405,298,127,37,90,22.22,0.222,0.181,0.124
210401,2007,444,238,206,315,130,185,77.73,0.777,0.709,0.631
210429,2007,916,527,389,184,54,130,24.67,0.247,0.201,0.139
210571,2007,512,307,205,247,90,157,51.14,0.511,0.482,0.439
210669,2007,581,351,230,431,159,272,77.49,0.775,0.742,0.691
210775,2007,302,165,137,107,48,59,35.76,0.358,0.354,0.35
211088,2007,476,364,112,253,53,200,54.95,0.549,0.532,0.473
211158,2007,1679,969,710,710,237,473,48.81,0.488,0.423,0.334
211291,2007,887,441,446,774,373,401,90.93,0.909,0.873,0.836
211352,2007,513,329,184,202,66,136,41.34,0.413,0.394,0.359
211361,2007,1250,622,628,281,124,157,25.24,0.252,0.225,0.197
211431,2007,199,194,5,93,0,93,47.94,0.479,0.467,0
211440,2007,1407,554,853,1046,612,434,78.34,0.783,0.743,0.717
211468,2007,222,221,1,112,0,112,50.68,0.507,0.505,0
211556,2007,175,175,0,77,0,77,44,0.44,0.44,NA
211583,2007,234,128,106,63,24,39,30.47,0.305,0.269,0.226
211608,2007,278,166,112,26,5,21,12.65,0.126,0.094,0.045
211644,2007,1381,799,582,417,142,275,34.42,0.344,0.302,0.244
211981,2007,475,270,205,221,79,142,52.59,0.526,0.465,0.385
212009,2007,619,319,300,515,237,278,87.15,0.872,0.832,0.79
212054,2007,2260,945,1315,640,254,386,40.85,0.409,0.283,0.193
212106,2007,1354,785,569,796,307,489,62.29,0.623,0.588,0.54
212115,2007,1183,612,571,422,156,266,43.46,0.435,0.357,0.273
212133,2007,483,319,164,206,58,148,46.39,0.464,0.427,0.354
212160,2007,1243,707,536,239,75,164,23.2,0.232,0.192,0.14
212197,2007,487,324,163,344,113,231,71.3,0.713,0.706,0.693
212577,2007,569,301,268,477,214,263,87.38,0.874,0.838,0.799
212601,2007,610,365,245,276,96,180,49.32,0.493,0.452,0.392
212832,2007,291,208,83,58,23,35,16.83,0.168,0.199,0.277
212911,2007,315,169,146,287,131,156,92.31,0.923,0.911,0.897
213020,2007,2524,1450,1074,786,257,529,36.48,0.365,0.311,0.239
213251,2007,377,220,157,271,104,167,75.91,0.759,0.719,0.662
213321,2007,555,268,287,338,173,165,61.57,0.616,0.609,0.603
213349,2007,1888,1111,777,645,182,463,41.67,0.417,0.342,0.234
213358,2007,294,192,102,93,29,64,33.33,0.333,0.316,0.284
213367,2007,804,472,332,424,136,288,61.02,0.61,0.527,0.41
213385,2007,591,277,314,500,253,247,89.17,0.892,0.846,0.806
213507,2007,450,261,189,308,109,199,76.25,0.763,0.684,0.577
213543,2007,1165,450,715,851,485,366,81.33,0.813,0.73,0.678
213613,2007,1217,656,561,321,144,177,26.98,0.27,0.264,0.257
213668,2007,399,211,188,215,84,131,62.09,0.621,0.539,0.447
213783,2007,661,397,264,198,63,135,34.01,0.34,0.3,0.239
213826,2007,407,297,110,218,46,172,57.91,0.579,0.536,0.418
213996,2007,723,459,264,514,185,329,71.68,0.717,0.711,0.701
214041,2007,1326,766,560,491,161,330,43.08,0.431,0.37,0.288
214069,2007,364,273,91,234,51,183,67.03,0.67,0.643,0.56
214157,2007,401,214,187,282,130,152,71.03,0.71,0.703,0.695
214175,2007,551,304,247,445,189,256,84.21,0.842,0.808,0.765
214272,2007,540,336,204,157,44,113,33.63,0.336,0.291,0.216
214777,2007,6492,3121,3371,4191,1943,2248,72.03,0.72,0.646,0.576
215062,2007,2342,1107,1235,2058,1052,1006,90.88,0.909,0.879,0.852
215743,2007,403,258,145,230,71,159,61.63,0.616,0.571,0.49
215798,2007,423,200,223,269,130,139,69.5,0.695,0.636,0.583
215929,2007,1025,574,451,771,307,464,80.84,0.808,0.752,0.681
216010,2007,1720,927,793,639,251,388,41.86,0.419,0.372,0.317
216038,2007,1498,876,622,596,185,411,46.92,0.469,0.398,0.297
216287,2007,365,190,175,324,152,172,90.53,0.905,0.888,0.869
216339,2007,4385,2478,1907,1705,684,1021,41.2,0.412,0.389,0.359
216524,2007,468,242,226,353,159,194,80.17,0.802,0.754,0.704
216694,2007,402,232,170,182,67,115,49.57,0.496,0.453,0.394
216764,2007,1955,1215,740,857,235,622,51.19,0.512,0.438,0.318
216807,2007,311,179,132,195,76,119,66.48,0.665,0.627,0.576
216852,2007,782,382,400,312,133,179,46.86,0.469,0.399,0.332
216931,2007,620,299,321,291,146,145,48.49,0.485,0.469,0.455
217059,2007,1177,597,580,437,189,248,41.54,0.415,0.371,0.326
217156,2007,1477,814,663,1246,548,698,85.75,0.858,0.844,0.827
217402,2007,989,559,430,820,361,459,82.11,0.821,0.829,0.84
217536,2007,556,353,203,338,117,221,62.61,0.626,0.608,0.576
217776,2007,183,114,69,49,20,29,25.44,0.254,0.268,0.29
217819,2007,2061,1352,709,1071,302,769,56.88,0.569,0.52,0.426
217882,2007,2702,1304,1398,1598,677,921,70.63,0.706,0.591,0.484
217998,2007,163,94,69,84,30,54,57.45,0.575,0.515,0.435
218061,2007,776,493,283,127,47,80,16.23,0.162,0.164,0.166
218229,2007,433,296,137,139,35,104,35.14,0.351,0.321,0.255
218238,2007,225,92,133,42,18,24,26.09,0.261,0.187,0.135
218399,2007,295,152,143,40,14,26,17.11,0.171,0.136,0.098
218414,2007,323,122,201,88,41,47,38.52,0.385,0.272,0.204
218663,2007,3690,2117,1573,1999,734,1265,59.75,0.598,0.542,0.467
218724,2007,1647,886,761,443,143,300,33.86,0.339,0.269,0.188
218733,2007,1292,652,640,177,59,118,18.1,0.181,0.137,0.092
218742,2007,805,488,317,191,54,137,28.07,0.281,0.237,0.17
218973,2007,385,193,192,301,141,160,82.9,0.829,0.782,0.734
219000,2007,429,272,157,207,54,153,56.25,0.562,0.483,0.344
219046,2007,472,268,204,51,14,37,13.81,0.138,0.108,0.069
219082,2007,243,110,133,44,23,21,19.09,0.191,0.181,0.173
219198,2007,108,73,35,49,14,35,47.95,0.48,0.454,0.4
219259,2007,340,203,137,70,15,55,27.09,0.271,0.206,0.109
219356,2007,1933,950,983,495,183,312,32.84,0.328,0.256,0.186
219471,2007,1030,612,418,282,105,177,28.92,0.289,0.274,0.251
219602,2007,1188,683,505,178,55,123,18.01,0.18,0.15,0.109
219709,2007,799,453,346,449,187,262,57.84,0.578,0.562,0.54
219718,2007,255,115,140,27,13,14,12.17,0.122,0.106,0.093
219949,2007,210,75,135,43,22,21,28,0.28,0.205,0.163
220075,2007,1918,1063,855,330,110,220,20.7,0.207,0.172,0.129
220215,2007,385,222,163,148,58,90,40.54,0.405,0.384,0.356
220613,2007,783,437,346,271,88,183,41.88,0.419,0.346,0.254
220631,2007,230,159,71,23,19,4,2.52,0.025,0.1,0.268
220710,2007,317,158,159,148,49,99,62.66,0.627,0.467,0.308
221351,2007,452,252,200,335,148,187,74.21,0.742,0.741,0.74
221519,2007,401,235,166,303,115,188,80,0.8,0.756,0.693
221731,2007,153,86,67,49,19,30,34.88,0.349,0.32,0.284
221847,2007,1649,730,919,371,157,214,29.32,0.293,0.225,0.171
221892,2007,238,139,99,85,31,54,38.85,0.388,0.357,0.313
222178,2007,887,476,411,324,113,211,44.33,0.443,0.365,0.275
222983,2007,333,174,159,223,91,132,75.86,0.759,0.67,0.572
223232,2007,2721,1618,1103,1556,552,1004,62.05,0.62,0.572,0.5
224004,2007,160,87,73,29,9,20,22.99,0.23,0.181,0.123
224323,2007,362,200,162,201,85,116,58,0.58,0.555,0.525
225432,2007,831,438,393,22,7,15,3.42,0.034,0.026,0.018
225548,2007,255,103,152,77,31,46,44.66,0.447,0.302,0.204
225627,2007,715,463,252,138,41,97,20.95,0.21,0.193,0.163
226231,2007,322,97,225,108,71,37,38.14,0.381,0.335,0.316
226833,2007,735,384,351,118,43,75,19.53,0.195,0.161,0.123
227216,2007,3495,1996,1499,862,254,608,30.46,0.305,0.247,0.169
227331,2007,283,189,94,51,13,38,20.11,0.201,0.18,0.138
227526,2007,1391,784,607,155,36,119,15.18,0.152,0.111,0.059
227757,2007,742,346,396,585,288,297,85.84,0.858,0.788,0.727
227845,2007,725,437,288,372,127,245,56.06,0.561,0.513,0.441
227863,2007,288,179,109,77,25,52,29.05,0.291,0.267,0.229
228042,2007,262,135,127,92,36,56,41.48,0.415,0.351,0.283
228149,2007,565,334,231,187,54,133,39.82,0.398,0.331,0.234
228246,2007,1306,697,609,870,359,511,73.31,0.733,0.666,0.589
228343,2007,371,232,139,242,84,158,68.1,0.681,0.652,0.604
228431,2007,2268,1375,893,521,156,365,26.55,0.266,0.23,0.175
228459,2007,3237,1900,1337,983,288,695,36.58,0.366,0.304,0.215
228501,2007,242,92,150,34,6,28,30.43,0.304,0.14,0.04
228529,2007,1190,685,505,259,86,173,25.26,0.253,0.218,0.17
228705,2007,651,251,400,115,58,57,22.71,0.227,0.177,0.145
228723,2007,8025,4074,3951,3968,1491,2477,60.8,0.608,0.494,0.377
228769,2007,2096,1041,1055,354,130,224,21.52,0.215,0.169,0.123
228778,2007,7419,3973,3446,3776,1472,2304,57.99,0.58,0.509,0.427
228787,2007,1030,421,609,472,237,235,55.82,0.558,0.458,0.389
228796,2007,2017,1046,971,245,94,151,14.44,0.144,0.121,0.097
228875,2007,1642,965,677,961,348,613,63.52,0.635,0.585,0.514
228981,2007,365,177,188,114,39,75,42.37,0.424,0.312,0.207
229018,2007,372,198,174,48,15,33,16.67,0.167,0.129,0.086
229027,2007,4833,2309,2524,465,179,286,12.39,0.124,0.096,0.071
229115,2007,4439,2065,2374,1455,600,855,41.4,0.414,0.328,0.253
229780,2007,247,129,118,53,20,33,25.58,0.256,0.215,0.169
229814,2007,923,480,443,227,79,148,30.83,0.308,0.246,0.178
230603,2007,865,579,286,185,39,146,25.22,0.252,0.214,0.136
230728,2007,2654,1697,957,544,113,431,25.4,0.254,0.205,0.118
230764,2007,1953,1082,871,469,170,299,27.63,0.276,0.24,0.195
230782,2007,1364,783,581,110,27,83,10.6,0.106,0.081,0.046
231059,2007,524,280,244,364,154,210,75,0.75,0.695,0.631
231174,2007,2432,1346,1086,1577,650,927,68.87,0.689,0.648,0.599
231420,2007,238,70,168,43,23,20,28.57,0.286,0.181,0.137
231554,2007,89,49,40,34,10,24,48.98,0.49,0.382,0.25
231624,2007,1341,729,612,1114,474,640,87.79,0.878,0.831,0.775
231712,2007,1241,706,535,618,200,418,59.21,0.592,0.498,0.374
232025,2007,240,103,137,80,37,43,41.75,0.418,0.333,0.27
232043,2007,203,121,82,100,34,66,54.55,0.545,0.493,0.415
232089,2007,525,228,297,103,42,61,26.75,0.268,0.196,0.141
232186,2007,2174,1222,952,942,316,626,51.23,0.512,0.433,0.332
232265,2007,1179,757,422,585,163,422,55.75,0.557,0.496,0.386
232423,2007,3864,2401,1463,2520,829,1691,70.43,0.704,0.652,0.567
232557,2007,2715,1474,1241,715,278,437,29.65,0.296,0.263,0.224
232566,2007,984,650,334,412,107,305,46.92,0.469,0.419,0.32
232609,2007,598,324,274,274,95,179,55.25,0.552,0.458,0.347
232681,2007,951,649,302,626,175,451,69.49,0.695,0.658,0.579
232706,2007,396,288,108,176,35,141,48.96,0.49,0.444,0.324
232937,2007,938,571,367,179,46,133,23.29,0.233,0.191,0.125
232982,2007,2513,1327,1186,581,200,381,28.71,0.287,0.231,0.169
233277,2007,1840,1055,785,758,273,485,45.97,0.46,0.412,0.348
233374,2007,801,427,374,653,295,358,83.84,0.838,0.815,0.789
233426,2007,565,335,230,327,115,212,63.28,0.633,0.579,0.5
233541,2007,397,205,192,135,49,86,41.95,0.42,0.34,0.255
233897,2007,401,184,217,97,41,56,30.43,0.304,0.242,0.189
233921,2007,5112,2264,2848,3063,1430,1633,72.13,0.721,0.599,0.502
234030,2007,3802,2159,1643,1129,405,724,33.53,0.335,0.297,0.247
234085,2007,410,36,374,240,221,19,52.78,0.528,0.585,0.591
234155,2007,1185,796,389,259,58,201,25.25,0.252,0.219,0.149
234164,2007,375,209,166,81,17,64,30.62,0.306,0.216,0.102
235097,2007,1313,770,543,243,81,162,21.04,0.21,0.185,0.149
235167,2007,677,347,330,288,138,150,43.23,0.432,0.425,0.418
236230,2007,714,453,261,394,134,260,57.4,0.574,0.552,0.513
236328,2007,641,393,248,437,157,280,71.25,0.713,0.682,0.633
236577,2007,716,499,217,390,110,280,56.11,0.561,0.545,0.507
236595,2007,736,479,257,432,127,305,63.67,0.637,0.587,0.494
236896,2007,344,162,182,58,25,33,20.37,0.204,0.169,0.137
236939,2007,3184,1588,1596,1275,508,767,48.3,0.483,0.4,0.318
236948,2007,5163,2771,2392,2968,1213,1755,63.33,0.633,0.575,0.507
237011,2007,2572,1484,1088,970,324,646,43.53,0.435,0.377,0.298
237057,2007,400,239,161,319,124,195,81.59,0.816,0.797,0.77
237066,2007,532,293,239,347,141,206,70.31,0.703,0.652,0.59
237215,2007,296,167,129,18,11,7,4.19,0.042,0.061,0.085
237330,2007,618,335,283,115,49,66,19.7,0.197,0.186,0.173
237358,2007,120,70,50,21,9,12,17.14,0.171,0.175,0.18
237367,2007,632,331,301,87,37,50,15.11,0.151,0.138,0.123
237792,2007,691,366,325,124,48,76,20.77,0.208,0.179,0.148
237899,2007,364,170,194,14,5,9,5.29,0.053,0.038,0.026
237932,2007,499,264,235,110,27,83,31.44,0.314,0.22,0.115
237969,2007,401,203,198,174,71,103,50.74,0.507,0.434,0.359
238032,2007,4664,2156,2508,1561,696,865,40.12,0.401,0.335,0.278
238333,2007,325,183,142,229,99,130,71.04,0.71,0.705,0.697
238430,2007,173,115,58,25,6,19,16.52,0.165,0.145,0.103
238458,2007,652,440,212,277,88,189,42.95,0.43,0.425,0.415
238476,2007,683,350,333,371,145,226,64.57,0.646,0.543,0.435
238616,2007,422,232,190,143,46,97,41.81,0.418,0.339,0.242
238661,2007,302,202,100,98,28,70,34.65,0.346,0.325,0.28
239080,2007,266,191,75,80,8,72,37.7,0.377,0.301,0.107
239105,2007,1811,966,845,1038,442,596,61.7,0.617,0.573,0.523
239628,2007,262,124,138,158,78,80,64.52,0.645,0.603,0.565
239716,2007,542,328,214,372,130,242,73.78,0.738,0.686,0.607
240107,2007,361,252,109,108,26,82,32.54,0.325,0.299,0.239
240189,2007,2048,993,1055,564,258,306,30.82,0.308,0.275,0.245
240277,2007,987,644,343,201,42,159,24.69,0.247,0.204,0.122
240329,2007,1750,1084,666,621,196,425,39.21,0.392,0.355,0.294
240338,2007,181,97,84,82,34,48,49.48,0.495,0.453,0.405
240365,2007,1723,1018,705,300,96,204,20.04,0.2,0.174,0.136
240374,2007,833,418,415,75,38,37,8.85,0.088,0.09,0.092
240417,2007,1489,763,726,309,108,201,26.34,0.263,0.208,0.149
240426,2007,343,197,146,47,14,33,16.75,0.168,0.137,0.096
240444,2007,5980,3197,2783,3291,1332,1959,61.28,0.613,0.55,0.479
240453,2007,4465,2228,2237,585,259,326,14.63,0.146,0.131,0.116
240462,2007,1466,500,966,275,127,148,29.6,0.296,0.188,0.131
240471,2007,1276,743,533,297,103,194,26.11,0.261,0.233,0.193
240480,2007,1611,892,719,358,145,213,23.88,0.239,0.222,0.202
240727,2007,1614,831,783,389,132,257,30.93,0.309,0.241,0.169
243443,2007,690,422,268,41,10,31,7.35,0.074,0.059,0.037
243780,2007,6830,2882,3948,2702,1260,1442,50.03,0.5,0.396,0.319
100654,2008,1044,568,476,115,23,92,16.2,0.162,0.11,0.048
100663,2008,1246,710,536,406,140,266,37.46,0.375,0.326,0.261
100751,2008,5009,2776,2233,1942,703,1239,44.63,0.446,0.388,0.315
100858,2008,3967,2049,1918,1676,627,1049,51.2,0.512,0.422,0.327
101435,2008,253,106,147,76,28,48,45.28,0.453,0.3,0.19
101480,2008,1243,663,580,108,31,77,11.61,0.116,0.087,0.053
101675,2008,461,213,248,38,5,33,15.49,0.155,0.082,0.02
101879,2008,988,533,455,119,34,85,15.95,0.16,0.12,0.075
102049,2008,705,442,263,336,104,232,52.49,0.525,0.477,0.395
102094,2008,1543,875,668,230,68,162,18.51,0.185,0.149,0.102
102234,2008,344,213,131,175,62,113,53.05,0.53,0.509,0.473
102368,2008,1827,1081,746,246,76,170,15.73,0.157,0.135,0.102
102377,2008,722,414,308,154,44,110,26.57,0.266,0.213,0.143
104151,2008,6743,3320,3423,2886,1224,1662,50.06,0.501,0.428,0.358
104179,2008,6331,3377,2954,2536,1017,1519,44.98,0.45,0.401,0.344
105330,2008,3248,1899,1349,1078,316,762,40.13,0.401,0.332,0.234
106245,2008,618,375,243,50,23,27,7.2,0.072,0.081,0.095
106342,2008,102,52,50,50,25,25,48.08,0.481,0.49,0.5
106397,2008,2977,1488,1489,1108,475,633,42.54,0.425,0.372,0.319
106412,2008,952,504,448,93,21,72,14.29,0.143,0.098,0.047
106458,2008,1743,981,762,352,129,223,22.73,0.227,0.202,0.169
106467,2008,1450,763,687,305,115,190,24.9,0.249,0.21,0.167
106485,2008,661,361,300,89,33,56,15.51,0.155,0.135,0.11
106704,2008,2075,1165,910,444,157,287,24.64,0.246,0.214,0.173
107044,2008,980,537,443,425,158,267,49.72,0.497,0.434,0.357
107080,2008,430,238,192,284,122,162,68.07,0.681,0.66,0.635
107141,2008,307,165,142,160,72,88,53.33,0.533,0.521,0.507
107512,2008,404,220,184,205,80,125,56.82,0.568,0.507,0.435
107558,2008,195,113,82,72,27,45,39.82,0.398,0.369,0.329
110097,2008,846,530,316,430,157,273,51.51,0.515,0.508,0.497
110404,2008,236,97,139,200,112,88,90.72,0.907,0.847,0.806
110422,2008,3448,1553,1895,1246,458,788,50.74,0.507,0.361,0.242
110486,2008,901,592,309,144,45,99,16.72,0.167,0.16,0.146
110495,2008,899,576,323,133,33,100,17.36,0.174,0.148,0.102
110510,2008,1916,1213,703,241,77,164,13.52,0.135,0.126,0.11
110529,2008,2538,1068,1470,299,135,164,15.36,0.154,0.118,0.092
110538,2008,2727,1420,1307,537,163,374,26.34,0.263,0.197,0.125
110547,2008,889,599,290,42,14,28,4.67,0.047,0.047,0.048
110556,2008,2731,1604,1127,402,121,281,17.52,0.175,0.147,0.107
110565,2008,4519,2673,1846,630,180,450,16.84,0.168,0.139,0.098
110574,2008,1356,828,528,141,45,96,11.59,0.116,0.104,0.085
110583,2008,4536,2856,1680,676,183,493,17.26,0.173,0.149,0.109
110592,2008,1676,1014,662,105,40,65,6.41,0.064,0.063,0.06
110617,2008,2536,1493,1043,191,50,141,9.44,0.094,0.075,0.048
113698,2008,267,202,65,146,31,115,56.93,0.569,0.547,0.477
115755,2008,1168,661,507,147,37,110,16.64,0.166,0.126,0.073
119173,2008,313,302,11,84,2,82,27.15,0.272,0.268,0.182
120184,2008,147,85,62,63,21,42,49.41,0.494,0.429,0.339
121309,2008,538,327,211,318,116,202,61.77,0.618,0.591,0.55
121345,2008,382,194,188,344,168,176,90.72,0.907,0.901,0.894
122409,2008,3578,2086,1492,1053,346,707,33.89,0.339,0.294,0.232
122436,2008,1259,771,488,838,289,549,71.21,0.712,0.666,0.592
122597,2008,3512,2334,1178,524,145,379,16.24,0.162,0.149,0.123
122612,2008,1036,686,350,632,196,436,63.56,0.636,0.61,0.56
122931,2008,1220,623,597,951,436,515,82.66,0.827,0.78,0.73
123554,2008,665,436,229,349,100,249,57.11,0.571,0.525,0.437
123572,2008,1631,1058,573,444,96,348,32.89,0.329,0.272,0.168
126562,2008,1036,603,433,156,68,88,14.59,0.146,0.151,0.157
126580,2008,1075,577,498,288,110,178,30.85,0.308,0.268,0.221
126614,2008,5811,2890,2921,2678,1158,1520,52.6,0.526,0.461,0.396
126818,2008,4386,2435,1951,1693,567,1126,46.24,0.462,0.386,0.291
127060,2008,1131,633,498,743,317,426,67.3,0.673,0.657,0.637
127185,2008,758,355,403,136,62,74,20.85,0.209,0.179,0.154
127565,2008,1918,969,949,88,33,55,5.68,0.057,0.046,0.035
127741,2008,2071,1227,844,558,156,402,32.76,0.328,0.269,0.185
128106,2008,1002,465,537,160,65,95,20.43,0.204,0.16,0.121
128744,2008,444,266,178,90,30,60,22.56,0.226,0.203,0.169
128771,2008,1297,578,719,279,133,146,25.26,0.253,0.215,0.185
129020,2008,3587,1780,1807,2382,1098,1284,72.13,0.721,0.664,0.608
129242,2008,898,537,361,688,257,431,80.26,0.803,0.766,0.712
129941,2008,1129,569,560,430,175,255,44.82,0.448,0.381,0.312
130253,2008,981,577,404,583,201,382,66.2,0.662,0.594,0.498
130314,2008,225,225,0,92,0,92,40.89,0.409,0.409,NA
130493,2008,1288,858,430,293,77,216,25.17,0.252,0.227,0.179
130590,2008,589,300,289,464,214,250,83.33,0.833,0.788,0.74
130697,2008,715,355,360,622,300,322,90.7,0.907,0.87,0.833
130776,2008,928,462,466,180,82,98,21.21,0.212,0.194,0.176
130794,2008,1316,664,652,1150,543,607,91.42,0.914,0.874,0.833
130934,2008,721,455,266,154,36,118,25.93,0.259,0.214,0.135
130943,2008,3834,2211,1623,2378,891,1487,67.25,0.672,0.62,0.549
131159,2008,1570,967,603,1199,442,757,78.28,0.783,0.764,0.733
131283,2008,901,475,426,537,234,303,63.79,0.638,0.596,0.549
131450,2008,179,97,82,29,9,20,20.62,0.206,0.162,0.11
131469,2008,2449,1408,1041,1755,687,1068,75.85,0.758,0.717,0.66
131496,2008,1571,822,749,1430,665,765,93.07,0.931,0.91,0.888
131520,2008,1477,1004,473,629,133,496,49.4,0.494,0.426,0.281
132471,2008,584,400,184,120,34,86,21.5,0.215,0.205,0.185
132602,2008,719,478,241,198,38,160,33.47,0.335,0.275,0.158
132903,2008,6139,3283,2856,2464,867,1597,48.64,0.486,0.401,0.304
133492,2008,487,285,202,283,116,167,58.6,0.586,0.581,0.574
133553,2008,1058,158,900,325,263,62,39.24,0.392,0.307,0.292
133650,2008,2090,1196,894,254,79,175,14.63,0.146,0.122,0.088
133669,2008,2677,1407,1270,457,149,308,21.89,0.219,0.171,0.117
133711,2008,645,365,280,312,116,196,53.7,0.537,0.484,0.414
133881,2008,635,194,441,247,152,95,48.97,0.49,0.389,0.345
133951,2008,3106,1642,1464,732,234,498,30.33,0.303,0.236,0.16
134079,2008,497,304,193,277,102,175,57.57,0.576,0.557,0.528
134097,2008,4993,2928,2065,3066,1093,1973,67.38,0.674,0.614,0.529
134130,2008,6382,3787,2595,4289,1442,2847,75.18,0.752,0.672,0.556
134945,2008,539,249,290,151,67,84,33.73,0.337,0.28,0.231
135726,2008,1983,987,996,1358,647,711,72.04,0.72,0.685,0.65
136172,2008,1694,1013,681,444,115,329,32.48,0.325,0.262,0.169
136950,2008,464,262,202,293,118,175,66.79,0.668,0.631,0.584
137546,2008,617,360,257,344,133,211,58.61,0.586,0.558,0.518
138354,2008,1030,605,425,277,94,183,30.25,0.302,0.269,0.221
138716,2008,626,392,234,65,9,56,14.29,0.143,0.104,0.038
138789,2008,864,511,353,87,23,64,12.52,0.125,0.101,0.065
139144,2008,448,311,137,243,70,173,55.63,0.556,0.542,0.511
139366,2008,1114,642,472,131,38,93,14.49,0.145,0.118,0.081
139393,2008,267,149,118,129,51,78,52.35,0.524,0.483,0.432
139658,2008,1661,893,768,1064,501,563,63.05,0.63,0.641,0.652
139719,2008,1074,568,506,117,32,85,14.96,0.15,0.109,0.063
139755,2008,2633,838,1795,974,604,370,44.15,0.442,0.37,0.336
139764,2008,418,240,178,42,16,26,10.83,0.108,0.1,0.09
139861,2008,1177,751,426,470,136,334,44.47,0.445,0.399,0.319
139931,2008,3106,1453,1653,828,300,528,36.34,0.363,0.267,0.181
139940,2008,2743,1609,1134,614,206,408,25.36,0.254,0.224,0.182
139959,2008,4778,3013,1765,2853,924,1929,64.02,0.64,0.597,0.524
140447,2008,615,365,250,298,94,204,55.89,0.559,0.485,0.376
140960,2008,905,490,415,71,22,49,10,0.1,0.078,0.053
140988,2008,330,163,167,117,46,71,43.56,0.436,0.355,0.275
141185,2008,155,93,62,63,20,43,46.24,0.462,0.406,0.323
141264,2008,2106,1223,883,344,93,251,20.52,0.205,0.163,0.105
141334,2008,2008,1216,792,321,88,233,19.16,0.192,0.16,0.111
141486,2008,236,161,75,69,18,51,31.68,0.317,0.292,0.24
141565,2008,536,326,210,61,16,45,13.8,0.138,0.114,0.076
141574,2008,1808,1027,781,358,114,244,23.76,0.238,0.198,0.146
142276,2008,1031,525,506,94,35,59,11.24,0.112,0.091,0.069
142285,2008,1663,777,886,460,202,258,33.2,0.332,0.277,0.228
142461,2008,301,169,132,96,34,62,36.69,0.367,0.319,0.258
143084,2008,640,369,271,454,179,275,74.53,0.745,0.709,0.661
143288,2008,171,94,77,52,18,34,36.17,0.362,0.304,0.234
144005,2008,402,279,123,10,4,6,2.15,0.021,0.025,0.033
144281,2008,2329,1289,1040,690,277,413,32.04,0.32,0.296,0.266
144740,2008,2553,1502,1051,1430,537,893,59.45,0.595,0.56,0.511
144892,2008,1764,1029,735,582,196,386,37.51,0.375,0.33,0.267
144962,2008,576,348,228,350,113,237,68.1,0.681,0.608,0.496
144971,2008,153,75,78,53,18,35,46.67,0.467,0.346,0.231
145600,2008,2944,1659,1285,981,392,589,35.5,0.355,0.333,0.305
145619,2008,434,227,207,141,57,84,37,0.37,0.325,0.275
145637,2008,7277,3386,3891,5015,2439,2576,76.08,0.761,0.689,0.627
145691,2008,166,84,82,110,51,59,70.24,0.702,0.663,0.622
145813,2008,3387,2088,1299,1545,503,1042,49.9,0.499,0.456,0.387
146481,2008,378,218,160,242,85,157,72.02,0.72,0.64,0.531
146612,2008,650,345,305,272,127,145,42.03,0.42,0.418,0.416
146719,2008,2176,1460,716,1419,448,971,66.51,0.665,0.652,0.626
146825,2008,90,36,54,21,8,13,36.11,0.361,0.233,0.148
147013,2008,308,145,163,110,40,70,48.28,0.483,0.357,0.245
147244,2008,484,298,186,247,83,164,55.03,0.55,0.51,0.446
147341,2008,383,179,204,182,84,98,54.75,0.547,0.475,0.412
147703,2008,2844,1469,1375,718,315,403,27.43,0.274,0.252,0.229
147767,2008,2077,1075,1002,1773,822,951,88.47,0.885,0.854,0.82
147776,2008,952,519,433,48,18,30,5.78,0.058,0.05,0.042
147828,2008,590,357,233,260,76,184,51.54,0.515,0.441,0.326
148131,2008,245,108,137,81,31,50,46.3,0.463,0.331,0.226
148496,2008,416,291,125,198,59,139,47.77,0.478,0.476,0.472
148584,2008,203,125,78,77,27,50,40,0.4,0.379,0.346
148627,2008,547,375,172,176,55,121,32.27,0.323,0.322,0.32
149222,2008,2592,1183,1409,627,305,322,27.22,0.272,0.242,0.216
149231,2008,1901,1101,800,545,194,351,31.88,0.319,0.287,0.242
149772,2008,1806,881,925,536,278,258,29.28,0.293,0.297,0.301
149781,2008,580,291,289,462,219,243,83.51,0.835,0.797,0.758
150066,2008,540,316,224,259,97,162,51.27,0.513,0.48,0.433
150136,2008,3983,2188,1795,1384,504,880,40.22,0.402,0.347,0.281
150145,2008,242,149,93,132,45,87,58.39,0.584,0.545,0.484
150163,2008,934,566,368,580,209,371,65.55,0.655,0.621,0.568
150400,2008,600,341,259,448,172,276,80.94,0.809,0.747,0.664
150534,2008,616,377,239,325,116,209,55.44,0.554,0.528,0.485
150668,2008,172,97,75,95,36,59,60.82,0.608,0.552,0.48
150941,2008,275,161,114,133,51,82,50.93,0.509,0.484,0.447
151102,2008,1905,1009,896,118,36,82,8.13,0.081,0.062,0.04
151111,2008,2802,1657,1145,463,170,293,17.68,0.177,0.165,0.148
151306,2008,2055,1232,823,340,83,257,20.86,0.209,0.165,0.101
151324,2008,1907,954,953,357,151,206,21.59,0.216,0.187,0.158
151333,2008,341,212,129,31,6,25,11.79,0.118,0.091,0.047
151342,2008,943,590,353,54,23,31,5.25,0.052,0.057,0.065
151351,2008,7550,3990,3560,4485,1959,2526,63.31,0.633,0.594,0.55
151360,2008,596,387,209,47,13,34,8.79,0.088,0.079,0.062
151379,2008,970,590,380,81,26,55,9.32,0.093,0.084,0.068
151388,2008,291,190,101,26,8,18,9.47,0.095,0.089,0.079
151777,2008,396,202,194,190,77,113,55.94,0.559,0.48,0.397
151786,2008,326,158,168,111,50,61,38.61,0.386,0.34,0.298
152080,2008,1991,951,1040,1806,932,874,91.9,0.919,0.907,0.896
152248,2008,1213,624,589,108,50,58,9.29,0.093,0.089,0.085
152363,2008,296,144,152,118,51,67,46.53,0.465,0.399,0.336
152530,2008,465,266,199,312,115,197,74.06,0.741,0.671,0.578
152600,2008,655,336,319,390,169,221,65.77,0.658,0.595,0.53
153001,2008,273,117,156,96,46,50,42.74,0.427,0.352,0.295
153108,2008,404,204,200,255,101,154,75.49,0.755,0.631,0.505
153269,2008,901,544,357,507,199,308,56.62,0.566,0.563,0.557
153384,2008,462,251,211,392,171,221,88.05,0.88,0.848,0.81
153603,2008,4528,2074,2454,1787,772,1015,48.94,0.489,0.395,0.315
153834,2008,630,371,259,469,194,275,74.12,0.741,0.744,0.749
154095,2008,1972,1206,766,747,254,493,40.88,0.409,0.379,0.332
155089,2008,169,100,69,20,2,18,18,0.18,0.118,0.029
155317,2008,4435,2260,2175,1649,670,979,43.32,0.433,0.372,0.308
155335,2008,115,74,41,36,10,26,35.14,0.351,0.313,0.244
155399,2008,3518,1780,1738,960,339,621,34.89,0.349,0.273,0.195
155520,2008,208,114,94,69,25,44,38.6,0.386,0.332,0.266
155627,2008,201,100,101,40,17,23,23,0.23,0.199,0.168
155937,2008,150,71,79,44,15,29,40.85,0.409,0.293,0.19
156213,2008,313,208,105,173,57,116,55.77,0.558,0.553,0.543
156286,2008,567,356,211,301,109,192,53.93,0.539,0.531,0.517
156295,2008,413,241,172,184,72,112,46.47,0.465,0.446,0.419
156365,2008,442,192,250,112,56,56,29.17,0.292,0.253,0.224
156541,2008,478,223,255,120,38,82,36.77,0.368,0.251,0.149
156745,2008,379,209,170,169,61,108,51.67,0.517,0.446,0.359
157058,2008,566,293,273,32,7,25,8.53,0.085,0.057,0.026
157076,2008,219,103,116,81,44,37,35.92,0.359,0.37,0.379
157085,2008,4074,2086,1988,1323,513,810,38.83,0.388,0.325,0.258
157289,2008,2548,1344,1204,915,391,524,38.99,0.39,0.359,0.325
157386,2008,1313,777,536,235,78,157,20.21,0.202,0.179,0.146
157401,2008,1452,875,577,415,120,295,33.71,0.337,0.286,0.208
157447,2008,2001,1117,884,252,77,175,15.67,0.157,0.126,0.087
157535,2008,177,83,94,41,13,28,33.73,0.337,0.232,0.138
157951,2008,3203,1821,1382,684,247,437,24,0.24,0.214,0.179
158477,2008,246,148,98,104,41,63,42.57,0.426,0.423,0.418
159009,2008,1203,626,577,144,53,91,14.54,0.145,0.12,0.092
159391,2008,5131,2781,2350,1900,699,1201,43.19,0.432,0.37,0.297
159647,2008,1503,695,808,428,187,241,34.68,0.347,0.285,0.231
159717,2008,1272,742,530,203,62,141,19,0.19,0.16,0.117
159966,2008,1217,712,505,207,60,147,20.65,0.206,0.17,0.119
160038,2008,1183,736,447,225,69,156,21.2,0.212,0.19,0.154
160612,2008,2613,1538,1075,358,112,246,15.99,0.16,0.137,0.104
160621,2008,1034,605,429,62,19,43,7.11,0.071,0.06,0.044
160658,2008,2566,1435,1131,373,128,245,17.07,0.171,0.145,0.113
161004,2008,488,232,256,420,203,217,93.53,0.935,0.861,0.793
161226,2008,512,335,177,184,47,137,40.9,0.409,0.359,0.266
161235,2008,111,60,51,27,14,13,21.67,0.217,0.243,0.275
161244,2008,105,62,43,23,8,15,24.19,0.242,0.219,0.186
161253,2008,1931,947,984,717,320,397,41.92,0.419,0.371,0.325
161554,2008,991,531,460,126,53,73,13.75,0.138,0.127,0.115
162007,2008,664,393,271,52,12,40,10.18,0.102,0.078,0.044
162210,2008,98,61,37,16,4,12,19.67,0.197,0.163,0.108
162283,2008,570,428,142,28,6,22,5.14,0.051,0.049,0.042
162584,2008,1030,478,552,201,86,115,24.06,0.241,0.195,0.156
162654,2008,360,262,98,205,54,151,57.63,0.576,0.569,0.551
162760,2008,308,200,108,179,57,122,61,0.61,0.581,0.528
162928,2008,1315,612,703,1140,587,553,90.36,0.904,0.867,0.835
163046,2008,1066,637,429,825,307,518,81.32,0.813,0.774,0.716
163268,2008,1555,650,905,531,237,294,45.23,0.452,0.341,0.262
163286,2008,3907,1824,2083,2610,1298,1312,71.93,0.719,0.668,0.623
163453,2008,1430,808,622,169,46,123,15.22,0.152,0.118,0.074
163462,2008,410,218,192,236,99,137,62.84,0.628,0.576,0.516
163851,2008,1198,694,504,533,151,382,55.04,0.55,0.445,0.3
163912,2008,458,279,179,332,119,213,76.34,0.763,0.725,0.665
164076,2008,2825,1786,1039,1210,385,825,46.19,0.462,0.428,0.371
164173,2008,626,436,190,301,81,220,50.46,0.505,0.481,0.426
164216,2008,415,248,167,291,108,183,73.79,0.738,0.701,0.647
164270,2008,426,223,203,263,117,146,65.47,0.655,0.617,0.576
164447,2008,371,185,186,102,46,56,30.27,0.303,0.275,0.247
164492,2008,245,135,110,81,38,43,31.85,0.318,0.331,0.345
164562,2008,606,357,249,402,151,251,70.31,0.703,0.663,0.606
165015,2008,754,426,328,643,274,369,86.62,0.866,0.853,0.835
165024,2008,1464,915,549,412,134,278,30.38,0.304,0.281,0.244
165334,2008,586,348,238,424,162,262,75.29,0.753,0.724,0.681
165662,2008,772,466,306,598,243,355,76.18,0.762,0.775,0.794
165671,2008,480,346,134,268,73,195,56.36,0.564,0.558,0.545
165820,2008,763,421,342,227,76,151,35.87,0.359,0.298,0.222
165866,2008,644,450,194,213,49,164,36.44,0.364,0.331,0.253
165936,2008,419,260,159,256,91,165,63.46,0.635,0.611,0.572
166027,2008,1656,836,820,1420,677,743,88.88,0.889,0.857,0.826
166124,2008,737,420,317,664,285,379,90.24,0.902,0.901,0.899
166513,2008,1514,540,974,411,213,198,36.67,0.367,0.271,0.219
166629,2008,4256,2200,2056,2594,1140,1454,66.09,0.661,0.609,0.554
166638,2008,972,570,402,154,60,94,16.49,0.165,0.158,0.149
166683,2008,1046,487,559,849,441,408,83.78,0.838,0.812,0.789
167288,2008,325,193,132,109,38,71,36.79,0.368,0.335,0.288
167987,2008,1768,837,931,485,210,275,32.86,0.329,0.274,0.226
167996,2008,634,384,250,503,185,318,82.81,0.828,0.793,0.74
168005,2008,1557,920,637,607,215,392,42.61,0.426,0.39,0.338
168148,2008,1298,702,596,1141,511,630,89.74,0.897,0.879,0.857
168254,2008,735,281,454,370,206,164,58.36,0.584,0.503,0.454
168281,2008,420,259,161,313,116,197,76.06,0.761,0.745,0.72
168342,2008,538,284,254,476,222,254,89.44,0.894,0.885,0.874
168546,2008,485,242,243,297,137,160,66.12,0.661,0.612,0.564
168786,2008,456,283,173,138,43,95,33.57,0.336,0.303,0.249
169080,2008,935,500,435,539,235,304,60.8,0.608,0.576,0.54
169798,2008,2167,1283,884,269,84,185,14.42,0.144,0.124,0.095
169910,2008,2103,992,1111,169,75,94,9.48,0.095,0.08,0.068
170082,2008,3879,2413,1466,1216,403,813,33.69,0.337,0.313,0.275
170301,2008,805,499,306,565,189,376,75.35,0.753,0.702,0.618
170532,2008,364,200,164,279,128,151,75.5,0.755,0.766,0.78
170639,2008,490,250,240,72,32,40,16,0.16,0.147,0.133
170976,2008,5738,2905,2833,4336,1989,2347,80.79,0.808,0.756,0.702
171100,2008,7385,4098,3287,3831,1442,2389,58.3,0.583,0.519,0.439
171128,2008,1361,318,1043,333,218,115,36.16,0.362,0.245,0.209
171137,2008,905,436,469,145,60,85,19.5,0.195,0.16,0.128
171146,2008,846,512,334,78,31,47,9.18,0.092,0.092,0.093
171599,2008,282,99,183,76,34,42,42.42,0.424,0.27,0.186
172051,2008,1647,949,698,144,50,94,9.91,0.099,0.087,0.072
172699,2008,3803,1934,1869,880,381,499,25.8,0.258,0.231,0.204
173160,2008,632,377,255,408,155,253,67.11,0.671,0.646,0.608
173258,2008,488,244,244,444,220,224,91.8,0.918,0.91,0.902
173328,2008,211,116,95,60,25,35,30.17,0.302,0.284,0.263
173647,2008,616,346,270,495,211,284,82.08,0.821,0.804,0.781
173902,2008,478,279,199,401,161,240,86.02,0.86,0.839,0.809
174066,2008,5089,2813,2276,2975,1224,1751,62.25,0.623,0.585,0.538
174233,2008,2213,1110,1103,760,306,454,40.9,0.409,0.343,0.277
174251,2008,373,209,164,200,80,120,57.42,0.574,0.536,0.488
174491,2008,455,273,182,202,62,140,51.28,0.513,0.444,0.341
174792,2008,461,0,461,332,332,0,NA,NA,0.72,0.72
174844,2008,813,454,359,698,292,406,89.43,0.894,0.859,0.813
174899,2008,575,381,194,314,93,221,58.01,0.58,0.546,0.479
174914,2008,1321,638,683,792,374,418,65.52,0.655,0.6,0.548
175342,2008,451,261,190,87,36,51,19.54,0.195,0.193,0.189
175421,2008,239,146,93,79,27,52,35.62,0.356,0.331,0.29
175616,2008,384,227,157,58,19,39,17.18,0.172,0.151,0.121
175856,2008,938,547,391,177,48,129,23.58,0.236,0.189,0.123
175980,2008,266,141,125,165,66,99,70.21,0.702,0.62,0.528
176017,2008,2316,1272,1044,857,301,556,43.71,0.437,0.37,0.288
176035,2008,252,212,40,54,7,47,22.17,0.222,0.214,0.175
176044,2008,446,203,243,57,23,34,16.75,0.168,0.128,0.095
176080,2008,2474,1278,1196,746,282,464,36.31,0.363,0.302,0.236
176406,2008,237,158,79,68,19,49,31.01,0.31,0.287,0.241
176628,2008,183,105,78,45,9,36,34.29,0.343,0.246,0.115
176947,2008,300,141,159,110,47,63,44.68,0.447,0.367,0.296
176965,2008,1583,854,729,463,185,278,32.55,0.325,0.292,0.254
177418,2008,187,112,75,44,12,32,28.57,0.286,0.235,0.16
178059,2008,318,236,82,149,39,110,46.61,0.466,0.469,0.476
178341,2008,727,398,329,106,34,72,18.09,0.181,0.146,0.103
178387,2008,956,536,420,146,44,102,19.03,0.19,0.153,0.105
178396,2008,5698,3031,2667,2622,1004,1618,53.38,0.534,0.46,0.376
178402,2008,971,589,382,218,68,150,25.47,0.255,0.225,0.178
178411,2008,1036,234,802,253,181,72,30.77,0.308,0.244,0.226
178420,2008,437,244,193,92,34,58,23.77,0.238,0.211,0.176
178615,2008,1334,779,555,757,251,506,64.96,0.65,0.567,0.452
179043,2008,358,237,121,223,69,154,64.98,0.65,0.623,0.57
179159,2008,1624,923,701,945,365,580,62.84,0.628,0.582,0.521
179557,2008,1672,1054,618,492,141,351,33.3,0.333,0.294,0.228
179566,2008,2532,1464,1068,785,258,527,36,0.36,0.31,0.242
179867,2008,1408,711,697,1270,605,665,93.53,0.935,0.902,0.868
179894,2008,407,250,157,173,58,115,46,0.46,0.425,0.369
179946,2008,244,108,136,123,67,56,51.85,0.519,0.504,0.493
180179,2008,692,402,290,47,14,33,8.21,0.082,0.068,0.048
180461,2008,1805,765,1040,354,154,200,26.14,0.261,0.196,0.148
180522,2008,199,70,129,14,5,9,12.86,0.129,0.07,0.039
180984,2008,273,129,144,125,57,68,52.71,0.527,0.458,0.396
181002,2008,984,582,402,647,257,390,67.01,0.67,0.658,0.639
181020,2008,247,105,142,135,62,73,69.52,0.695,0.547,0.437
181127,2008,320,151,169,153,63,90,59.6,0.596,0.478,0.373
181215,2008,1019,530,489,232,87,145,27.36,0.274,0.228,0.178
181394,2008,1755,920,835,286,107,179,19.46,0.195,0.163,0.128
181446,2008,383,212,171,211,76,135,63.68,0.637,0.551,0.444
181464,2008,4164,2015,2149,1377,566,811,40.25,0.402,0.331,0.263
181534,2008,210,101,109,23,10,13,12.87,0.129,0.11,0.092
181783,2008,653,345,308,148,52,96,27.83,0.278,0.227,0.169
182281,2008,3020,1709,1311,422,142,280,16.38,0.164,0.14,0.108
182290,2008,2260,1211,1049,467,179,288,23.78,0.238,0.207,0.171
182634,2008,376,251,125,138,44,94,37.45,0.375,0.367,0.352
182795,2008,474,205,269,185,89,96,46.83,0.468,0.39,0.331
183062,2008,1287,777,510,667,238,429,55.21,0.552,0.518,0.467
183080,2008,1087,500,587,476,214,262,52.4,0.524,0.438,0.365
183239,2008,500,286,214,351,143,208,72.73,0.727,0.702,0.668
183822,2008,392,237,155,23,10,13,5.49,0.055,0.059,0.065
183974,2008,310,196,114,188,63,125,63.78,0.638,0.606,0.553
184348,2008,390,256,134,222,75,147,57.42,0.574,0.569,0.56
184603,2008,461,276,185,126,39,87,31.52,0.315,0.273,0.211
184612,2008,245,170,75,42,9,33,19.41,0.194,0.171,0.12
184782,2008,1174,516,658,502,269,233,45.16,0.452,0.428,0.409
185129,2008,563,306,257,42,19,23,7.52,0.075,0.075,0.074
185572,2008,960,549,411,473,187,286,52.09,0.521,0.493,0.455
185590,2008,2257,1365,892,817,230,587,43,0.43,0.362,0.258
185828,2008,779,158,621,185,136,49,31.01,0.31,0.237,0.219
186131,2008,1243,620,623,1121,545,576,92.9,0.929,0.902,0.875
186201,2008,877,513,364,511,177,334,65.11,0.651,0.583,0.486
186283,2008,875,516,359,460,167,293,56.78,0.568,0.526,0.465
186584,2008,1216,688,528,687,282,405,58.87,0.589,0.565,0.534
186876,2008,840,458,382,425,156,269,58.73,0.587,0.506,0.408
187134,2008,1295,763,532,939,356,583,76.41,0.764,0.725,0.669
187444,2008,1204,617,587,215,75,140,22.69,0.227,0.179,0.128
187985,2008,3148,1737,1411,459,161,298,17.16,0.172,0.146,0.114
188030,2008,2171,1175,996,337,130,207,17.62,0.176,0.155,0.131
188429,2008,944,614,330,510,146,364,59.28,0.593,0.54,0.442
188641,2008,502,219,283,193,99,94,42.92,0.429,0.384,0.35
190044,2008,734,204,530,407,274,133,65.2,0.652,0.554,0.517
190099,2008,737,386,351,661,307,354,91.71,0.917,0.897,0.875
190150,2008,1374,653,721,1208,613,595,91.12,0.911,0.879,0.85
190248,2008,104,58,46,40,12,28,48.28,0.483,0.385,0.261
190415,2008,3132,1573,1559,2718,1307,1411,89.7,0.897,0.868,0.838
190512,2008,1497,693,804,530,250,280,40.4,0.404,0.354,0.311
190549,2008,1330,792,538,319,107,212,26.77,0.268,0.24,0.199
190558,2008,2282,1209,1073,112,47,65,5.38,0.054,0.049,0.044
190567,2008,1744,919,825,182,67,115,12.51,0.125,0.104,0.081
190594,2008,1988,1273,715,445,108,337,26.47,0.265,0.224,0.151
190637,2008,987,654,333,139,40,99,15.14,0.151,0.141,0.12
190664,2008,1642,961,681,445,125,320,33.3,0.333,0.271,0.184
190691,2008,1024,673,351,80,26,54,8.02,0.08,0.078,0.074
190725,2008,405,309,96,110,24,86,27.83,0.278,0.272,0.25
191241,2008,1852,991,861,1385,629,756,76.29,0.763,0.748,0.731
191515,2008,461,257,204,396,164,232,90.27,0.903,0.859,0.804
191533,2008,444,250,194,224,91,133,53.2,0.532,0.505,0.469
191630,2008,544,288,256,404,179,225,78.12,0.781,0.743,0.699
191649,2008,1637,864,773,816,344,472,54.63,0.546,0.498,0.445
191676,2008,327,211,116,193,56,137,64.93,0.649,0.59,0.483
191931,2008,921,498,423,469,167,302,60.64,0.606,0.509,0.395
191968,2008,1441,862,579,1017,397,620,71.93,0.719,0.706,0.686
192192,2008,270,200,70,98,21,77,38.5,0.385,0.363,0.3
192323,2008,541,335,206,331,114,217,64.78,0.648,0.612,0.553
192439,2008,992,706,286,73,18,55,7.79,0.078,0.074,0.063
192703,2008,726,351,375,475,226,249,70.94,0.709,0.654,0.603
192749,2008,476,326,150,270,82,188,57.67,0.577,0.567,0.547
192819,2008,1018,611,407,697,249,448,73.32,0.733,0.685,0.612
192925,2008,408,253,155,105,49,56,22.13,0.221,0.257,0.316
193016,2008,677,441,236,92,14,78,17.69,0.177,0.136,0.059
193292,2008,393,288,105,156,32,124,43.06,0.431,0.397,0.305
193353,2008,432,318,114,191,50,141,44.34,0.443,0.442,0.439
193399,2008,374,267,107,146,34,112,41.95,0.42,0.39,0.318
193584,2008,471,361,110,306,62,244,67.59,0.676,0.65,0.564
193645,2008,504,461,43,86,2,84,18.22,0.182,0.171,0.047
193654,2008,1058,746,312,482,113,369,49.46,0.495,0.456,0.362
193900,2008,4786,2738,2048,2740,1134,1606,58.66,0.587,0.573,0.554
193973,2008,738,454,284,435,146,289,63.66,0.637,0.589,0.514
194161,2008,253,140,113,61,22,39,27.86,0.279,0.241,0.195
194310,2008,1616,1002,614,589,208,381,38.02,0.38,0.364,0.339
194824,2008,1355,380,975,833,599,234,61.58,0.616,0.615,0.614
195003,2008,2594,848,1746,706,357,349,41.16,0.412,0.272,0.204
195030,2008,1282,642,640,936,442,494,76.95,0.77,0.73,0.691
195164,2008,563,315,248,310,113,197,62.54,0.625,0.551,0.456
195173,2008,566,292,274,160,68,92,31.51,0.315,0.283,0.248
195216,2008,616,334,282,490,220,270,80.84,0.808,0.795,0.78
195234,2008,574,415,159,312,72,240,57.83,0.578,0.544,0.453
195243,2008,352,213,139,140,44,96,45.07,0.451,0.398,0.317
195304,2008,348,273,75,246,57,189,69.23,0.692,0.707,0.76
195474,2008,824,444,380,613,272,341,76.8,0.768,0.744,0.716
195526,2008,652,400,252,552,212,340,85,0.85,0.847,0.841
195544,2008,613,420,193,326,84,242,57.62,0.576,0.532,0.435
195809,2008,3258,1737,1521,1294,521,773,44.5,0.445,0.397,0.343
196413,2008,3161,1853,1308,2173,846,1327,71.61,0.716,0.687,0.647
196592,2008,790,486,304,69,27,42,8.64,0.086,0.087,0.089
197045,2008,568,254,314,171,82,89,35.04,0.35,0.301,0.261
197133,2008,638,365,273,560,235,325,89.04,0.89,0.878,0.861
197869,2008,2768,1415,1353,1221,462,759,53.64,0.536,0.441,0.341
197984,2008,286,134,152,93,39,54,40.3,0.403,0.325,0.257
198385,2008,480,250,230,436,209,227,90.8,0.908,0.908,0.909
198464,2008,4515,2608,1907,1468,483,985,37.77,0.378,0.325,0.253
198507,2008,636,368,268,95,25,70,19.02,0.19,0.149,0.093
198516,2008,1290,777,513,977,358,619,79.67,0.797,0.757,0.698
198835,2008,345,217,128,140,32,108,49.77,0.498,0.406,0.25
198969,2008,439,148,291,64,26,38,25.68,0.257,0.146,0.089
199102,2008,1592,848,744,342,105,237,27.95,0.28,0.215,0.141
199111,2008,586,361,225,225,77,148,41,0.41,0.384,0.342
199120,2008,3852,2270,1582,3096,1188,1908,84.05,0.841,0.804,0.751
199139,2008,3059,1610,1449,766,289,477,29.63,0.296,0.25,0.199
199148,2008,2471,1703,768,759,183,576,33.82,0.338,0.307,0.238
199157,2008,1026,683,343,224,56,168,24.6,0.246,0.218,0.163
199193,2008,4792,2184,2608,2029,863,1166,53.39,0.534,0.423,0.331
199218,2008,2069,1229,840,1017,326,691,56.22,0.562,0.492,0.388
199281,2008,1054,563,491,157,50,107,19.01,0.19,0.149,0.102
199306,2008,192,91,101,48,15,33,36.26,0.363,0.25,0.149
199412,2008,307,214,93,164,49,115,53.74,0.537,0.534,0.527
199582,2008,484,233,251,87,33,54,23.18,0.232,0.18,0.131
199643,2008,532,308,224,64,21,43,13.96,0.14,0.12,0.094
199847,2008,1197,621,576,991,455,536,86.31,0.863,0.828,0.79
199962,2008,431,223,208,183,79,104,46.64,0.466,0.425,0.38
199999,2008,1353,886,467,234,62,172,19.41,0.194,0.173,0.133
200004,2008,1218,617,601,485,198,287,46.52,0.465,0.398,0.329
200059,2008,320,142,178,34,16,18,12.68,0.127,0.106,0.09
200156,2008,267,123,144,74,27,47,38.21,0.382,0.277,0.188
200217,2008,373,227,146,108,25,83,36.56,0.366,0.29,0.171
200226,2008,89,52,37,17,5,12,23.08,0.231,0.191,0.135
200253,2008,406,259,147,55,11,44,16.99,0.17,0.135,0.075
200280,2008,1923,896,1027,450,214,236,26.34,0.263,0.234,0.208
200332,2008,2650,1182,1468,667,326,341,28.85,0.289,0.252,0.222
200572,2008,154,70,84,35,14,21,30,0.3,0.227,0.167
201104,2008,570,306,264,236,83,153,50,0.5,0.414,0.314
201371,2008,272,140,132,144,62,82,58.57,0.586,0.529,0.47
201548,2008,632,354,278,321,122,199,56.21,0.562,0.508,0.439
201645,2008,1023,442,581,651,337,314,71.04,0.71,0.636,0.58
201690,2008,646,330,316,72,10,62,18.79,0.188,0.111,0.032
202134,2008,1005,548,457,150,50,100,18.25,0.182,0.149,0.109
202480,2008,1985,1045,940,1177,452,725,69.38,0.694,0.593,0.481
202523,2008,604,325,279,476,202,274,84.31,0.843,0.788,0.724
202763,2008,562,391,171,242,56,186,47.57,0.476,0.431,0.327
203085,2008,402,177,225,142,61,81,45.76,0.458,0.353,0.271
203128,2008,331,164,167,189,82,107,65.24,0.652,0.571,0.491
203368,2008,789,393,396,473,209,264,67.18,0.672,0.599,0.528
203517,2008,3684,2261,1423,1135,325,810,35.82,0.358,0.308,0.228
203535,2008,455,237,218,404,192,212,89.45,0.895,0.888,0.881
203580,2008,249,131,118,91,29,62,47.33,0.473,0.365,0.246
203775,2008,389,233,156,147,44,103,44.21,0.442,0.378,0.282
203845,2008,385,178,207,201,95,106,59.55,0.596,0.522,0.459
204024,2008,3598,1955,1643,2357,959,1398,71.51,0.715,0.655,0.584
204185,2008,663,321,342,336,126,210,65.42,0.654,0.507,0.368
204194,2008,368,234,134,183,66,117,50,0.5,0.497,0.493
204617,2008,356,194,162,113,49,64,32.99,0.33,0.317,0.302
204796,2008,6151,3068,3083,3780,1643,2137,69.65,0.697,0.615,0.533
204857,2008,3908,2114,1794,1910,769,1141,53.97,0.54,0.489,0.429
206330,2008,226,72,154,67,32,35,48.61,0.486,0.296,0.208
206589,2008,518,267,251,364,160,204,76.4,0.764,0.703,0.637
206604,2008,2596,1496,1100,556,193,363,24.26,0.243,0.214,0.175
206622,2008,859,436,423,542,244,298,68.35,0.683,0.631,0.577
206695,2008,2189,1090,1099,199,74,125,11.47,0.115,0.091,0.067
206914,2008,817,457,360,66,22,44,9.63,0.096,0.081,0.061
207209,2008,593,281,312,19,2,17,6.05,0.06,0.032,0.006
207306,2008,317,162,155,47,14,33,20.37,0.204,0.148,0.09
207324,2008,430,206,224,113,50,63,30.58,0.306,0.263,0.223
207388,2008,2946,1501,1445,992,361,631,42.04,0.42,0.337,0.25
207500,2008,3750,2058,1692,1394,525,869,42.23,0.422,0.372,0.31
207722,2008,203,126,77,88,28,60,47.62,0.476,0.433,0.364
207847,2008,583,296,287,68,29,39,13.18,0.132,0.117,0.101
207865,2008,920,511,409,124,41,83,16.24,0.162,0.135,0.1
208822,2008,401,245,156,204,74,130,53.06,0.531,0.509,0.474
209056,2008,534,323,211,381,135,246,76.16,0.762,0.713,0.64
209065,2008,474,274,200,290,106,184,67.15,0.672,0.612,0.53
209542,2008,3006,1422,1584,922,373,549,38.61,0.386,0.307,0.235
209551,2008,4191,2129,2062,1903,824,1079,50.68,0.507,0.454,0.4
209612,2008,345,227,118,174,60,114,50.22,0.502,0.504,0.508
209807,2008,1567,839,728,264,105,159,18.95,0.19,0.168,0.144
209922,2008,329,194,135,219,88,131,67.53,0.675,0.666,0.652
210146,2008,675,407,268,147,46,101,24.82,0.248,0.218,0.172
210401,2008,482,278,204,333,129,204,73.38,0.734,0.691,0.632
210429,2008,882,524,358,197,58,139,26.53,0.265,0.223,0.162
210571,2008,505,260,245,224,86,138,53.08,0.531,0.444,0.351
210669,2008,562,306,256,412,179,233,76.14,0.761,0.733,0.699
210775,2008,383,233,150,148,44,104,44.64,0.446,0.386,0.293
211088,2008,593,434,159,294,73,221,50.92,0.509,0.496,0.459
211158,2008,1805,1028,777,781,263,518,50.39,0.504,0.433,0.338
211291,2008,956,529,427,814,357,457,86.39,0.864,0.851,0.836
211352,2008,503,341,162,210,62,148,43.4,0.434,0.417,0.383
211361,2008,1363,748,615,355,130,225,30.08,0.301,0.26,0.211
211431,2008,226,215,11,99,2,97,45.12,0.451,0.438,0.182
211440,2008,1462,625,837,1050,580,470,75.2,0.752,0.718,0.693
211468,2008,194,194,0,114,0,114,58.76,0.588,0.588,NA
211556,2008,176,176,0,82,0,82,46.59,0.466,0.466,NA
211583,2008,194,115,79,72,24,48,41.74,0.417,0.371,0.304
211608,2008,280,157,123,31,6,25,15.92,0.159,0.111,0.049
211644,2008,1305,747,558,355,116,239,31.99,0.32,0.272,0.208
211981,2008,429,253,176,220,78,142,56.13,0.561,0.513,0.443
212009,2008,613,337,276,495,204,291,86.35,0.863,0.808,0.739
212054,2008,2402,992,1410,579,206,373,37.6,0.376,0.241,0.146
212106,2008,1425,838,587,801,308,493,58.83,0.588,0.562,0.525
212115,2008,1262,655,607,458,167,291,44.43,0.444,0.363,0.275
212133,2008,550,367,183,233,68,165,44.96,0.45,0.424,0.372
212160,2008,1219,697,522,245,77,168,24.1,0.241,0.201,0.148
212197,2008,508,331,177,328,114,214,64.65,0.647,0.646,0.644
212577,2008,588,321,267,485,210,275,85.67,0.857,0.825,0.787
212601,2008,620,367,253,289,106,183,49.86,0.499,0.466,0.419
212832,2008,339,223,116,56,23,33,14.8,0.148,0.165,0.198
212911,2008,327,182,145,287,124,163,89.56,0.896,0.878,0.855
213020,2008,3065,1790,1275,1041,323,718,40.11,0.401,0.34,0.253
213251,2008,461,260,201,332,134,198,76.15,0.762,0.72,0.667
213321,2008,559,295,264,315,134,181,61.36,0.614,0.564,0.508
213349,2008,1812,1034,778,680,206,474,45.84,0.458,0.375,0.265
213358,2008,227,148,79,60,15,45,30.41,0.304,0.264,0.19
213367,2008,902,519,383,471,190,281,54.14,0.541,0.522,0.496
213385,2008,600,270,330,530,280,250,92.59,0.926,0.883,0.848
213507,2008,395,217,178,276,110,166,76.5,0.765,0.699,0.618
213543,2008,1205,516,689,910,484,426,82.56,0.826,0.755,0.702
213613,2008,1269,731,538,340,119,221,30.23,0.302,0.268,0.221
213668,2008,340,161,179,178,77,101,62.73,0.627,0.524,0.43
213783,2008,665,410,255,203,67,136,33.17,0.332,0.305,0.263
213826,2008,422,291,131,238,62,176,60.48,0.605,0.564,0.473
213996,2008,709,448,261,529,186,343,76.56,0.766,0.746,0.713
214041,2008,1311,729,582,503,190,313,42.94,0.429,0.384,0.326
214069,2008,378,248,130,238,72,166,66.94,0.669,0.63,0.554
214157,2008,387,226,161,253,94,159,70.35,0.703,0.654,0.584
214175,2008,597,344,253,484,197,287,83.43,0.834,0.811,0.779
214272,2008,539,348,191,185,51,134,38.51,0.385,0.343,0.267
214777,2008,7241,3428,3813,4746,2226,2520,73.51,0.735,0.655,0.584
215062,2008,2392,1278,1114,2078,943,1135,88.81,0.888,0.869,0.846
215743,2008,412,224,188,254,99,155,69.2,0.692,0.617,0.527
215798,2008,442,195,247,302,167,135,69.23,0.692,0.683,0.676
215929,2008,961,555,406,710,274,436,78.56,0.786,0.739,0.675
216010,2008,1716,871,845,638,247,391,44.89,0.449,0.372,0.292
216038,2008,1527,887,640,749,272,477,53.78,0.538,0.491,0.425
216287,2008,372,184,188,330,159,171,92.93,0.929,0.887,0.846
216339,2008,4157,2260,1897,1718,663,1055,46.68,0.467,0.413,0.349
216524,2008,543,304,239,428,181,247,81.25,0.812,0.788,0.757
216694,2008,376,218,158,195,76,119,54.59,0.546,0.519,0.481
216764,2008,1992,1231,761,872,232,640,51.99,0.52,0.438,0.305
216807,2008,441,246,195,313,128,185,75.2,0.752,0.71,0.656
216852,2008,718,337,381,266,121,145,43.03,0.43,0.37,0.318
216931,2008,559,290,269,249,114,135,46.55,0.465,0.445,0.424
217059,2008,1097,580,517,427,185,242,41.72,0.417,0.389,0.358
217156,2008,1546,813,733,1307,612,695,85.49,0.855,0.845,0.835
217402,2008,987,575,412,821,336,485,84.35,0.843,0.832,0.816
217536,2008,556,382,174,355,94,261,68.32,0.683,0.638,0.54
217776,2008,142,84,58,52,13,39,46.43,0.464,0.366,0.224
217819,2008,1949,1296,653,1070,318,752,58.02,0.58,0.549,0.487
217882,2008,2866,1412,1454,1747,737,1010,71.53,0.715,0.61,0.507
217998,2008,163,83,80,72,32,40,48.19,0.482,0.442,0.4
218061,2008,676,452,224,104,34,70,15.49,0.155,0.154,0.152
218229,2008,554,398,156,162,39,123,30.9,0.309,0.292,0.25
218238,2008,229,98,131,29,8,21,21.43,0.214,0.127,0.061
218399,2008,292,162,130,37,6,31,19.14,0.191,0.127,0.046
218414,2008,297,118,179,78,27,51,43.22,0.432,0.263,0.151
218663,2008,3826,2133,1693,2129,812,1317,61.74,0.617,0.556,0.48
218724,2008,1641,835,806,422,157,265,31.74,0.317,0.257,0.195
218733,2008,923,484,439,138,38,100,20.66,0.207,0.15,0.087
218742,2008,708,455,253,164,47,117,25.71,0.257,0.232,0.186
218973,2008,415,203,212,296,140,156,76.85,0.768,0.713,0.66
219000,2008,426,292,134,211,50,161,55.14,0.551,0.495,0.373
219046,2008,545,345,200,64,17,47,13.62,0.136,0.117,0.085
219082,2008,258,121,137,45,18,27,22.31,0.223,0.174,0.131
219198,2008,136,88,48,66,20,46,52.27,0.523,0.485,0.417
219259,2008,389,204,185,67,16,51,25,0.25,0.172,0.086
219356,2008,2008,987,1021,563,237,326,33.03,0.33,0.28,0.232
219471,2008,1023,597,426,295,111,184,30.82,0.308,0.288,0.261
219602,2008,1326,806,520,208,70,138,17.12,0.171,0.157,0.135
219709,2008,928,519,409,520,217,303,58.38,0.584,0.56,0.531
219718,2008,268,122,146,57,19,38,31.15,0.312,0.213,0.13
219949,2008,194,82,112,43,20,23,28.05,0.28,0.222,0.179
220075,2008,1932,1069,863,380,133,247,23.11,0.231,0.197,0.154
220215,2008,405,220,185,154,61,93,42.27,0.423,0.38,0.33
220613,2008,848,501,347,333,103,230,45.91,0.459,0.393,0.297
220631,2008,256,169,87,31,10,21,12.43,0.124,0.121,0.115
220710,2008,297,146,151,120,50,70,47.95,0.48,0.404,0.331
221351,2008,475,276,199,353,143,210,76.09,0.761,0.743,0.719
221519,2008,409,199,210,310,149,161,80.9,0.809,0.758,0.71
221731,2008,251,141,110,77,30,47,33.33,0.333,0.307,0.273
221847,2008,1659,736,923,379,165,214,29.08,0.291,0.228,0.179
221892,2008,218,125,93,86,31,55,44,0.44,0.394,0.333
222178,2008,971,518,453,434,167,267,51.54,0.515,0.447,0.369
222983,2008,318,191,127,229,88,141,73.82,0.738,0.72,0.693
223232,2008,3054,1801,1253,1669,594,1075,59.69,0.597,0.546,0.474
224004,2008,229,129,100,44,16,28,21.71,0.217,0.192,0.16
224323,2008,341,168,173,216,104,112,66.67,0.667,0.633,0.601
225432,2008,699,400,299,20,9,11,2.75,0.028,0.029,0.03
225548,2008,304,128,176,107,48,59,46.09,0.461,0.352,0.273
225627,2008,880,553,327,157,39,118,21.34,0.213,0.178,0.119
226231,2008,340,106,234,118,76,42,39.62,0.396,0.347,0.325
226833,2008,706,405,301,119,44,75,18.52,0.185,0.169,0.146
227216,2008,3442,1928,1514,891,271,620,32.16,0.322,0.259,0.179
227331,2008,306,213,93,67,14,53,24.88,0.249,0.219,0.151
227526,2008,1290,761,529,355,112,243,31.93,0.319,0.275,0.212
227757,2008,777,386,391,636,307,329,85.23,0.852,0.819,0.785
227845,2008,741,480,261,397,121,276,57.5,0.575,0.536,0.464
227863,2008,293,187,106,101,30,71,37.97,0.38,0.345,0.283
228042,2008,266,145,121,84,34,50,34.48,0.345,0.316,0.281
228149,2008,535,335,200,237,63,174,51.94,0.519,0.443,0.315
228246,2008,1397,751,646,941,404,537,71.5,0.715,0.674,0.625
228343,2008,349,216,133,227,78,149,68.98,0.69,0.65,0.586
228431,2008,2480,1545,935,590,131,459,29.71,0.297,0.238,0.14
228459,2008,3444,2051,1393,916,289,627,30.57,0.306,0.266,0.207
228501,2008,315,124,191,43,18,25,20.16,0.202,0.137,0.094
228529,2008,1274,722,552,276,92,184,25.48,0.255,0.217,0.167
228705,2008,737,310,427,124,70,54,17.42,0.174,0.168,0.164
228723,2008,8038,3940,4098,3989,1575,2414,61.27,0.613,0.496,0.384
228769,2008,2254,1106,1148,396,151,245,22.15,0.222,0.176,0.132
228778,2008,6679,3679,3000,3487,1358,2129,57.87,0.579,0.522,0.453
228787,2008,1090,434,656,553,280,273,62.9,0.629,0.507,0.427
228796,2008,2060,1006,1054,251,83,168,16.7,0.167,0.122,0.079
228875,2008,1628,996,632,954,309,645,64.76,0.648,0.586,0.489
228981,2008,396,191,205,123,44,79,41.36,0.414,0.311,0.215
229018,2008,332,176,156,65,19,46,26.14,0.261,0.196,0.122
229027,2008,4758,2432,2326,512,198,314,12.91,0.129,0.108,0.085
229115,2008,4338,2056,2282,1413,560,853,41.49,0.415,0.326,0.245
229780,2008,197,88,109,23,9,14,15.91,0.159,0.117,0.083
229814,2008,1149,599,550,259,83,176,29.38,0.294,0.225,0.151
230603,2008,836,574,262,169,29,140,24.39,0.244,0.202,0.111
230728,2008,2580,1646,934,484,83,401,24.36,0.244,0.188,0.089
230764,2008,1908,1054,854,465,171,294,27.89,0.279,0.244,0.2
230782,2008,1549,853,696,136,41,95,11.14,0.111,0.088,0.059
231059,2008,543,277,266,396,180,216,77.98,0.78,0.729,0.677
231174,2008,2453,1457,996,1611,617,994,68.22,0.682,0.657,0.619
231420,2008,234,88,146,53,17,36,40.91,0.409,0.226,0.116
231554,2008,80,47,33,29,8,21,44.68,0.447,0.362,0.242
231624,2008,1381,780,601,1146,462,684,87.69,0.877,0.83,0.769
231712,2008,1134,640,494,624,207,417,65.16,0.652,0.55,0.419
232025,2008,241,123,118,87,31,56,45.53,0.455,0.361,0.263
232043,2008,183,103,80,90,35,55,53.4,0.534,0.492,0.438
232089,2008,581,253,328,80,26,54,21.34,0.213,0.138,0.079
232186,2008,2476,1328,1148,1099,406,693,52.18,0.522,0.444,0.354
232265,2008,1190,792,398,489,120,369,46.59,0.466,0.411,0.302
232423,2008,3956,2425,1531,2577,876,1701,70.14,0.701,0.651,0.572
232557,2008,3063,1663,1400,857,314,543,32.65,0.326,0.28,0.224
232566,2008,1043,700,343,467,104,363,51.86,0.519,0.448,0.303
232609,2008,593,336,257,252,85,167,49.7,0.497,0.425,0.331
232681,2008,848,553,295,539,160,379,68.54,0.685,0.636,0.542
232706,2008,404,294,110,141,25,116,39.46,0.395,0.349,0.227
232937,2008,1143,657,486,182,53,129,19.63,0.196,0.159,0.109
232982,2008,2757,1381,1376,652,233,419,30.34,0.303,0.236,0.169
233277,2008,1871,1119,752,809,261,548,48.97,0.49,0.432,0.347
233374,2008,737,412,325,591,255,336,81.55,0.816,0.802,0.785
233426,2008,529,284,245,302,115,187,65.85,0.658,0.571,0.469
233541,2008,399,200,199,145,52,93,46.5,0.465,0.363,0.261
233897,2008,427,194,233,98,42,56,28.87,0.289,0.23,0.18
233921,2008,5449,2449,3000,3306,1509,1797,73.38,0.734,0.607,0.503
234030,2008,3640,2128,1512,1227,429,798,37.5,0.375,0.337,0.284
234085,2008,391,33,358,210,192,18,54.55,0.545,0.537,0.536
234155,2008,1323,832,491,302,64,238,28.61,0.286,0.228,0.13
234164,2008,345,170,175,48,20,28,16.47,0.165,0.139,0.114
235097,2008,1488,859,629,295,110,185,21.54,0.215,0.198,0.175
235167,2008,658,321,337,302,146,156,48.6,0.486,0.459,0.433
236230,2008,712,444,268,372,115,257,57.88,0.579,0.522,0.429
236328,2008,676,377,299,459,187,272,72.15,0.722,0.679,0.625
236577,2008,712,492,220,431,122,309,62.8,0.628,0.605,0.555
236595,2008,881,557,324,530,170,360,64.63,0.646,0.602,0.525
236896,2008,310,158,152,63,24,39,24.68,0.247,0.203,0.158
236939,2008,3391,1744,1647,1408,536,872,50,0.5,0.415,0.325
236948,2008,5377,2896,2481,3296,1351,1945,67.16,0.672,0.613,0.545
237011,2008,2667,1560,1107,1057,328,729,46.73,0.467,0.396,0.296
237057,2008,401,230,171,328,130,198,86.09,0.861,0.818,0.76
237066,2008,545,289,256,354,149,205,70.93,0.709,0.65,0.582
237215,2008,270,156,114,33,15,18,11.54,0.115,0.122,0.132
237330,2008,706,380,326,128,38,90,23.68,0.237,0.181,0.117
237358,2008,129,68,61,35,19,16,23.53,0.235,0.271,0.311
237367,2008,755,370,385,116,52,64,17.3,0.173,0.154,0.135
237792,2008,698,395,303,137,42,95,24.05,0.241,0.196,0.139
237899,2008,302,147,155,16,5,11,7.48,0.075,0.053,0.032
237932,2008,550,299,251,96,30,66,22.07,0.221,0.175,0.12
237969,2008,382,208,174,168,63,105,50.48,0.505,0.44,0.362
238032,2008,5083,2300,2783,1656,766,890,38.7,0.387,0.326,0.275
238333,2008,337,182,155,240,104,136,74.73,0.747,0.712,0.671
238430,2008,258,177,81,39,14,25,14.12,0.141,0.151,0.173
238458,2008,655,447,208,263,77,186,41.61,0.416,0.402,0.37
238476,2008,753,359,394,405,192,213,59.33,0.593,0.538,0.487
238616,2008,402,222,180,139,59,80,36.04,0.36,0.346,0.328
238661,2008,298,219,79,108,29,79,36.07,0.361,0.362,0.367
239080,2008,284,210,74,103,15,88,41.9,0.419,0.363,0.203
239105,2008,1950,1043,907,1153,481,672,64.43,0.644,0.591,0.53
239628,2008,282,143,139,145,59,86,60.14,0.601,0.514,0.424
239716,2008,531,293,238,335,131,204,69.62,0.696,0.631,0.55
240107,2008,357,250,107,102,27,75,30,0.3,0.286,0.252
240189,2008,2132,1025,1107,575,276,299,29.17,0.292,0.27,0.249
240277,2008,1000,614,386,236,67,169,27.52,0.275,0.236,0.174
240329,2008,1779,1081,698,577,192,385,35.62,0.356,0.324,0.275
240338,2008,223,128,95,110,43,67,52.34,0.523,0.493,0.453
240365,2008,1807,1048,759,294,112,182,17.37,0.174,0.163,0.148
240374,2008,833,420,413,70,36,34,8.1,0.081,0.084,0.087
240417,2008,1633,837,796,313,103,210,25.09,0.251,0.192,0.129
240426,2008,303,168,135,59,15,44,26.19,0.262,0.195,0.111
240444,2008,5759,3027,2732,3148,1333,1815,59.96,0.6,0.547,0.488
240453,2008,4002,2100,1902,572,246,326,15.52,0.155,0.143,0.129
240462,2008,1468,496,972,235,117,118,23.79,0.238,0.16,0.12
240471,2008,1332,783,549,365,136,229,29.25,0.292,0.274,0.248
240480,2008,1608,882,726,412,145,267,30.27,0.303,0.256,0.2
240727,2008,1674,851,823,408,148,260,30.55,0.306,0.244,0.18
243443,2008,750,435,315,43,9,34,7.82,0.078,0.057,0.029
243780,2008,7058,3083,3975,3028,1409,1619,52.51,0.525,0.429,0.354
100654,2009,1042,537,505,115,22,93,17.32,0.173,0.11,0.044
100663,2009,1494,819,675,474,188,286,34.92,0.349,0.317,0.279
100751,2009,5062,2746,2316,2093,772,1321,48.11,0.481,0.413,0.333
100858,2009,3911,2007,1904,1733,617,1116,55.61,0.556,0.443,0.324
101435,2009,237,99,138,58,30,28,28.28,0.283,0.245,0.217
101480,2009,1220,695,525,137,30,107,15.4,0.154,0.112,0.057
101675,2009,392,179,213,21,4,17,9.5,0.095,0.054,0.019
101879,2009,1064,597,467,122,33,89,14.91,0.149,0.115,0.071
102049,2009,730,486,244,430,132,298,61.32,0.613,0.589,0.541
102094,2009,1753,927,826,244,83,161,17.37,0.174,0.139,0.1
102234,2009,355,203,152,152,55,97,47.78,0.478,0.428,0.362
102368,2009,1997,1192,805,265,78,187,15.69,0.157,0.133,0.097
102377,2009,688,410,278,123,25,98,23.9,0.239,0.179,0.09
104151,2009,6747,3279,3468,3054,1335,1719,52.42,0.524,0.453,0.385
104179,2009,6782,3697,3085,2922,1146,1776,48.04,0.48,0.431,0.371
105330,2009,3377,1951,1426,1122,354,768,39.36,0.394,0.332,0.248
106245,2009,674,387,287,74,27,47,12.14,0.121,0.11,0.094
106342,2009,216,114,102,75,39,36,31.58,0.316,0.347,0.382
106397,2009,2890,1448,1442,1129,466,663,45.79,0.458,0.391,0.323
106412,2009,959,523,436,67,16,51,9.75,0.098,0.07,0.037
106458,2009,1645,874,771,349,154,195,22.31,0.223,0.212,0.2
106467,2009,1744,882,862,375,139,236,26.76,0.268,0.215,0.161
106485,2009,740,373,367,63,16,47,12.6,0.126,0.085,0.044
106704,2009,1753,1023,730,403,136,267,26.1,0.261,0.23,0.186
107044,2009,950,530,420,430,143,287,54.15,0.541,0.453,0.34
107080,2009,412,245,167,265,107,158,64.49,0.645,0.643,0.641
107141,2009,305,170,135,167,62,105,61.76,0.618,0.548,0.459
107512,2009,389,198,191,208,84,124,62.63,0.626,0.535,0.44
107558,2009,152,72,80,39,12,27,37.5,0.375,0.257,0.15
110097,2009,775,508,267,402,131,271,53.35,0.533,0.519,0.491
110404,2009,251,106,145,212,122,90,84.91,0.849,0.845,0.841
110422,2009,3877,1803,2074,1557,593,964,53.47,0.535,0.402,0.286
110486,2009,1061,652,409,139,39,100,15.34,0.153,0.131,0.095
110495,2009,798,555,243,124,37,87,15.68,0.157,0.155,0.152
110510,2009,1968,1275,693,265,75,190,14.9,0.149,0.135,0.108
110529,2009,2728,1192,1536,401,134,267,22.4,0.224,0.147,0.087
110538,2009,2468,1338,1130,561,159,402,30.04,0.3,0.227,0.141
110547,2009,1069,703,366,66,13,53,7.54,0.075,0.062,0.036
110556,2009,2619,1574,1045,407,123,284,18.04,0.18,0.155,0.118
110565,2009,3842,2233,1609,666,180,486,21.76,0.218,0.173,0.112
110574,2009,1436,884,552,184,54,130,14.71,0.147,0.128,0.098
110583,2009,3473,2133,1340,551,172,379,17.77,0.178,0.159,0.128
110592,2009,1877,1173,704,127,40,87,7.42,0.074,0.068,0.057
110617,2009,2954,1712,1242,196,50,146,8.53,0.085,0.066,0.04
113698,2009,289,207,82,152,25,127,61.35,0.614,0.526,0.305
115755,2009,1345,745,600,214,57,157,21.07,0.211,0.159,0.095
119173,2009,367,351,16,109,5,104,29.63,0.296,0.297,0.312
120184,2009,116,78,38,33,10,23,29.49,0.295,0.284,0.263
121309,2009,533,343,190,338,113,225,65.6,0.656,0.634,0.595
121345,2009,389,190,199,355,180,175,92.11,0.921,0.913,0.905
122409,2009,3291,1881,1410,990,332,658,34.98,0.35,0.301,0.235
122436,2009,1081,621,460,714,259,455,73.27,0.733,0.66,0.563
122597,2009,3855,2497,1358,704,178,526,21.07,0.211,0.183,0.131
122612,2009,1073,744,329,648,172,476,63.98,0.64,0.604,0.523
122931,2009,1084,571,513,830,371,459,80.39,0.804,0.766,0.723
123554,2009,567,354,213,320,101,219,61.86,0.619,0.564,0.474
123572,2009,1465,953,512,413,94,319,33.47,0.335,0.282,0.184
126562,2009,1037,556,481,172,64,108,19.42,0.194,0.166,0.133
126580,2009,1035,543,492,247,98,149,27.44,0.274,0.239,0.199
126614,2009,5515,2719,2796,2598,1102,1496,55.02,0.55,0.471,0.394
126818,2009,4274,2360,1914,1732,593,1139,48.26,0.483,0.405,0.31
127060,2009,1196,684,512,797,314,483,70.61,0.706,0.666,0.613
127185,2009,766,344,422,138,64,74,21.51,0.215,0.18,0.152
127565,2009,1959,985,974,115,46,69,7.01,0.07,0.059,0.047
127741,2009,2275,1360,915,605,165,440,32.35,0.324,0.266,0.18
128106,2009,1013,513,500,178,67,111,21.64,0.216,0.176,0.134
128744,2009,429,260,169,108,37,71,27.31,0.273,0.252,0.219
128771,2009,1277,621,656,321,128,193,31.08,0.311,0.251,0.195
129020,2009,3206,1652,1554,2216,986,1230,74.46,0.745,0.691,0.634
129242,2009,848,479,369,664,270,394,82.25,0.823,0.783,0.732
129941,2009,1252,639,613,553,247,306,47.89,0.479,0.442,0.403
130253,2009,907,542,365,526,180,346,63.84,0.638,0.58,0.493
130314,2009,184,184,0,82,0,82,44.57,0.446,0.446,NA
130493,2009,1237,792,445,280,65,215,27.15,0.272,0.226,0.146
130590,2009,573,272,301,464,232,232,85.29,0.853,0.81,0.771
130697,2009,744,389,355,681,322,359,92.29,0.923,0.915,0.907
130776,2009,1008,549,459,255,99,156,28.42,0.284,0.253,0.216
130794,2009,1305,651,654,1145,553,592,90.94,0.909,0.877,0.846
130934,2009,739,463,276,165,42,123,26.57,0.266,0.223,0.152
130943,2009,4211,2424,1787,2486,929,1557,64.23,0.642,0.59,0.52
131159,2009,1527,917,610,1164,449,715,77.97,0.78,0.762,0.736
131283,2009,813,456,357,501,184,317,69.52,0.695,0.616,0.515
131450,2009,211,112,99,51,13,38,33.93,0.339,0.242,0.131
131469,2009,2582,1435,1147,1940,825,1115,77.7,0.777,0.751,0.719
131496,2009,1550,861,689,1389,601,788,91.52,0.915,0.896,0.872
131520,2009,1600,1097,503,633,144,489,44.58,0.446,0.396,0.286
132471,2009,648,433,215,102,25,77,17.78,0.178,0.157,0.116
132602,2009,917,551,366,233,76,157,28.49,0.285,0.254,0.208
132903,2009,6251,3342,2909,2529,868,1661,49.7,0.497,0.405,0.298
133492,2009,504,300,204,301,122,179,59.67,0.597,0.597,0.598
133553,2009,853,134,719,265,203,62,46.27,0.463,0.311,0.282
133650,2009,2348,1421,927,267,88,179,12.6,0.126,0.114,0.095
133669,2009,2447,1314,1133,487,156,331,25.19,0.252,0.199,0.138
133711,2009,564,337,227,281,94,187,55.49,0.555,0.498,0.414
133881,2009,538,145,393,222,144,78,53.79,0.538,0.413,0.366
133951,2009,2946,1615,1331,828,278,550,34.06,0.341,0.281,0.209
134079,2009,557,319,238,257,91,166,52.04,0.52,0.461,0.382
134097,2009,5925,3476,2449,3650,1245,2405,69.19,0.692,0.616,0.508
134130,2009,6253,3728,2525,4149,1367,2782,74.62,0.746,0.664,0.541
134945,2009,665,337,328,187,78,109,32.34,0.323,0.281,0.238
135726,2009,1903,924,979,1297,599,698,75.54,0.755,0.682,0.612
136172,2009,2025,1129,896,536,155,381,33.75,0.338,0.265,0.173
136950,2009,464,287,177,299,103,196,68.29,0.683,0.644,0.582
137546,2009,502,273,229,287,124,163,59.71,0.597,0.572,0.541
138354,2009,1154,643,511,313,91,222,34.53,0.345,0.271,0.178
138716,2009,745,468,277,66,15,51,10.9,0.109,0.089,0.054
138789,2009,1063,611,452,110,20,90,14.73,0.147,0.103,0.044
139144,2009,569,402,167,315,85,230,57.21,0.572,0.554,0.509
139366,2009,1231,734,497,138,43,95,12.94,0.129,0.112,0.087
139393,2009,277,158,119,139,48,91,57.59,0.576,0.502,0.403
139658,2009,1287,712,575,1067,448,619,86.94,0.869,0.829,0.779
139719,2009,984,550,434,118,26,92,16.73,0.167,0.12,0.06
139755,2009,2654,887,1767,1064,638,426,48.03,0.48,0.401,0.361
139764,2009,435,251,184,49,16,33,13.15,0.132,0.113,0.087
139861,2009,1206,741,465,476,138,338,45.61,0.456,0.395,0.297
139931,2009,3490,1683,1807,854,292,562,33.39,0.334,0.245,0.162
139940,2009,2937,1745,1192,702,233,469,26.88,0.269,0.239,0.195
139959,2009,4675,2862,1813,2881,951,1930,67.44,0.674,0.616,0.525
140447,2009,628,349,279,294,108,186,53.3,0.533,0.468,0.387
140960,2009,866,448,418,68,18,50,11.16,0.112,0.079,0.043
140988,2009,333,175,158,105,32,73,41.71,0.417,0.315,0.203
141185,2009,168,109,59,59,21,38,34.86,0.349,0.351,0.356
141264,2009,2416,1421,995,365,85,280,19.7,0.197,0.151,0.085
141334,2009,1911,1095,816,298,81,217,19.82,0.198,0.156,0.099
141486,2009,262,164,98,73,25,48,29.27,0.293,0.279,0.255
141565,2009,460,269,191,54,17,37,13.75,0.138,0.117,0.089
141574,2009,1847,984,863,392,155,237,24.09,0.241,0.212,0.18
142276,2009,1189,599,590,122,47,75,12.52,0.125,0.103,0.08
142285,2009,1754,841,913,512,180,332,39.48,0.395,0.292,0.197
142461,2009,263,151,112,95,33,62,41.06,0.411,0.361,0.295
143084,2009,616,342,274,434,168,266,77.78,0.778,0.705,0.613
143288,2009,146,93,53,46,18,28,30.11,0.301,0.315,0.34
144005,2009,589,428,161,13,6,7,1.64,0.016,0.022,0.037
144281,2009,2089,1170,919,616,241,375,32.05,0.32,0.295,0.262
144740,2009,2523,1494,1029,1425,538,887,59.37,0.594,0.565,0.523
144892,2009,1637,997,640,520,178,342,34.3,0.343,0.318,0.278
144962,2009,584,341,243,317,106,211,61.88,0.619,0.543,0.436
144971,2009,143,75,68,55,23,32,42.67,0.427,0.385,0.338
145600,2009,3126,1680,1446,1056,411,645,38.39,0.384,0.338,0.284
145619,2009,451,215,236,156,68,88,40.93,0.409,0.346,0.288
145637,2009,6974,3332,3642,4938,2317,2621,78.66,0.787,0.708,0.636
145691,2009,224,99,125,139,71,68,68.69,0.687,0.621,0.568
145813,2009,3060,1816,1244,1462,500,962,52.97,0.53,0.478,0.402
146481,2009,354,213,141,232,81,151,70.89,0.709,0.655,0.574
146612,2009,653,360,293,288,114,174,48.33,0.483,0.441,0.389
146719,2009,2076,1358,718,1323,434,889,65.46,0.655,0.637,0.604
146825,2009,96,34,62,19,6,13,38.24,0.382,0.198,0.097
147013,2009,305,148,157,102,44,58,39.19,0.392,0.334,0.28
147244,2009,541,317,224,259,97,162,51.1,0.511,0.479,0.433
147341,2009,378,187,191,183,79,104,55.61,0.556,0.484,0.414
147703,2009,2988,1573,1415,754,310,444,28.23,0.282,0.252,0.219
147767,2009,2128,1076,1052,1754,826,928,86.25,0.863,0.824,0.785
147776,2009,996,545,451,50,20,30,5.5,0.055,0.05,0.044
147828,2009,771,447,324,395,134,261,58.39,0.584,0.512,0.414
148131,2009,248,127,121,81,31,50,39.37,0.394,0.327,0.256
148496,2009,405,279,126,193,51,142,50.9,0.509,0.477,0.405
148584,2009,223,144,79,92,26,66,45.83,0.458,0.413,0.329
148627,2009,438,282,156,131,34,97,34.4,0.344,0.299,0.218
149222,2009,2445,1131,1314,624,264,360,31.83,0.318,0.255,0.201
149231,2009,1911,1068,843,503,198,305,28.56,0.286,0.263,0.235
149772,2009,1633,817,816,515,226,289,35.37,0.354,0.315,0.277
149781,2009,620,318,302,501,232,269,84.59,0.846,0.808,0.768
150066,2009,547,313,234,238,83,155,49.52,0.495,0.435,0.355
150136,2009,4131,2240,1891,1542,570,972,43.39,0.434,0.373,0.301
150145,2009,295,175,120,165,60,105,60,0.6,0.559,0.5
150163,2009,944,571,373,501,166,335,58.67,0.587,0.531,0.445
150400,2009,717,405,312,543,222,321,79.26,0.793,0.757,0.712
150534,2009,701,433,268,403,152,251,57.97,0.58,0.575,0.567
150668,2009,238,148,90,126,45,81,54.73,0.547,0.529,0.5
150941,2009,250,138,112,142,64,78,56.52,0.565,0.568,0.571
151102,2009,2040,1054,986,131,54,77,7.31,0.073,0.064,0.055
151111,2009,2794,1670,1124,500,187,313,18.74,0.187,0.179,0.166
151306,2009,2048,1199,849,420,100,320,26.69,0.267,0.205,0.118
151324,2009,1969,954,1015,393,183,210,22.01,0.22,0.2,0.18
151333,2009,406,232,174,51,14,37,15.95,0.16,0.126,0.08
151342,2009,1045,611,434,60,21,39,6.38,0.064,0.057,0.048
151351,2009,7301,3640,3661,4387,2001,2386,65.55,0.655,0.601,0.547
151360,2009,773,483,290,70,22,48,9.94,0.099,0.091,0.076
151379,2009,995,612,383,80,27,53,8.66,0.087,0.08,0.07
151388,2009,358,217,141,51,11,40,18.43,0.184,0.142,0.078
151777,2009,426,210,216,198,88,110,52.38,0.524,0.465,0.407
151786,2009,312,166,146,103,39,64,38.55,0.385,0.33,0.267
152080,2009,2055,930,1125,1867,1009,858,92.26,0.923,0.909,0.897
152248,2009,1060,499,561,92,37,55,11.02,0.11,0.087,0.066
152363,2009,240,108,132,102,41,61,56.48,0.565,0.425,0.311
152530,2009,482,263,219,342,141,201,76.43,0.764,0.71,0.644
152600,2009,671,330,341,371,157,214,64.85,0.648,0.553,0.46
153001,2009,271,123,148,116,55,61,49.59,0.496,0.428,0.372
153108,2009,442,213,229,264,117,147,69.01,0.69,0.597,0.511
153269,2009,860,512,348,482,185,297,58.01,0.58,0.56,0.532
153384,2009,377,202,175,299,124,175,86.63,0.866,0.793,0.709
153603,2009,4320,1974,2346,1757,742,1015,51.42,0.514,0.407,0.316
153834,2009,657,380,277,451,190,261,68.68,0.687,0.686,0.686
154095,2009,1913,1194,719,721,220,501,41.96,0.42,0.377,0.306
155089,2009,217,114,103,62,33,29,25.44,0.254,0.286,0.32
155317,2009,3894,1984,1910,1459,599,860,43.35,0.434,0.375,0.314
155335,2009,174,106,68,55,16,39,36.79,0.368,0.316,0.235
155399,2009,3420,1686,1734,972,343,629,37.31,0.373,0.284,0.198
155520,2009,198,110,88,83,29,54,49.09,0.491,0.419,0.33
155627,2009,150,67,83,55,30,25,37.31,0.373,0.367,0.361
155937,2009,182,82,100,49,24,25,30.49,0.305,0.269,0.24
156213,2009,315,198,117,168,64,104,52.53,0.525,0.533,0.547
156286,2009,600,383,217,303,98,205,53.52,0.535,0.505,0.452
156295,2009,391,221,170,174,74,100,45.25,0.452,0.445,0.435
156365,2009,515,260,255,127,44,83,31.92,0.319,0.247,0.173
156541,2009,453,211,242,107,31,76,36.02,0.36,0.236,0.128
156745,2009,378,211,167,186,63,123,58.29,0.583,0.492,0.377
157058,2009,476,265,211,24,7,17,6.42,0.064,0.05,0.033
157076,2009,227,118,109,79,30,49,41.53,0.415,0.348,0.275
157085,2009,4105,2102,2003,1438,551,887,42.2,0.422,0.35,0.275
157289,2009,2441,1273,1168,622,270,352,27.65,0.276,0.255,0.231
157386,2009,1240,708,532,231,74,157,22.18,0.222,0.186,0.139
157401,2009,1374,837,537,330,101,229,27.36,0.274,0.24,0.188
157447,2009,2187,1219,968,340,121,219,17.97,0.18,0.155,0.125
157535,2009,185,62,123,38,20,18,29.03,0.29,0.205,0.163
157951,2009,3288,1783,1505,700,249,451,25.29,0.253,0.213,0.165
158477,2009,278,162,116,128,49,79,48.77,0.488,0.46,0.422
159009,2009,910,548,362,177,65,112,20.44,0.204,0.195,0.18
159391,2009,4776,2516,2260,1823,665,1158,46.03,0.46,0.382,0.294
159647,2009,1448,622,826,438,209,229,36.82,0.368,0.302,0.253
159717,2009,1221,728,493,256,83,173,23.76,0.238,0.21,0.168
159966,2009,1212,707,505,200,67,133,18.81,0.188,0.165,0.133
160038,2009,1235,781,454,231,64,167,21.38,0.214,0.187,0.141
160612,2009,2508,1497,1011,359,118,241,16.1,0.161,0.143,0.117
160621,2009,992,539,453,96,31,65,12.06,0.121,0.097,0.068
160658,2009,2553,1427,1126,373,126,247,17.31,0.173,0.146,0.112
161004,2009,493,253,240,422,200,222,87.75,0.878,0.856,0.833
161226,2009,487,312,175,210,64,146,46.79,0.468,0.431,0.366
161235,2009,118,69,49,20,5,15,21.74,0.217,0.169,0.102
161244,2009,101,67,34,16,4,12,17.91,0.179,0.158,0.118
161253,2009,1654,756,898,550,288,262,34.66,0.347,0.333,0.321
161554,2009,825,447,378,107,27,80,17.9,0.179,0.13,0.071
162007,2009,635,401,234,71,18,53,13.22,0.132,0.112,0.077
162210,2009,144,83,61,21,7,14,16.87,0.169,0.146,0.115
162283,2009,541,392,149,29,2,27,6.89,0.069,0.054,0.013
162584,2009,1028,505,523,217,67,150,29.7,0.297,0.211,0.128
162654,2009,398,276,122,227,53,174,63.04,0.63,0.57,0.434
162760,2009,251,168,83,136,46,90,53.57,0.536,0.542,0.554
162928,2009,1427,663,764,1240,643,597,90.05,0.9,0.869,0.842
163046,2009,968,592,376,740,275,465,78.55,0.785,0.764,0.731
163268,2009,1522,656,866,574,257,317,48.32,0.483,0.377,0.297
163286,2009,4199,1953,2246,2912,1448,1464,74.96,0.75,0.693,0.645
163453,2009,1261,715,546,121,35,86,12.03,0.12,0.096,0.064
163462,2009,464,268,196,298,126,172,64.18,0.642,0.642,0.643
163851,2009,1273,738,535,577,169,408,55.28,0.553,0.453,0.316
163912,2009,486,273,213,327,121,206,75.46,0.755,0.673,0.568
164076,2009,2395,1564,831,1076,275,801,51.21,0.512,0.449,0.331
164173,2009,522,346,176,220,62,158,45.66,0.457,0.421,0.352
164216,2009,378,215,163,269,111,158,73.49,0.735,0.712,0.681
164270,2009,420,195,225,266,124,142,72.82,0.728,0.633,0.551
164447,2009,354,165,189,88,40,48,29.09,0.291,0.249,0.212
164492,2009,373,172,201,95,46,49,28.49,0.285,0.255,0.229
164562,2009,515,294,221,363,135,228,77.55,0.775,0.705,0.611
165015,2009,775,434,341,621,255,366,84.33,0.843,0.801,0.748
165024,2009,1453,866,587,420,162,258,29.79,0.298,0.289,0.276
165334,2009,548,356,192,422,144,278,78.09,0.781,0.77,0.75
165662,2009,764,486,278,593,215,378,77.78,0.778,0.776,0.773
165671,2009,423,308,115,235,60,175,56.82,0.568,0.556,0.522
165820,2009,781,410,371,217,89,128,31.22,0.312,0.278,0.24
165866,2009,719,520,199,261,59,202,38.85,0.388,0.363,0.296
165936,2009,381,237,144,233,71,162,68.35,0.683,0.612,0.493
166027,2009,1662,837,825,1425,673,752,89.84,0.898,0.857,0.816
166124,2009,746,379,367,666,320,346,91.29,0.913,0.893,0.872
166513,2009,1499,548,951,465,243,222,40.51,0.405,0.31,0.256
166629,2009,4215,2175,2040,2703,1192,1511,69.47,0.695,0.641,0.584
166638,2009,934,545,389,154,53,101,18.53,0.185,0.165,0.136
166683,2009,1066,477,589,874,462,412,86.37,0.864,0.82,0.784
167288,2009,347,229,118,119,40,79,34.5,0.345,0.343,0.339
167987,2009,1780,822,958,494,212,282,34.31,0.343,0.278,0.221
167996,2009,683,397,286,564,219,345,86.9,0.869,0.826,0.766
168005,2009,1257,736,521,510,182,328,44.57,0.446,0.406,0.349
168148,2009,1302,669,633,1141,542,599,89.54,0.895,0.876,0.856
168254,2009,683,257,426,322,187,135,52.53,0.525,0.471,0.439
168281,2009,423,261,162,322,118,204,78.16,0.782,0.761,0.728
168342,2009,545,293,252,481,216,265,90.44,0.904,0.883,0.857
168546,2009,434,218,216,241,106,135,61.93,0.619,0.555,0.491
168786,2009,402,271,131,158,46,112,41.33,0.413,0.393,0.351
169080,2009,943,492,451,540,244,296,60.16,0.602,0.573,0.541
169798,2009,2196,1308,888,288,84,204,15.6,0.156,0.131,0.095
169910,2009,1958,980,978,152,58,94,9.59,0.096,0.078,0.059
170082,2009,3716,2278,1438,1363,461,902,39.6,0.396,0.367,0.321
170301,2009,803,486,317,515,186,329,67.7,0.677,0.641,0.587
170532,2009,389,219,170,299,121,178,81.28,0.813,0.769,0.712
170639,2009,437,209,228,65,33,32,15.31,0.153,0.149,0.145
170976,2009,6019,2983,3036,4503,2101,2402,80.52,0.805,0.748,0.692
171100,2009,7249,3869,3380,3612,1445,2167,56.01,0.56,0.498,0.428
171128,2009,1155,301,854,260,162,98,32.56,0.326,0.225,0.19
171137,2009,886,418,468,146,60,86,20.57,0.206,0.165,0.128
171146,2009,713,401,312,77,29,48,11.97,0.12,0.108,0.093
171599,2009,258,141,117,68,26,42,29.79,0.298,0.264,0.222
172051,2009,1728,1028,700,177,59,118,11.48,0.115,0.102,0.084
172699,2009,3162,1591,1571,718,279,439,27.59,0.276,0.227,0.178
173160,2009,683,387,296,430,169,261,67.44,0.674,0.63,0.571
173258,2009,528,272,256,480,222,258,94.85,0.949,0.909,0.867
173328,2009,183,82,101,56,22,34,41.46,0.415,0.306,0.218
173647,2009,611,372,239,495,193,302,81.18,0.812,0.81,0.808
173902,2009,564,329,235,481,196,285,86.63,0.866,0.853,0.834
174066,2009,5381,2849,2532,3188,1380,1808,63.46,0.635,0.592,0.545
174233,2009,2079,1028,1051,728,296,432,42.02,0.42,0.35,0.282
174251,2009,404,235,169,206,74,132,56.17,0.562,0.51,0.438
174491,2009,450,258,192,240,86,154,59.69,0.597,0.533,0.448
174792,2009,461,0,461,303,303,0,NA,NA,0.657,0.657
174844,2009,778,445,333,652,267,385,86.52,0.865,0.838,0.802
174899,2009,540,359,181,337,90,247,68.8,0.688,0.624,0.497
174914,2009,1350,586,764,812,439,373,63.65,0.636,0.601,0.575
175342,2009,463,277,186,77,20,57,20.58,0.206,0.166,0.108
175421,2009,208,116,92,67,18,49,42.24,0.422,0.322,0.196
175616,2009,367,230,137,62,22,40,17.39,0.174,0.169,0.161
175856,2009,841,507,334,157,47,110,21.7,0.217,0.187,0.141
175980,2009,281,116,165,166,80,86,74.14,0.741,0.591,0.485
176017,2009,2547,1358,1189,996,360,636,46.83,0.468,0.391,0.303
176035,2009,216,177,39,56,10,46,25.99,0.26,0.259,0.256
176044,2009,413,222,191,43,13,30,13.51,0.135,0.104,0.068
176080,2009,2447,1210,1237,755,282,473,39.09,0.391,0.309,0.228
176406,2009,231,154,77,57,12,45,29.22,0.292,0.247,0.156
176628,2009,118,79,39,36,9,27,34.18,0.342,0.305,0.231
176947,2009,260,129,131,106,42,64,49.61,0.496,0.408,0.321
176965,2009,1478,822,656,452,148,304,36.98,0.37,0.306,0.226
177418,2009,173,104,69,65,19,46,44.23,0.442,0.376,0.275
178059,2009,340,233,107,190,57,133,57.08,0.571,0.559,0.533
178341,2009,811,395,416,119,53,66,16.71,0.167,0.147,0.127
178387,2009,1004,572,432,127,35,92,16.08,0.161,0.126,0.081
178396,2009,5492,2958,2534,2527,907,1620,54.77,0.548,0.46,0.358
178402,2009,979,610,369,224,62,162,26.56,0.266,0.229,0.168
178411,2009,1099,260,839,263,180,83,31.92,0.319,0.239,0.215
178420,2009,494,295,199,109,34,75,25.42,0.254,0.221,0.171
178615,2009,1337,776,561,739,263,476,61.34,0.613,0.553,0.469
179043,2009,417,263,154,251,84,167,63.5,0.635,0.602,0.545
179159,2009,1714,966,748,1026,393,633,65.53,0.655,0.599,0.525
179557,2009,1640,943,697,455,165,290,30.75,0.308,0.277,0.237
179566,2009,2625,1542,1083,768,225,543,35.21,0.352,0.293,0.208
179867,2009,1481,720,761,1280,622,658,91.39,0.914,0.864,0.817
179894,2009,486,289,197,219,78,141,48.79,0.488,0.451,0.396
179946,2009,311,152,159,149,61,88,57.89,0.579,0.479,0.384
180179,2009,715,400,315,51,19,32,8,0.08,0.071,0.06
180461,2009,1795,728,1067,387,190,197,27.06,0.271,0.216,0.178
180522,2009,233,71,162,21,13,8,11.27,0.113,0.09,0.08
180984,2009,288,139,149,117,47,70,50.36,0.504,0.406,0.315
181002,2009,1052,635,417,709,275,434,68.35,0.683,0.674,0.659
181020,2009,309,167,142,175,65,110,65.87,0.659,0.566,0.458
181127,2009,290,150,140,132,50,82,54.67,0.547,0.455,0.357
181215,2009,974,548,426,231,81,150,27.37,0.274,0.237,0.19
181394,2009,1747,932,815,278,93,185,19.85,0.198,0.159,0.114
181446,2009,393,233,160,201,63,138,59.23,0.592,0.511,0.394
181464,2009,3965,1870,2095,1308,552,756,40.43,0.404,0.33,0.263
181534,2009,227,113,114,35,12,23,20.35,0.204,0.154,0.105
181783,2009,663,361,302,158,56,102,28.25,0.283,0.238,0.185
182281,2009,3083,1659,1424,397,146,251,15.13,0.151,0.129,0.103
182290,2009,2124,1144,980,467,172,295,25.79,0.258,0.22,0.176
182634,2009,432,313,119,190,45,145,46.33,0.463,0.44,0.378
182795,2009,388,175,213,138,62,76,43.43,0.434,0.356,0.291
183062,2009,1171,712,459,616,228,388,54.49,0.545,0.526,0.497
183080,2009,971,450,521,430,196,234,52,0.52,0.443,0.376
183239,2009,528,285,243,372,154,218,76.49,0.765,0.705,0.634
183822,2009,439,278,161,32,16,16,5.76,0.058,0.073,0.099
183974,2009,270,165,105,156,50,106,64.24,0.642,0.578,0.476
184348,2009,505,296,209,317,114,203,68.58,0.686,0.628,0.545
184603,2009,641,361,280,175,57,118,32.69,0.327,0.273,0.204
184612,2009,251,172,79,46,17,29,16.86,0.169,0.183,0.215
184782,2009,1586,738,848,677,344,333,45.12,0.451,0.427,0.406
185129,2009,634,358,276,32,12,20,5.59,0.056,0.05,0.043
185572,2009,998,581,417,504,191,313,53.87,0.539,0.505,0.458
185590,2009,2100,1284,816,757,219,538,41.9,0.419,0.36,0.268
185828,2009,899,169,730,212,151,61,36.09,0.361,0.236,0.207
186131,2009,1297,643,654,1164,568,596,92.69,0.927,0.897,0.869
186201,2009,933,575,358,559,165,394,68.52,0.685,0.599,0.461
186283,2009,1027,611,416,557,216,341,55.81,0.558,0.542,0.519
186584,2009,1124,659,465,570,232,338,51.29,0.513,0.507,0.499
186876,2009,865,483,382,459,175,284,58.8,0.588,0.531,0.458
187134,2009,1283,718,565,918,366,552,76.88,0.769,0.716,0.648
187444,2009,1435,703,732,284,129,155,22.05,0.22,0.198,0.176
187985,2009,3344,1762,1582,516,193,323,18.33,0.183,0.154,0.122
188030,2009,2446,1306,1140,328,116,212,16.23,0.162,0.134,0.102
188429,2009,985,690,295,539,131,408,59.13,0.591,0.547,0.444
188641,2009,465,234,231,204,85,119,50.85,0.509,0.439,0.368
190044,2009,774,220,554,405,262,143,65,0.65,0.523,0.473
190099,2009,750,400,350,644,299,345,86.25,0.863,0.859,0.854
190150,2009,1432,701,731,1260,629,631,90.01,0.9,0.88,0.86
190248,2009,101,54,47,27,7,20,37.04,0.37,0.267,0.149
190415,2009,3174,1597,1577,2742,1327,1415,88.6,0.886,0.864,0.841
190512,2009,1430,619,811,598,294,304,49.11,0.491,0.418,0.363
190549,2009,952,541,411,223,94,129,23.84,0.238,0.234,0.229
190558,2009,2407,1245,1162,127,52,75,6.02,0.06,0.053,0.045
190567,2009,1753,909,844,195,75,120,13.2,0.132,0.111,0.089
190594,2009,1983,1241,742,487,115,372,29.98,0.3,0.246,0.155
190637,2009,754,461,293,111,34,77,16.7,0.167,0.147,0.116
190664,2009,1684,944,740,473,153,320,33.9,0.339,0.281,0.207
190691,2009,1028,627,401,50,12,38,6.06,0.061,0.049,0.03
190725,2009,400,306,94,103,29,74,24.18,0.242,0.258,0.309
191241,2009,1811,926,885,1358,647,711,76.78,0.768,0.75,0.731
191515,2009,466,241,225,407,180,227,94.19,0.942,0.873,0.8
191533,2009,402,239,163,202,66,136,56.9,0.569,0.502,0.405
191630,2009,545,315,230,416,161,255,80.95,0.809,0.763,0.7
191649,2009,1554,834,720,755,297,458,54.92,0.549,0.486,0.412
191676,2009,282,199,83,186,53,133,66.83,0.668,0.66,0.639
191931,2009,792,480,312,448,150,298,62.08,0.621,0.566,0.481
191968,2009,2024,1144,880,1390,571,819,71.59,0.716,0.687,0.649
192192,2009,254,175,79,57,24,33,18.86,0.189,0.224,0.304
192323,2009,605,394,211,344,102,242,61.42,0.614,0.569,0.483
192439,2009,1005,692,313,81,19,62,8.96,0.09,0.081,0.061
192703,2009,693,343,350,412,183,229,66.76,0.668,0.595,0.523
192749,2009,490,298,192,250,86,164,55.03,0.55,0.51,0.448
192819,2009,1041,577,464,708,279,429,74.35,0.743,0.68,0.601
192925,2009,402,257,145,104,35,69,26.85,0.268,0.259,0.241
193016,2009,880,552,328,157,39,118,21.38,0.214,0.178,0.119
193292,2009,414,307,107,189,42,147,47.88,0.479,0.457,0.393
193353,2009,474,362,112,217,42,175,48.34,0.483,0.458,0.375
193399,2009,390,275,115,131,30,101,36.73,0.367,0.336,0.261
193584,2009,491,387,104,315,68,247,63.82,0.638,0.642,0.654
193645,2009,530,465,65,86,8,78,16.77,0.168,0.162,0.123
193654,2009,1136,836,300,533,113,420,50.24,0.502,0.469,0.377
193900,2009,5367,3037,2330,3359,1449,1910,62.89,0.629,0.626,0.622
193973,2009,671,404,267,378,141,237,58.66,0.587,0.563,0.528
194161,2009,260,151,109,68,26,42,27.81,0.278,0.262,0.239
194310,2009,1637,1036,601,603,194,409,39.48,0.395,0.368,0.323
194824,2009,1337,360,977,840,599,241,66.94,0.669,0.628,0.613
195003,2009,2582,798,1784,796,413,383,47.99,0.48,0.308,0.232
195030,2009,1195,594,601,890,431,459,77.27,0.773,0.745,0.717
195164,2009,465,249,216,252,106,146,58.63,0.586,0.542,0.491
195173,2009,580,301,279,168,63,105,34.88,0.349,0.29,0.226
195216,2009,579,307,272,476,219,257,83.71,0.837,0.822,0.805
195234,2009,583,381,202,271,76,195,51.18,0.512,0.465,0.376
195243,2009,293,156,137,105,56,49,31.41,0.314,0.358,0.409
195304,2009,365,273,92,263,72,191,69.96,0.7,0.721,0.783
195474,2009,783,417,366,563,239,324,77.7,0.777,0.719,0.653
195526,2009,663,414,249,549,194,355,85.75,0.858,0.828,0.779
195544,2009,700,519,181,374,73,301,58,0.58,0.534,0.403
195809,2009,3101,1651,1450,1245,534,711,43.06,0.431,0.401,0.368
196413,2009,3240,1868,1372,2215,854,1361,72.86,0.729,0.684,0.622
196592,2009,867,555,312,58,7,51,9.19,0.092,0.067,0.022
197045,2009,559,271,288,161,76,85,31.37,0.314,0.288,0.264
197133,2009,658,392,266,568,217,351,89.54,0.895,0.863,0.816
197869,2009,2732,1471,1261,1267,464,803,54.59,0.546,0.464,0.368
197984,2009,396,224,172,138,50,88,39.29,0.393,0.348,0.291
198385,2009,487,252,235,438,207,231,91.67,0.917,0.899,0.881
198464,2009,3942,2273,1669,1397,445,952,41.88,0.419,0.354,0.267
198507,2009,659,375,284,106,35,71,18.93,0.189,0.161,0.123
198516,2009,1290,774,516,1025,374,651,84.11,0.841,0.795,0.725
198835,2009,355,215,140,119,36,83,38.6,0.386,0.335,0.257
198969,2009,472,144,328,80,35,45,31.25,0.312,0.169,0.107
199102,2009,1875,1028,847,383,116,267,25.97,0.26,0.204,0.137
199111,2009,637,363,274,230,75,155,42.7,0.427,0.361,0.274
199120,2009,3955,2354,1601,3216,1225,1991,84.58,0.846,0.813,0.765
199139,2009,3152,1571,1581,820,319,501,31.89,0.319,0.26,0.202
199148,2009,2495,1733,762,804,180,624,36.01,0.36,0.322,0.236
199157,2009,1345,858,487,215,49,166,19.35,0.194,0.16,0.101
199193,2009,4716,2067,2649,2031,920,1111,53.75,0.537,0.431,0.347
199218,2009,1943,1178,765,975,314,661,56.11,0.561,0.502,0.41
199281,2009,1202,642,560,218,77,141,21.96,0.22,0.181,0.138
199306,2009,225,100,125,71,34,37,37,0.37,0.316,0.272
199412,2009,311,232,79,144,31,113,48.71,0.487,0.463,0.392
199582,2009,424,206,218,91,35,56,27.18,0.272,0.215,0.161
199643,2009,581,334,247,74,24,50,14.97,0.15,0.127,0.097
199847,2009,1193,628,565,983,445,538,85.67,0.857,0.824,0.788
199962,2009,375,195,180,150,59,91,46.67,0.467,0.4,0.328
199999,2009,794,540,254,135,39,96,17.78,0.178,0.17,0.154
200004,2009,1547,848,699,568,211,357,42.1,0.421,0.367,0.302
200059,2009,307,177,130,43,13,30,16.95,0.169,0.14,0.1
200156,2009,233,116,117,49,17,32,27.59,0.276,0.21,0.145
200217,2009,311,192,119,122,32,90,46.88,0.469,0.392,0.269
200226,2009,147,57,90,17,7,10,17.54,0.175,0.116,0.078
200253,2009,418,238,180,68,21,47,19.75,0.198,0.163,0.117
200280,2009,1970,940,1030,468,218,250,26.6,0.266,0.238,0.212
200332,2009,2435,1111,1324,655,299,356,32.04,0.32,0.269,0.226
200572,2009,152,53,99,32,13,19,35.85,0.359,0.211,0.131
201104,2009,614,338,276,281,94,187,55.33,0.553,0.458,0.341
201371,2009,257,116,141,107,48,59,50.86,0.509,0.416,0.34
201548,2009,608,323,285,336,150,186,57.59,0.576,0.553,0.526
201645,2009,965,401,564,609,309,300,74.81,0.748,0.631,0.548
201690,2009,702,363,339,42,14,28,7.71,0.077,0.06,0.041
202134,2009,1127,601,526,181,70,111,18.47,0.185,0.161,0.133
202480,2009,1692,834,858,1050,463,587,70.38,0.704,0.621,0.54
202523,2009,649,362,287,500,205,295,81.49,0.815,0.77,0.714
202763,2009,565,398,167,251,51,200,50.25,0.503,0.444,0.305
203085,2009,375,168,207,118,48,70,41.67,0.417,0.315,0.232
203128,2009,293,143,150,154,74,80,55.94,0.559,0.526,0.493
203368,2009,660,335,325,373,163,210,62.69,0.627,0.565,0.502
203517,2009,4003,2437,1566,1298,400,898,36.85,0.368,0.324,0.255
203535,2009,468,248,220,393,176,217,87.5,0.875,0.84,0.8
203580,2009,263,127,136,95,44,51,40.16,0.402,0.361,0.324
203775,2009,477,275,202,230,80,150,54.55,0.545,0.482,0.396
203845,2009,386,178,208,218,109,109,61.24,0.612,0.565,0.524
204024,2009,3219,1745,1474,2104,855,1249,71.58,0.716,0.654,0.58
204185,2009,578,286,292,315,124,191,66.78,0.668,0.545,0.425
204194,2009,300,190,110,172,61,111,58.42,0.584,0.573,0.555
204617,2009,274,143,131,98,40,58,40.56,0.406,0.358,0.305
204796,2009,6724,3237,3487,3935,1699,2236,69.08,0.691,0.585,0.487
204857,2009,4052,2217,1835,1954,702,1252,56.47,0.565,0.482,0.383
206330,2009,182,75,107,28,10,18,24,0.24,0.154,0.093
206589,2009,479,264,215,371,154,217,82.2,0.822,0.775,0.716
206604,2009,2463,1378,1085,515,196,319,23.15,0.231,0.209,0.181
206622,2009,1178,637,541,779,352,427,67.03,0.67,0.661,0.651
206695,2009,2564,1306,1258,240,111,129,9.88,0.099,0.094,0.088
206914,2009,855,489,366,73,28,45,9.2,0.092,0.085,0.077
207209,2009,561,253,308,17,6,11,4.35,0.044,0.03,0.019
207306,2009,402,199,203,32,8,24,12.06,0.121,0.08,0.039
207324,2009,471,218,253,148,67,81,37.16,0.372,0.314,0.265
207388,2009,2973,1544,1429,997,365,632,40.93,0.409,0.335,0.255
207500,2009,3700,1917,1783,1411,555,856,44.65,0.446,0.381,0.311
207722,2009,166,113,53,49,12,37,32.74,0.327,0.295,0.226
207847,2009,639,313,326,84,38,46,14.7,0.147,0.131,0.117
207865,2009,900,481,419,105,30,75,15.59,0.156,0.117,0.072
208822,2009,411,239,172,249,102,147,61.51,0.615,0.606,0.593
209056,2009,494,298,196,327,122,205,68.79,0.688,0.662,0.622
209065,2009,420,252,168,226,76,150,59.52,0.595,0.538,0.452
209542,2009,3314,1620,1694,1072,400,672,41.48,0.415,0.323,0.236
209551,2009,3788,2027,1761,1900,778,1122,55.35,0.553,0.502,0.442
209612,2009,333,204,129,213,82,131,64.22,0.642,0.64,0.636
209807,2009,1551,800,751,296,109,187,23.38,0.234,0.191,0.145
209922,2009,367,192,175,253,122,131,68.23,0.682,0.689,0.697
210146,2009,652,378,274,131,37,94,24.87,0.249,0.201,0.135
210401,2009,541,294,247,384,165,219,74.49,0.745,0.71,0.668
210429,2009,933,553,380,192,39,153,27.67,0.277,0.206,0.103
210571,2009,541,317,224,268,83,185,58.36,0.584,0.495,0.371
210669,2009,580,299,281,395,177,218,72.91,0.729,0.681,0.63
210775,2009,328,188,140,124,53,71,37.77,0.378,0.378,0.379
211088,2009,529,381,148,257,70,187,49.08,0.491,0.486,0.473
211158,2009,2031,1221,810,772,252,520,42.59,0.426,0.38,0.311
211291,2009,920,466,454,780,371,409,87.77,0.878,0.848,0.817
211352,2009,357,237,120,178,57,121,51.05,0.51,0.499,0.475
211361,2009,1373,679,694,323,156,167,24.59,0.246,0.235,0.225
211431,2009,250,245,5,100,1,99,40.41,0.404,0.4,0.2
211440,2009,1423,611,812,1026,558,468,76.6,0.766,0.721,0.687
211468,2009,195,194,1,84,0,84,43.3,0.433,0.431,0
211556,2009,131,131,0,66,0,66,50.38,0.504,0.504,NA
211583,2009,273,164,109,101,27,74,45.12,0.451,0.37,0.248
211608,2009,372,199,173,22,7,15,7.54,0.075,0.059,0.04
211644,2009,1384,805,579,395,122,273,33.91,0.339,0.285,0.211
211981,2009,452,252,200,227,74,153,60.71,0.607,0.502,0.37
212009,2009,581,340,241,472,191,281,82.65,0.827,0.812,0.793
212054,2009,2268,898,1370,516,209,307,34.19,0.342,0.228,0.153
212106,2009,1425,814,611,787,296,491,60.32,0.603,0.552,0.484
212115,2009,1342,737,605,466,167,299,40.57,0.406,0.347,0.276
212133,2009,489,318,171,213,61,152,47.8,0.478,0.436,0.357
212160,2009,1407,803,604,266,82,184,22.91,0.229,0.189,0.136
212197,2009,544,340,204,391,133,258,75.88,0.759,0.719,0.652
212577,2009,629,334,295,511,229,282,84.43,0.844,0.812,0.776
212601,2009,648,382,266,310,106,204,53.4,0.534,0.478,0.398
212832,2009,313,214,99,47,18,29,13.55,0.136,0.15,0.182
212911,2009,323,186,137,275,121,154,82.8,0.828,0.851,0.883
213020,2009,2993,1774,1219,1068,329,739,41.66,0.417,0.357,0.27
213251,2009,366,207,159,246,98,148,71.5,0.715,0.672,0.616
213321,2009,499,233,266,303,142,161,69.1,0.691,0.607,0.534
213349,2009,1985,1132,853,689,221,468,41.34,0.413,0.347,0.259
213358,2009,190,121,69,46,15,31,25.62,0.256,0.242,0.217
213367,2009,1005,580,425,522,209,313,53.97,0.54,0.519,0.492
213385,2009,616,298,318,533,263,270,90.6,0.906,0.865,0.827
213507,2009,378,205,173,258,92,166,80.98,0.81,0.683,0.532
213543,2009,1189,489,700,878,469,409,83.64,0.836,0.738,0.67
213613,2009,1185,702,483,336,117,219,31.2,0.312,0.284,0.242
213668,2009,383,194,189,220,89,131,67.53,0.675,0.574,0.471
213783,2009,704,397,307,189,71,118,29.72,0.297,0.268,0.231
213826,2009,411,287,124,231,54,177,61.67,0.617,0.562,0.435
213996,2009,697,440,257,497,173,324,73.64,0.736,0.713,0.673
214041,2009,1317,726,591,472,179,293,40.36,0.404,0.358,0.303
214069,2009,371,236,135,237,78,159,67.37,0.674,0.639,0.578
214157,2009,379,223,156,248,97,151,67.71,0.677,0.654,0.622
214175,2009,576,337,239,475,187,288,85.46,0.855,0.825,0.782
214272,2009,519,323,196,189,57,132,40.87,0.409,0.364,0.291
214777,2009,6574,3217,3357,4226,1910,2316,71.99,0.72,0.643,0.569
215062,2009,2402,1232,1170,2091,976,1115,90.5,0.905,0.871,0.834
215743,2009,349,207,142,15,3,12,5.8,0.058,0.043,0.021
215798,2009,446,197,249,267,125,142,72.08,0.721,0.599,0.502
215929,2009,1027,578,449,747,296,451,78.03,0.78,0.727,0.659
216010,2009,1673,873,800,669,273,396,45.36,0.454,0.4,0.341
216038,2009,1534,915,619,795,258,537,58.69,0.587,0.518,0.417
216287,2009,394,204,190,343,159,184,90.2,0.902,0.871,0.837
216339,2009,4183,2320,1863,1808,687,1121,48.32,0.483,0.432,0.369
216524,2009,509,260,249,379,178,201,77.31,0.773,0.745,0.715
216694,2009,380,221,159,211,77,134,60.63,0.606,0.555,0.484
216764,2009,2241,1353,888,954,277,677,50.04,0.5,0.426,0.312
216807,2009,451,277,174,313,117,196,70.76,0.708,0.694,0.672
216852,2009,710,372,338,304,127,177,47.58,0.476,0.428,0.376
216931,2009,527,243,284,250,121,129,53.09,0.531,0.474,0.426
217059,2009,1092,595,497,431,144,287,48.24,0.482,0.395,0.29
217156,2009,1490,770,720,1238,598,640,83.12,0.831,0.831,0.831
217402,2009,952,549,403,772,324,448,81.6,0.816,0.811,0.804
217536,2009,501,346,155,343,98,245,70.81,0.708,0.685,0.632
217776,2009,168,100,68,67,26,41,41,0.41,0.399,0.382
217819,2009,2136,1497,639,1203,320,883,58.98,0.59,0.563,0.501
217882,2009,3336,1564,1772,1926,853,1073,68.61,0.686,0.577,0.481
217998,2009,182,99,83,102,45,57,57.58,0.576,0.56,0.542
218061,2009,791,533,258,142,44,98,18.39,0.184,0.18,0.171
218229,2009,581,405,176,160,46,114,28.15,0.281,0.275,0.261
218238,2009,288,133,155,63,22,41,30.83,0.308,0.219,0.142
218399,2009,300,166,134,37,9,28,16.87,0.169,0.123,0.067
218414,2009,342,133,209,84,32,52,39.1,0.391,0.246,0.153
218663,2009,3881,2089,1792,2132,825,1307,62.57,0.626,0.549,0.46
218724,2009,1766,950,816,465,142,323,34,0.34,0.263,0.174
218733,2009,713,358,355,106,37,69,19.27,0.193,0.149,0.104
218742,2009,837,540,297,219,63,156,28.89,0.289,0.262,0.212
218973,2009,391,203,188,302,138,164,80.79,0.808,0.772,0.734
219000,2009,431,261,170,245,80,165,63.22,0.632,0.568,0.471
219046,2009,540,308,232,85,23,62,20.13,0.201,0.157,0.099
219082,2009,284,116,168,54,28,26,22.41,0.224,0.19,0.167
219198,2009,109,66,43,47,16,31,46.97,0.47,0.431,0.372
219259,2009,317,197,120,65,16,49,24.87,0.249,0.205,0.133
219356,2009,2043,1032,1011,602,247,355,34.4,0.344,0.295,0.244
219471,2009,971,559,412,286,91,195,34.88,0.349,0.295,0.221
219602,2009,1465,897,568,214,74,140,15.61,0.156,0.146,0.13
219709,2009,986,558,428,561,222,339,60.75,0.608,0.569,0.519
219718,2009,351,151,200,90,36,54,35.76,0.358,0.256,0.18
219949,2009,200,101,99,62,25,37,36.63,0.366,0.31,0.253
220075,2009,2063,1144,919,415,146,269,23.51,0.235,0.201,0.159
220215,2009,405,240,165,177,72,105,43.75,0.438,0.437,0.436
220613,2009,829,507,322,288,80,208,41.03,0.41,0.347,0.248
220631,2009,314,218,96,61,15,46,21.1,0.211,0.194,0.156
220710,2009,304,154,150,56,46,10,6.49,0.065,0.184,0.307
221351,2009,427,236,191,320,133,187,79.24,0.792,0.749,0.696
221519,2009,401,203,198,296,140,156,76.85,0.768,0.738,0.707
221731,2009,246,163,83,75,22,53,32.52,0.325,0.305,0.265
221847,2009,1879,884,995,476,181,295,33.37,0.334,0.253,0.182
221892,2009,240,145,95,96,35,61,42.07,0.421,0.4,0.368
222178,2009,979,520,459,406,136,270,51.92,0.519,0.415,0.296
222983,2009,413,213,200,295,129,166,77.93,0.779,0.714,0.645
223232,2009,3097,1825,1272,1672,592,1080,59.18,0.592,0.54,0.465
224004,2009,225,122,103,58,22,36,29.51,0.295,0.258,0.214
224323,2009,319,169,150,212,96,116,68.64,0.686,0.665,0.64
225432,2009,722,378,344,10,6,4,1.06,0.011,0.014,0.017
225548,2009,209,84,125,74,31,43,51.19,0.512,0.354,0.248
225627,2009,717,469,248,178,49,129,27.51,0.275,0.248,0.198
226231,2009,341,109,232,123,83,40,36.7,0.367,0.361,0.358
226833,2009,701,386,315,139,40,99,25.65,0.256,0.198,0.127
227216,2009,3255,1832,1423,881,271,610,33.3,0.333,0.271,0.19
227331,2009,246,170,76,54,14,40,23.53,0.235,0.22,0.184
227526,2009,1638,957,681,180,42,138,14.42,0.144,0.11,0.062
227757,2009,887,427,460,710,342,368,86.18,0.862,0.8,0.743
227845,2009,755,470,285,383,123,260,55.32,0.553,0.507,0.432
227863,2009,284,181,103,106,34,72,39.78,0.398,0.373,0.33
228042,2009,289,155,134,98,44,54,34.84,0.348,0.339,0.328
228149,2009,530,335,195,270,76,194,57.91,0.579,0.509,0.39
228246,2009,1325,702,623,886,374,512,72.93,0.729,0.669,0.6
228343,2009,375,231,144,257,88,169,73.16,0.732,0.685,0.611
228431,2009,2553,1613,940,576,135,441,27.34,0.273,0.226,0.144
228459,2009,3804,2260,1544,985,271,714,31.59,0.316,0.259,0.176
228501,2009,374,135,239,36,15,21,15.56,0.156,0.096,0.063
228529,2009,1207,668,539,293,96,197,29.49,0.295,0.243,0.178
228705,2009,971,414,557,165,75,90,21.74,0.217,0.17,0.135
228723,2009,7933,3908,4025,4017,1602,2415,61.8,0.618,0.506,0.398
228769,2009,2435,1261,1174,502,206,296,23.47,0.235,0.206,0.175
228778,2009,7198,3853,3345,3746,1514,2232,57.93,0.579,0.52,0.453
228787,2009,1293,560,733,615,304,311,55.54,0.555,0.476,0.415
228796,2009,2281,1153,1128,274,95,179,15.52,0.155,0.12,0.084
228875,2009,1818,1142,676,1068,348,720,63.05,0.63,0.587,0.515
228981,2009,345,171,174,104,43,61,35.67,0.357,0.301,0.247
229018,2009,326,176,150,72,29,43,24.43,0.244,0.221,0.193
229027,2009,4559,2281,2278,507,180,327,14.34,0.143,0.111,0.079
229115,2009,4514,2185,2329,1582,641,941,43.07,0.431,0.35,0.275
229780,2009,214,103,111,38,11,27,26.21,0.262,0.178,0.099
229814,2009,1193,603,590,260,78,182,30.18,0.302,0.218,0.132
230603,2009,1101,742,359,193,42,151,20.35,0.204,0.175,0.117
230728,2009,2664,1663,1001,508,100,408,24.53,0.245,0.191,0.1
230764,2009,2102,1177,925,597,205,392,33.31,0.333,0.284,0.222
230782,2009,1845,1011,834,140,43,97,9.59,0.096,0.076,0.052
231059,2009,470,230,240,322,146,176,76.52,0.765,0.685,0.608
231174,2009,2607,1482,1125,1733,691,1042,70.31,0.703,0.665,0.614
231420,2009,222,78,144,52,27,25,32.05,0.32,0.234,0.188
231554,2009,115,64,51,36,11,25,39.06,0.391,0.313,0.216
231624,2009,1384,728,656,1133,503,630,86.54,0.865,0.819,0.767
231712,2009,1212,719,493,689,235,454,63.14,0.631,0.568,0.477
232025,2009,283,115,168,108,52,56,48.7,0.487,0.382,0.31
232043,2009,218,135,83,110,40,70,51.85,0.519,0.505,0.482
232089,2009,531,262,269,106,45,61,23.28,0.233,0.2,0.167
232186,2009,2627,1367,1260,1198,446,752,55.01,0.55,0.456,0.354
232265,2009,1017,632,385,135,135,0,0,0,0.133,0.351
232423,2009,3948,2488,1460,2625,823,1802,72.43,0.724,0.665,0.564
232557,2009,3871,2113,1758,1154,439,715,33.84,0.338,0.298,0.25
232566,2009,934,631,303,414,96,318,50.4,0.504,0.443,0.317
232609,2009,592,348,244,278,91,187,53.74,0.537,0.47,0.373
232681,2009,925,600,325,543,156,387,64.5,0.645,0.587,0.48
232706,2009,383,274,109,131,31,100,36.5,0.365,0.342,0.284
232937,2009,1160,654,506,183,63,120,18.35,0.184,0.158,0.125
232982,2009,2691,1346,1345,698,263,435,32.32,0.323,0.259,0.196
233277,2009,1444,838,606,637,217,420,50.12,0.501,0.441,0.358
233374,2009,918,546,372,758,293,465,85.16,0.852,0.826,0.788
233426,2009,560,325,235,327,123,204,62.77,0.628,0.584,0.523
233541,2009,443,235,208,155,46,109,46.38,0.464,0.35,0.221
233897,2009,397,172,225,87,40,47,27.33,0.273,0.219,0.178
233921,2009,5036,2266,2770,3075,1446,1629,71.89,0.719,0.611,0.522
234030,2009,3588,2094,1494,1318,475,843,40.26,0.403,0.367,0.318
234085,2009,429,42,387,261,237,24,57.14,0.571,0.608,0.612
234155,2009,1225,806,419,353,93,260,32.26,0.323,0.288,0.222
234164,2009,554,303,251,99,34,65,21.45,0.214,0.179,0.135
235097,2009,1459,848,611,298,98,200,23.58,0.236,0.204,0.16
235167,2009,576,284,292,234,112,122,42.96,0.43,0.406,0.384
236230,2009,712,436,276,373,123,250,57.34,0.573,0.524,0.446
236328,2009,719,419,300,517,198,319,76.13,0.761,0.719,0.66
236577,2009,682,489,193,361,93,268,54.81,0.548,0.529,0.482
236595,2009,730,459,271,468,156,312,67.97,0.68,0.641,0.576
236896,2009,316,157,159,59,20,39,24.84,0.248,0.187,0.126
236939,2009,3627,1888,1739,1366,549,817,43.27,0.433,0.377,0.316
236948,2009,5119,2795,2324,3227,1338,1889,67.58,0.676,0.63,0.576
237011,2009,2670,1521,1149,1062,369,693,45.56,0.456,0.398,0.321
237057,2009,395,238,157,314,117,197,82.77,0.828,0.795,0.745
237066,2009,555,324,231,354,145,209,64.51,0.645,0.638,0.628
237215,2009,304,177,127,28,18,10,5.65,0.056,0.092,0.142
237330,2009,607,348,259,121,44,77,22.13,0.221,0.199,0.17
237358,2009,234,139,95,60,23,37,26.62,0.266,0.256,0.242
237367,2009,795,412,383,118,58,60,14.56,0.146,0.148,0.151
237792,2009,786,437,349,169,63,106,24.26,0.243,0.215,0.181
237899,2009,246,120,126,28,9,19,15.83,0.158,0.114,0.071
237932,2009,569,340,229,130,33,97,28.53,0.285,0.228,0.144
237969,2009,399,197,202,151,61,90,45.69,0.457,0.378,0.302
238032,2009,4555,2098,2457,1501,661,840,40.04,0.4,0.33,0.269
238333,2009,332,199,133,233,90,143,71.86,0.719,0.702,0.677
238430,2009,209,119,90,19,4,15,12.61,0.126,0.091,0.044
238458,2009,738,482,256,311,102,209,43.36,0.434,0.421,0.398
238476,2009,721,351,370,359,158,201,57.26,0.573,0.498,0.427
238616,2009,468,266,202,171,63,108,40.6,0.406,0.365,0.312
238661,2009,285,213,72,110,27,83,38.97,0.39,0.386,0.375
239080,2009,316,228,88,88,19,69,30.26,0.303,0.278,0.216
239105,2009,1945,1005,940,1135,505,630,62.69,0.627,0.584,0.537
239628,2009,248,123,125,148,68,80,65.04,0.65,0.597,0.544
239716,2009,543,308,235,359,135,224,72.73,0.727,0.661,0.574
240107,2009,405,287,118,119,24,95,33.1,0.331,0.294,0.203
240189,2009,1941,941,1000,542,250,292,31.03,0.31,0.279,0.25
240277,2009,1037,647,390,248,58,190,29.37,0.294,0.239,0.149
240329,2009,1826,1128,698,660,193,467,41.4,0.414,0.361,0.277
240338,2009,202,104,98,89,33,56,53.85,0.538,0.441,0.337
240365,2009,1874,1061,813,274,95,179,16.87,0.169,0.146,0.117
240374,2009,788,427,361,88,31,57,13.35,0.134,0.112,0.086
240417,2009,1517,788,729,350,111,239,30.33,0.303,0.231,0.152
240426,2009,364,194,170,58,22,36,18.56,0.186,0.159,0.129
240444,2009,5673,3033,2640,3179,1277,1902,62.71,0.627,0.56,0.484
240453,2009,4051,2020,2031,578,250,328,16.24,0.162,0.143,0.123
240462,2009,1531,512,1019,304,166,138,26.95,0.27,0.199,0.163
240471,2009,1325,836,489,382,108,274,32.78,0.328,0.288,0.221
240480,2009,1632,835,797,422,156,266,31.86,0.319,0.259,0.196
240727,2009,1568,799,769,405,136,269,33.67,0.337,0.258,0.177
243443,2009,726,461,265,43,12,31,6.72,0.067,0.059,0.045
243780,2009,6308,2660,3648,2868,1412,1456,54.74,0.547,0.455,0.387
100654,2010,1073,549,524,69,18,51,9.29,0.093,0.064,0.034
100663,2010,1537,851,686,463,176,287,33.73,0.337,0.301,0.257
100751,2010,5443,3006,2437,2387,856,1531,50.93,0.509,0.439,0.351
100858,2010,4193,2204,1989,1963,730,1233,55.94,0.559,0.468,0.367
101435,2010,271,113,158,71,30,41,36.28,0.363,0.262,0.19
101480,2010,1246,685,561,180,55,125,18.25,0.182,0.144,0.098
101675,2010,343,141,202,44,18,26,18.44,0.184,0.128,0.089
101879,2010,961,562,399,152,43,109,19.4,0.194,0.158,0.108
102049,2010,711,455,256,417,132,285,62.64,0.626,0.586,0.516
102094,2010,1707,950,757,262,83,179,18.84,0.188,0.153,0.11
102234,2010,392,252,140,180,56,124,49.21,0.492,0.459,0.4
102368,2010,1810,1083,727,295,97,198,18.28,0.183,0.163,0.133
102377,2010,701,393,308,228,99,129,32.82,0.328,0.325,0.321
104151,2010,6210,2997,3213,3071,1409,1662,55.46,0.555,0.495,0.439
104179,2010,6797,3629,3168,2847,1137,1710,47.12,0.471,0.419,0.359
105330,2010,3739,2209,1530,1354,442,912,41.29,0.413,0.362,0.289
106245,2010,683,376,307,80,40,40,10.64,0.106,0.117,0.13
106342,2010,198,107,91,70,29,41,38.32,0.383,0.354,0.319
106397,2010,3774,1929,1845,1596,634,962,49.87,0.499,0.423,0.344
106412,2010,780,393,387,51,13,38,9.67,0.097,0.065,0.034
106458,2010,1659,897,762,438,167,271,30.21,0.302,0.264,0.219
106467,2010,1681,823,858,259,105,154,18.71,0.187,0.154,0.122
106485,2010,689,338,351,69,30,39,11.54,0.115,0.1,0.085
106704,2010,1828,1070,758,445,155,290,27.1,0.271,0.243,0.204
107044,2010,988,506,482,426,177,249,49.21,0.492,0.431,0.367
107080,2010,403,237,166,259,96,163,68.78,0.688,0.643,0.578
107141,2010,322,175,147,180,82,98,56,0.56,0.559,0.558
107512,2010,450,243,207,264,102,162,66.67,0.667,0.587,0.493
107558,2010,204,114,90,61,28,33,28.95,0.29,0.299,0.311
110097,2010,877,560,317,471,159,312,55.71,0.557,0.537,0.502
110404,2010,220,87,133,179,105,74,85.06,0.851,0.814,0.789
110422,2010,3459,1642,1817,1634,636,998,60.78,0.608,0.472,0.35
110486,2010,1013,613,400,148,50,98,15.99,0.16,0.146,0.125
110495,2010,998,670,328,156,41,115,17.16,0.172,0.156,0.125
110510,2010,1747,1114,633,251,73,178,15.98,0.16,0.144,0.115
110529,2010,1923,835,1088,352,150,202,24.19,0.242,0.183,0.138
110538,2010,1880,1048,832,484,160,324,30.92,0.309,0.257,0.192
110547,2010,982,633,349,50,17,33,5.21,0.052,0.051,0.049
110556,2010,2582,1551,1031,420,116,304,19.6,0.196,0.163,0.113
110565,2010,3749,2160,1589,660,173,487,22.55,0.226,0.176,0.109
110574,2010,1192,751,441,168,47,121,16.11,0.161,0.141,0.107
110583,2010,3913,2310,1603,585,189,396,17.14,0.171,0.15,0.118
110592,2010,2013,1222,791,127,48,79,6.46,0.065,0.063,0.061
110617,2010,2625,1548,1077,238,69,169,10.92,0.109,0.091,0.064
113698,2010,338,255,83,192,45,147,57.65,0.577,0.568,0.542
115755,2010,1282,701,581,188,65,123,17.55,0.176,0.147,0.112
119173,2010,525,507,18,140,3,137,27.02,0.27,0.267,0.167
120184,2010,145,94,51,50,15,35,37.23,0.372,0.345,0.294
121309,2010,588,360,228,367,130,237,65.83,0.658,0.624,0.57
121345,2010,401,217,184,369,169,200,92.17,0.922,0.92,0.918
122409,2010,3031,1802,1229,1017,352,665,36.9,0.369,0.336,0.286
122436,2010,1148,662,486,752,280,472,71.3,0.713,0.655,0.576
122597,2010,3609,2179,1430,648,210,438,20.1,0.201,0.18,0.147
122612,2010,1171,750,421,721,233,488,65.07,0.651,0.616,0.553
122931,2010,1295,644,651,1056,498,558,86.65,0.867,0.815,0.765
123554,2010,694,421,273,387,139,248,58.91,0.589,0.558,0.509
123572,2010,1547,925,622,430,106,324,35.03,0.35,0.278,0.17
126562,2010,1020,551,469,210,76,134,24.32,0.243,0.206,0.162
126580,2010,1123,568,555,284,112,172,30.28,0.303,0.253,0.202
126614,2010,5138,2403,2735,2438,1094,1344,55.93,0.559,0.475,0.4
126818,2010,4321,2414,1907,1820,656,1164,48.22,0.482,0.421,0.344
127060,2010,1215,663,552,806,320,486,73.3,0.733,0.663,0.58
127185,2010,830,393,437,203,74,129,32.82,0.328,0.245,0.169
127565,2010,1876,916,960,112,43,69,7.53,0.075,0.06,0.045
127741,2010,2221,1420,801,653,183,470,33.1,0.331,0.294,0.228
128106,2010,977,467,510,182,80,102,21.84,0.218,0.186,0.157
128744,2010,594,397,197,122,41,81,20.4,0.204,0.205,0.208
128771,2010,1340,592,748,279,125,154,26.01,0.26,0.208,0.167
129020,2010,3317,1629,1688,2300,1076,1224,75.14,0.751,0.693,0.637
129242,2010,921,576,345,722,250,472,81.94,0.819,0.784,0.725
129941,2010,1005,534,471,452,198,254,47.57,0.476,0.45,0.42
130253,2010,974,610,364,529,167,362,59.34,0.593,0.543,0.459
130314,2010,229,229,0,137,0,137,59.83,0.598,0.598,NA
130493,2010,1248,792,456,299,58,241,30.43,0.304,0.24,0.127
130590,2010,591,300,291,473,223,250,83.33,0.833,0.8,0.766
130697,2010,748,411,337,652,292,360,87.59,0.876,0.872,0.866
130776,2010,975,524,451,209,85,124,23.66,0.237,0.214,0.188
130794,2010,1343,696,647,1161,547,614,88.22,0.882,0.864,0.845
130934,2010,887,556,331,220,58,162,29.14,0.291,0.248,0.175
130943,2010,3719,2116,1603,2399,913,1486,70.23,0.702,0.645,0.57
131159,2010,1498,911,587,1145,438,707,77.61,0.776,0.764,0.746
131283,2010,991,576,415,613,240,373,64.76,0.648,0.619,0.578
131450,2010,198,107,91,39,10,29,27.1,0.271,0.197,0.11
131469,2010,2376,1316,1060,1805,761,1044,79.33,0.793,0.76,0.718
131496,2010,1569,859,710,1414,623,791,92.08,0.921,0.901,0.877
131520,2010,1464,1034,430,571,122,449,43.42,0.434,0.39,0.284
132471,2010,625,403,222,98,32,66,16.38,0.164,0.157,0.144
132602,2010,924,579,345,132,32,100,17.27,0.173,0.143,0.093
132903,2010,6028,3179,2849,2407,859,1548,48.69,0.487,0.399,0.302
133492,2010,496,300,196,304,117,187,62.33,0.623,0.613,0.597
133553,2010,949,120,829,283,239,44,36.67,0.367,0.298,0.288
133650,2010,2701,1636,1065,331,94,237,14.49,0.145,0.123,0.088
133669,2010,2616,1359,1257,501,169,332,24.43,0.244,0.192,0.134
133711,2010,612,347,265,281,98,183,52.74,0.527,0.459,0.37
133881,2010,489,138,351,220,142,78,56.52,0.565,0.45,0.405
133951,2010,3752,2079,1673,931,280,651,31.31,0.313,0.248,0.167
134079,2010,602,357,245,314,119,195,54.62,0.546,0.522,0.486
134097,2010,5957,3515,2442,3620,1249,2371,67.45,0.674,0.608,0.511
134130,2010,6345,3661,2684,4275,1469,2806,76.65,0.767,0.674,0.547
134945,2010,624,313,311,197,87,110,35.14,0.351,0.316,0.28
135726,2010,2105,1072,1033,1465,646,819,76.4,0.764,0.696,0.625
136172,2010,1926,1078,848,504,137,367,34.04,0.34,0.262,0.162
136950,2010,465,286,179,298,100,198,69.23,0.692,0.641,0.559
137546,2010,545,331,214,305,109,196,59.21,0.592,0.56,0.509
138354,2010,1211,661,550,325,118,207,31.32,0.313,0.268,0.215
138716,2010,883,542,341,47,13,34,6.27,0.063,0.053,0.038
138789,2010,1161,685,476,141,41,100,14.6,0.146,0.121,0.086
139144,2010,653,431,222,386,126,260,60.32,0.603,0.591,0.568
139366,2010,1154,718,436,130,43,87,12.12,0.121,0.113,0.099
139393,2010,269,131,138,160,66,94,71.76,0.718,0.595,0.478
139658,2010,1321,748,573,1125,462,663,88.64,0.886,0.852,0.806
139719,2010,840,487,353,69,26,43,8.83,0.088,0.082,0.074
139755,2010,2706,976,1730,1111,648,463,47.44,0.474,0.411,0.375
139764,2010,473,284,189,64,13,51,17.96,0.18,0.135,0.069
139861,2010,1202,767,435,505,138,367,47.85,0.479,0.42,0.317
139931,2010,3597,1785,1812,950,305,645,36.13,0.361,0.264,0.168
139940,2010,2853,1540,1313,669,240,429,27.86,0.279,0.234,0.183
139959,2010,4667,2886,1781,2903,961,1942,67.29,0.673,0.622,0.54
140447,2010,596,301,295,293,116,177,58.8,0.588,0.492,0.393
140960,2010,953,504,449,81,19,62,12.3,0.123,0.085,0.042
140988,2010,446,216,230,121,48,73,33.8,0.338,0.271,0.209
141185,2010,153,78,75,54,16,38,48.72,0.487,0.353,0.213
141264,2010,2528,1554,974,401,100,301,19.37,0.194,0.159,0.103
141334,2010,1844,1124,720,309,79,230,20.46,0.205,0.168,0.11
141486,2010,287,203,84,101,29,72,35.47,0.355,0.352,0.345
141565,2010,392,230,162,43,13,30,13.04,0.13,0.11,0.08
141574,2010,1776,984,792,439,164,275,27.95,0.28,0.247,0.207
142276,2010,1432,749,683,121,34,87,11.62,0.116,0.084,0.05
142285,2010,1709,799,910,511,226,285,35.67,0.357,0.299,0.248
142461,2010,253,151,102,78,30,48,31.79,0.318,0.308,0.294
143084,2010,753,432,321,532,206,326,75.46,0.755,0.707,0.642
143288,2010,150,105,45,46,9,37,35.24,0.352,0.307,0.2
144005,2010,523,354,169,14,2,12,3.39,0.034,0.027,0.012
144281,2010,2209,1252,957,665,258,407,32.51,0.325,0.301,0.27
144740,2010,2235,1307,928,1313,501,812,62.13,0.621,0.587,0.54
144892,2010,1446,892,554,492,157,335,37.56,0.376,0.34,0.283
144962,2010,537,330,207,301,99,202,61.21,0.612,0.561,0.478
144971,2010,174,92,82,70,30,40,43.48,0.435,0.402,0.366
145600,2010,3185,1731,1454,984,387,597,34.49,0.345,0.309,0.266
145619,2010,548,311,237,197,63,134,43.09,0.431,0.359,0.266
145637,2010,6921,3054,3867,4823,2414,2409,78.88,0.789,0.697,0.624
145691,2010,225,113,112,134,58,76,67.26,0.673,0.596,0.518
145813,2010,3179,1914,1265,1512,499,1013,52.93,0.529,0.476,0.394
146481,2010,402,238,164,258,98,160,67.23,0.672,0.642,0.598
146612,2010,632,319,313,257,126,131,41.07,0.411,0.407,0.403
146719,2010,2063,1315,748,1342,444,898,68.29,0.683,0.651,0.594
146825,2010,90,39,51,10,4,6,15.38,0.154,0.111,0.078
147013,2010,335,154,181,121,54,67,43.51,0.435,0.361,0.298
147244,2010,498,258,240,244,101,143,55.43,0.554,0.49,0.421
147341,2010,355,187,168,168,73,95,50.8,0.508,0.473,0.435
147703,2010,2663,1338,1325,625,278,347,25.93,0.259,0.235,0.21
147767,2010,2126,1125,1001,1785,790,995,88.44,0.884,0.84,0.789
147776,2010,976,551,425,37,11,26,4.72,0.047,0.038,0.026
147828,2010,740,417,323,344,128,216,51.8,0.518,0.465,0.396
148131,2010,272,136,136,94,44,50,36.76,0.368,0.346,0.324
148496,2010,427,287,140,212,60,152,52.96,0.53,0.496,0.429
148584,2010,210,131,79,93,29,64,48.85,0.489,0.443,0.367
148627,2010,488,308,180,153,41,112,36.36,0.364,0.314,0.228
149222,2010,2314,1104,1210,602,283,319,28.89,0.289,0.26,0.234
149231,2010,2022,1104,918,520,196,324,29.35,0.294,0.257,0.214
149772,2010,1741,886,855,534,265,269,30.36,0.304,0.307,0.31
149781,2010,602,312,290,495,226,269,86.22,0.862,0.822,0.779
150066,2010,469,264,205,230,79,151,57.2,0.572,0.49,0.385
150136,2010,3849,2123,1726,1588,560,1028,48.42,0.484,0.413,0.324
150145,2010,269,169,100,144,51,93,55.03,0.55,0.535,0.51
150163,2010,1049,616,433,600,211,389,63.15,0.631,0.572,0.487
150400,2010,608,345,263,474,202,272,78.84,0.788,0.78,0.768
150534,2010,683,403,280,398,136,262,65.01,0.65,0.583,0.486
150668,2010,179,106,73,100,39,61,57.55,0.576,0.559,0.534
150941,2010,263,146,117,144,62,82,56.16,0.562,0.548,0.53
151102,2010,2117,1078,1039,134,47,87,8.07,0.081,0.063,0.045
151111,2010,2679,1607,1072,478,176,302,18.79,0.188,0.178,0.164
151306,2010,2041,1179,862,378,115,263,22.31,0.223,0.185,0.133
151324,2010,2687,1352,1335,497,199,298,22.04,0.22,0.185,0.149
151333,2010,345,217,128,59,23,36,16.59,0.166,0.171,0.18
151342,2010,895,503,392,61,25,36,7.16,0.072,0.068,0.064
151351,2010,6977,3659,3318,4165,1805,2360,64.5,0.645,0.597,0.544
151360,2010,784,495,289,47,13,34,6.87,0.069,0.06,0.045
151379,2010,945,581,364,111,29,82,14.11,0.141,0.117,0.08
151388,2010,378,224,154,54,15,39,17.41,0.174,0.143,0.097
151777,2010,405,217,188,200,81,119,54.84,0.548,0.494,0.431
151786,2010,317,166,151,124,49,75,45.18,0.452,0.391,0.325
152080,2010,2056,966,1090,1846,966,880,91.1,0.911,0.898,0.886
152248,2010,965,484,481,101,48,53,10.95,0.11,0.105,0.1
152363,2010,257,120,137,111,43,68,56.67,0.567,0.432,0.314
152530,2010,467,270,197,308,112,196,72.59,0.726,0.66,0.569
152600,2010,691,360,331,376,148,228,63.33,0.633,0.544,0.447
153001,2010,265,139,126,117,43,74,53.24,0.532,0.442,0.341
153108,2010,402,212,190,235,99,136,64.15,0.642,0.585,0.521
153269,2010,864,474,390,513,218,295,62.24,0.622,0.594,0.559
153384,2010,415,231,184,336,140,196,84.85,0.848,0.81,0.761
153603,2010,4518,2077,2441,2006,847,1159,55.8,0.558,0.444,0.347
153834,2010,611,342,269,438,177,261,76.32,0.763,0.717,0.658
154095,2010,1934,1214,720,759,229,530,43.66,0.437,0.392,0.318
155089,2010,199,90,109,42,17,25,27.78,0.278,0.211,0.156
155317,2010,3489,1743,1746,1435,603,832,47.73,0.477,0.411,0.345
155335,2010,196,118,78,69,23,46,38.98,0.39,0.352,0.295
155399,2010,3465,1753,1712,1068,416,652,37.19,0.372,0.308,0.243
155520,2010,232,120,112,100,36,64,53.33,0.533,0.431,0.321
155627,2010,156,66,90,37,12,25,37.88,0.379,0.237,0.133
155937,2010,149,70,79,50,21,29,41.43,0.414,0.336,0.266
156213,2010,285,187,98,149,51,98,52.41,0.524,0.523,0.52
156286,2010,573,362,211,301,107,194,53.59,0.536,0.525,0.507
156295,2010,429,230,199,204,72,132,57.39,0.574,0.476,0.362
156365,2010,502,247,255,122,46,76,30.77,0.308,0.243,0.18
156541,2010,446,202,244,144,66,78,38.61,0.386,0.323,0.27
156745,2010,336,191,145,172,57,115,60.21,0.602,0.512,0.393
157058,2010,569,316,253,25,8,17,5.38,0.054,0.044,0.032
157076,2010,202,96,106,64,26,38,39.58,0.396,0.317,0.245
157085,2010,4270,2203,2067,1625,615,1010,45.85,0.458,0.381,0.298
157289,2010,2507,1266,1241,696,308,388,30.65,0.306,0.278,0.248
157386,2010,1175,662,513,294,118,176,26.59,0.266,0.25,0.23
157401,2010,1363,830,533,344,104,240,28.92,0.289,0.252,0.195
157447,2010,2230,1238,992,321,116,205,16.56,0.166,0.144,0.117
157535,2010,393,154,239,56,22,34,22.08,0.221,0.142,0.092
157951,2010,3279,1865,1414,747,228,519,27.83,0.278,0.228,0.161
158477,2010,192,104,88,81,29,52,50,0.5,0.422,0.33
159009,2010,706,384,322,183,63,120,31.25,0.312,0.259,0.196
159391,2010,5477,2904,2573,2145,777,1368,47.11,0.471,0.392,0.302
159647,2010,1530,679,851,504,220,284,41.83,0.418,0.329,0.259
159717,2010,1259,756,503,261,84,177,23.41,0.234,0.207,0.167
159966,2010,1048,652,396,201,63,138,21.17,0.212,0.192,0.159
160038,2010,1056,678,378,213,60,153,22.57,0.226,0.202,0.159
160612,2010,2414,1408,1006,408,133,275,19.53,0.195,0.169,0.132
160621,2010,852,488,364,60,18,42,8.61,0.086,0.07,0.049
160658,2010,2914,1629,1285,465,141,324,19.89,0.199,0.16,0.11
161004,2010,507,249,258,453,230,223,89.56,0.896,0.893,0.891
161226,2010,555,352,203,242,68,174,49.43,0.494,0.436,0.335
161235,2010,153,94,59,27,6,21,22.34,0.223,0.176,0.102
161244,2010,105,61,44,18,6,12,19.67,0.197,0.171,0.136
161253,2010,1713,828,885,622,283,339,40.94,0.409,0.363,0.32
161554,2010,763,394,369,104,43,61,15.48,0.155,0.136,0.117
162007,2010,608,353,255,73,17,56,15.86,0.159,0.12,0.067
162210,2010,123,83,40,21,2,19,22.89,0.229,0.171,0.05
162283,2010,511,357,154,29,7,22,6.16,0.062,0.057,0.045
162584,2010,1028,472,556,223,93,130,27.54,0.275,0.217,0.167
162654,2010,388,259,129,185,50,135,52.12,0.521,0.477,0.388
162760,2010,327,210,117,165,52,113,53.81,0.538,0.505,0.444
162928,2010,1322,646,676,1150,577,573,88.7,0.887,0.87,0.854
163046,2010,1019,630,389,818,311,507,80.48,0.805,0.803,0.799
163268,2010,1484,599,885,558,275,283,47.25,0.473,0.376,0.311
163286,2010,3930,1856,2074,2700,1314,1386,74.68,0.747,0.687,0.634
163453,2010,1208,663,545,115,32,83,12.52,0.125,0.095,0.059
163462,2010,424,241,183,275,101,174,72.2,0.722,0.649,0.552
163851,2010,1248,770,478,595,176,419,54.42,0.544,0.477,0.368
163912,2010,443,277,166,289,96,193,69.68,0.697,0.652,0.578
164076,2010,2427,1593,834,1125,310,815,51.16,0.512,0.464,0.372
164173,2010,877,535,342,331,98,233,43.55,0.436,0.377,0.287
164216,2010,421,238,183,293,109,184,77.31,0.773,0.696,0.596
164270,2010,408,213,195,250,93,157,73.71,0.737,0.613,0.477
164447,2010,367,168,199,107,47,60,35.71,0.357,0.292,0.236
164492,2010,287,140,147,95,43,52,37.14,0.371,0.331,0.293
164562,2010,590,369,221,423,141,282,76.42,0.764,0.717,0.638
165015,2010,686,370,316,569,247,322,87.03,0.87,0.829,0.782
165024,2010,1431,812,619,458,174,284,34.98,0.35,0.32,0.281
165334,2010,575,328,247,411,172,239,72.87,0.729,0.715,0.696
165662,2010,824,529,295,634,219,415,78.45,0.785,0.769,0.742
165671,2010,528,386,142,318,81,237,61.4,0.614,0.602,0.57
165820,2010,721,413,308,246,86,160,38.74,0.387,0.341,0.279
165866,2010,719,481,238,245,59,186,38.67,0.387,0.341,0.248
165936,2010,348,212,136,212,80,132,62.26,0.623,0.609,0.588
166027,2010,1663,827,836,1434,708,726,87.79,0.878,0.862,0.847
166124,2010,727,379,348,645,298,347,91.56,0.916,0.887,0.856
166513,2010,1601,575,1026,514,272,242,42.09,0.421,0.321,0.265
166629,2010,4543,2296,2247,2986,1336,1650,71.86,0.719,0.657,0.595
166638,2010,1067,595,472,194,55,139,23.36,0.234,0.182,0.117
166683,2010,1063,479,584,898,478,420,87.68,0.877,0.845,0.818
167288,2010,351,225,126,133,41,92,40.89,0.409,0.379,0.325
167987,2010,1667,765,902,471,208,263,34.38,0.344,0.283,0.231
167996,2010,727,469,258,556,180,376,80.17,0.802,0.765,0.698
168005,2010,1307,739,568,582,221,361,48.85,0.489,0.445,0.389
168148,2010,1313,649,664,1138,560,578,89.06,0.891,0.867,0.843
168254,2010,736,303,433,373,213,160,52.81,0.528,0.507,0.492
168281,2010,450,306,144,342,103,239,78.1,0.781,0.76,0.715
168342,2010,548,288,260,471,215,256,88.89,0.889,0.859,0.827
168546,2010,383,196,187,235,102,133,67.86,0.679,0.614,0.545
168786,2010,428,255,173,140,53,87,34.12,0.341,0.327,0.306
169080,2010,929,469,460,573,250,323,68.87,0.689,0.617,0.543
169798,2010,1955,1152,803,254,75,179,15.54,0.155,0.13,0.093
169910,2010,1960,976,984,143,59,84,8.61,0.086,0.073,0.06
170082,2010,3414,2084,1330,1165,413,752,36.08,0.361,0.341,0.311
170301,2010,765,455,310,524,185,339,74.51,0.745,0.685,0.597
170532,2010,341,192,149,250,106,144,75,0.75,0.733,0.711
170639,2010,501,229,272,91,54,37,16.16,0.162,0.182,0.199
170976,2010,6443,3217,3226,4929,2317,2612,81.19,0.812,0.765,0.718
171100,2010,7221,3821,3400,3685,1516,2169,56.77,0.568,0.51,0.446
171128,2010,1110,273,837,308,202,106,38.83,0.388,0.277,0.241
171137,2010,883,429,454,149,51,98,22.84,0.228,0.169,0.112
171146,2010,724,398,326,94,34,60,15.08,0.151,0.13,0.104
171599,2010,229,93,136,80,35,45,48.39,0.484,0.349,0.257
172051,2010,1729,1013,716,196,51,145,14.31,0.143,0.113,0.071
172699,2010,3346,1734,1612,721,259,462,26.64,0.266,0.215,0.161
173160,2010,604,366,238,408,146,262,71.58,0.716,0.675,0.613
173258,2010,511,268,243,451,209,242,90.3,0.903,0.883,0.86
173328,2010,217,126,91,81,19,62,49.21,0.492,0.373,0.209
173647,2010,585,314,271,454,208,246,78.34,0.783,0.776,0.768
173902,2010,515,314,201,434,158,276,87.9,0.879,0.843,0.786
174066,2010,5310,2810,2500,3251,1428,1823,64.88,0.649,0.612,0.571
174233,2010,2316,1112,1204,819,356,463,41.64,0.416,0.354,0.296
174251,2010,418,242,176,211,81,130,53.72,0.537,0.505,0.46
174491,2010,451,247,204,219,89,130,52.63,0.526,0.486,0.436
174792,2010,503,0,503,360,360,0,NA,NA,0.716,0.716
174844,2010,844,434,410,719,332,387,89.17,0.892,0.852,0.81
174899,2010,575,358,217,328,100,228,63.69,0.637,0.57,0.461
174914,2010,1518,762,756,941,396,545,71.52,0.715,0.62,0.524
175342,2010,588,341,247,94,25,69,20.23,0.202,0.16,0.101
175421,2010,234,126,108,65,17,48,38.1,0.381,0.278,0.157
175616,2010,370,208,162,61,25,36,17.31,0.173,0.165,0.154
175856,2010,879,489,390,169,52,117,23.93,0.239,0.192,0.133
175980,2010,211,106,105,145,69,76,71.7,0.717,0.687,0.657
176017,2010,3065,1580,1485,1135,440,695,43.99,0.44,0.37,0.296
176035,2010,199,154,45,50,7,43,27.92,0.279,0.251,0.156
176044,2010,382,192,190,68,25,43,22.4,0.224,0.178,0.132
176080,2010,2688,1308,1380,847,348,499,38.15,0.382,0.315,0.252
176406,2010,198,126,72,50,10,40,31.75,0.318,0.253,0.139
176628,2010,166,94,72,46,11,35,37.23,0.372,0.277,0.153
176947,2010,314,147,167,109,33,76,51.7,0.517,0.347,0.198
176965,2010,1546,862,684,496,176,320,37.12,0.371,0.321,0.257
177418,2010,151,77,74,53,21,32,41.56,0.416,0.351,0.284
178059,2010,338,242,96,192,49,143,59.09,0.591,0.568,0.51
178341,2010,844,439,405,88,35,53,12.07,0.121,0.104,0.086
178387,2010,1083,559,524,145,55,90,16.1,0.161,0.134,0.105
178396,2010,5996,3175,2821,2641,963,1678,52.85,0.528,0.44,0.341
178402,2010,1109,673,436,246,92,154,22.88,0.229,0.222,0.211
178411,2010,1138,250,888,246,166,80,32,0.32,0.216,0.187
178420,2010,479,282,197,141,51,90,31.91,0.319,0.294,0.259
178615,2010,1416,881,535,800,260,540,61.29,0.613,0.565,0.486
179043,2010,370,232,138,228,79,149,64.22,0.642,0.616,0.572
179159,2010,1724,1004,720,1063,381,682,67.93,0.679,0.617,0.529
179557,2010,1813,1097,716,526,165,361,32.91,0.329,0.29,0.23
179566,2010,2645,1574,1071,796,266,530,33.67,0.337,0.301,0.248
179867,2010,1619,776,843,1430,716,714,92.01,0.92,0.883,0.849
179894,2010,413,238,175,187,67,120,50.42,0.504,0.453,0.383
179946,2010,315,139,176,175,75,100,71.94,0.719,0.556,0.426
180179,2010,829,434,395,44,11,33,7.6,0.076,0.053,0.028
180461,2010,2115,877,1238,502,219,283,32.27,0.323,0.237,0.177
180522,2010,226,78,148,16,10,6,7.69,0.077,0.071,0.068
180984,2010,276,139,137,138,57,81,58.27,0.583,0.5,0.416
181002,2010,1010,606,404,676,248,428,70.63,0.706,0.669,0.614
181020,2010,327,179,148,163,52,111,62.01,0.62,0.498,0.351
181127,2010,312,150,162,144,66,78,52,0.52,0.462,0.407
181215,2010,1124,656,468,305,96,209,31.86,0.319,0.271,0.205
181394,2010,1703,925,778,14,8,6,0.65,0.007,0.008,0.01
181446,2010,427,237,190,256,106,150,63.29,0.633,0.6,0.558
181464,2010,4039,1889,2150,1461,647,814,43.09,0.431,0.362,0.301
181534,2010,243,117,126,32,6,26,22.22,0.222,0.132,0.048
181783,2010,677,366,311,172,58,114,31.15,0.312,0.254,0.186
182281,2010,2923,1621,1302,341,117,224,13.82,0.138,0.117,0.09
182290,2010,2693,1430,1263,610,233,377,26.36,0.264,0.227,0.184
182634,2010,393,266,127,185,51,134,50.38,0.504,0.471,0.402
182795,2010,399,179,220,142,50,92,51.4,0.514,0.356,0.227
183062,2010,1201,718,483,643,252,391,54.46,0.545,0.535,0.522
183080,2010,1056,520,536,456,186,270,51.92,0.519,0.432,0.347
183239,2010,535,295,240,369,142,227,76.95,0.77,0.69,0.592
183822,2010,379,225,154,44,22,22,9.78,0.098,0.116,0.143
183974,2010,252,144,108,115,35,80,55.56,0.556,0.456,0.324
184348,2010,494,311,183,280,96,184,59.16,0.592,0.567,0.525
184603,2010,694,400,294,133,48,85,21.25,0.212,0.192,0.163
184612,2010,324,236,88,66,21,45,19.07,0.191,0.204,0.239
184782,2010,1485,715,770,713,320,393,54.97,0.55,0.48,0.416
185129,2010,681,380,301,45,21,24,6.32,0.063,0.066,0.07
185572,2010,962,579,383,532,196,336,58.03,0.58,0.553,0.512
185590,2010,2169,1248,921,850,304,546,43.75,0.438,0.392,0.33
185828,2010,828,187,641,209,141,68,36.36,0.364,0.252,0.22
186131,2010,1311,649,662,1169,572,597,91.99,0.92,0.892,0.864
186201,2010,893,522,371,547,188,359,68.77,0.688,0.613,0.507
186283,2010,1007,601,406,585,227,358,59.57,0.596,0.581,0.559
186584,2010,1302,728,574,708,288,420,57.69,0.577,0.544,0.502
186876,2010,858,518,340,433,137,296,57.14,0.571,0.505,0.403
187134,2010,1421,800,621,1065,443,622,77.75,0.777,0.749,0.713
187444,2010,1509,774,735,443,160,283,36.56,0.366,0.294,0.218
187985,2010,3488,1951,1537,574,204,370,18.96,0.19,0.165,0.133
188030,2010,2255,1181,1074,381,151,230,19.48,0.195,0.169,0.141
188429,2010,909,634,275,521,133,388,61.2,0.612,0.573,0.484
188641,2010,526,240,286,225,91,134,55.83,0.558,0.428,0.318
190044,2010,712,182,530,399,279,120,65.93,0.659,0.56,0.526
190099,2010,849,466,383,721,312,409,87.77,0.878,0.849,0.815
190150,2010,1392,676,716,1188,595,593,87.72,0.877,0.853,0.831
190248,2010,138,76,62,62,22,40,52.63,0.526,0.449,0.355
190415,2010,3172,1579,1593,2763,1325,1438,91.07,0.911,0.871,0.832
190512,2010,1255,527,728,483,242,241,45.73,0.457,0.385,0.332
190549,2010,1143,661,482,284,95,189,28.59,0.286,0.248,0.197
190558,2010,2237,1184,1053,146,52,94,7.94,0.079,0.065,0.049
190567,2010,1368,685,683,171,58,113,16.5,0.165,0.125,0.085
190594,2010,1740,1141,599,413,100,313,27.43,0.274,0.237,0.167
190637,2010,619,386,233,116,33,83,21.5,0.215,0.187,0.142
190664,2010,1471,821,650,452,133,319,38.86,0.389,0.307,0.205
190691,2010,1085,652,433,71,16,55,8.44,0.084,0.065,0.037
190725,2010,441,325,116,148,36,112,34.46,0.345,0.336,0.31
191241,2010,1865,1021,844,1388,607,781,76.49,0.765,0.744,0.719
191515,2010,467,252,215,414,185,229,90.87,0.909,0.887,0.86
191533,2010,487,270,217,241,104,137,50.74,0.507,0.495,0.479
191630,2010,618,339,279,448,182,266,78.47,0.785,0.725,0.652
191649,2010,1435,819,616,764,289,475,58,0.58,0.532,0.469
191676,2010,253,178,75,154,46,108,60.67,0.607,0.609,0.613
191931,2010,871,504,367,525,202,323,64.09,0.641,0.603,0.55
191968,2010,1614,869,745,1071,442,629,72.38,0.724,0.664,0.593
192192,2010,270,196,74,141,32,109,55.61,0.556,0.522,0.432
192323,2010,615,372,243,355,130,225,60.48,0.605,0.577,0.535
192439,2010,883,618,265,58,13,45,7.28,0.073,0.066,0.049
192703,2010,658,300,358,375,190,185,61.67,0.617,0.57,0.531
192749,2010,428,274,154,181,57,124,45.26,0.453,0.423,0.37
192819,2010,1088,612,476,814,331,483,78.92,0.789,0.748,0.695
192925,2010,377,234,143,112,46,66,28.21,0.282,0.297,0.322
193016,2010,1086,708,378,212,45,167,23.59,0.236,0.195,0.119
193292,2010,387,257,130,180,59,121,47.08,0.471,0.465,0.454
193353,2010,443,301,142,187,60,127,42.19,0.422,0.422,0.423
193399,2010,377,249,128,147,41,106,42.57,0.426,0.39,0.32
193584,2010,467,353,114,273,60,213,60.34,0.603,0.585,0.526
193645,2010,635,566,69,140,10,130,22.97,0.23,0.22,0.145
193654,2010,1166,859,307,603,139,464,54.02,0.54,0.517,0.453
193900,2010,5434,3100,2334,3417,1477,1940,62.58,0.626,0.629,0.633
193973,2010,668,377,291,397,163,234,62.07,0.621,0.594,0.56
194161,2010,314,181,133,67,28,39,21.55,0.216,0.213,0.211
194310,2010,1766,1089,677,696,240,456,41.87,0.419,0.394,0.355
194824,2010,1152,322,830,703,494,209,64.91,0.649,0.61,0.595
195003,2010,2583,820,1763,699,346,353,43.05,0.43,0.271,0.196
195030,2010,1305,641,664,120,69,51,7.96,0.08,0.092,0.104
195164,2010,494,242,252,257,116,141,58.26,0.583,0.52,0.46
195173,2010,559,289,270,151,65,86,29.76,0.298,0.27,0.241
195216,2010,609,316,293,492,227,265,83.86,0.839,0.808,0.775
195234,2010,639,432,207,313,83,230,53.24,0.532,0.49,0.401
195243,2010,290,173,117,123,40,83,47.98,0.48,0.424,0.342
195304,2010,338,238,100,249,68,181,76.05,0.76,0.737,0.68
195474,2010,768,410,358,539,228,311,75.85,0.758,0.702,0.637
195526,2010,768,485,283,653,225,428,88.25,0.883,0.85,0.795
195544,2010,697,498,199,403,102,301,60.44,0.604,0.578,0.513
195809,2010,3105,1626,1479,1117,500,617,37.95,0.38,0.36,0.338
196413,2010,3452,1929,1523,2379,962,1417,73.46,0.735,0.689,0.632
196592,2010,1030,668,362,152,21,131,19.61,0.196,0.148,0.058
197045,2010,564,281,283,190,83,107,38.08,0.381,0.337,0.293
197133,2010,665,382,283,576,242,334,87.43,0.874,0.866,0.855
197869,2010,2816,1538,1278,1387,500,887,57.67,0.577,0.493,0.391
197984,2010,307,139,168,103,53,50,35.97,0.36,0.336,0.315
198385,2010,499,246,253,452,223,229,93.09,0.931,0.906,0.881
198464,2010,4196,2446,1750,1417,448,969,39.62,0.396,0.338,0.256
198507,2010,573,319,254,94,31,63,19.75,0.198,0.164,0.122
198516,2010,1359,794,565,1041,386,655,82.49,0.825,0.766,0.683
198835,2010,423,229,194,149,53,96,41.92,0.419,0.352,0.273
198969,2010,531,190,341,104,46,58,30.53,0.305,0.196,0.135
199102,2010,2040,1065,975,374,108,266,24.98,0.25,0.183,0.111
199111,2010,590,335,255,231,87,144,42.99,0.43,0.392,0.341
199120,2010,3944,2371,1573,3299,1235,2064,87.05,0.87,0.836,0.785
199139,2010,2947,1513,1434,840,312,528,34.9,0.349,0.285,0.218
199148,2010,2505,1722,783,762,162,600,34.84,0.348,0.304,0.207
199157,2010,1218,809,409,238,56,182,22.5,0.225,0.195,0.137
199193,2010,4685,2098,2587,2187,962,1225,58.39,0.584,0.467,0.372
199218,2010,1985,1236,749,1044,320,724,58.58,0.586,0.526,0.427
199281,2010,1036,582,454,209,74,135,23.2,0.232,0.202,0.163
199306,2010,199,88,111,67,31,36,40.91,0.409,0.337,0.279
199412,2010,349,252,97,162,38,124,49.21,0.492,0.464,0.392
199582,2010,440,196,244,78,25,53,27.04,0.27,0.177,0.102
199643,2010,679,360,319,54,23,31,8.61,0.086,0.08,0.072
199847,2010,1217,639,578,1019,462,557,87.17,0.872,0.837,0.799
199962,2010,605,336,269,267,95,172,51.19,0.512,0.441,0.353
199999,2010,690,465,225,139,25,114,24.52,0.245,0.201,0.111
200004,2010,1415,746,669,520,196,324,43.43,0.434,0.367,0.293
200059,2010,307,146,161,33,14,19,13.01,0.13,0.107,0.087
200156,2010,202,98,104,72,27,45,45.92,0.459,0.356,0.26
200217,2010,362,203,159,138,38,100,49.26,0.493,0.381,0.239
200226,2010,130,54,76,17,10,7,12.96,0.13,0.131,0.132
200253,2010,461,298,163,83,10,73,24.5,0.245,0.18,0.061
200280,2010,2073,978,1095,527,237,290,29.65,0.296,0.254,0.216
200332,2010,2373,1074,1299,635,297,338,31.47,0.315,0.268,0.229
200572,2010,217,95,122,45,22,23,24.21,0.242,0.207,0.18
201104,2010,688,407,281,345,115,230,56.51,0.565,0.501,0.409
201371,2010,219,91,128,96,45,51,56.04,0.56,0.438,0.352
201548,2010,715,409,306,381,167,214,52.32,0.523,0.533,0.546
201645,2010,1019,415,604,655,356,299,72.05,0.721,0.643,0.589
201690,2010,503,231,272,49,18,31,13.42,0.134,0.097,0.066
202134,2010,1148,615,533,237,105,132,21.46,0.215,0.206,0.197
202480,2010,2029,995,1034,1187,506,681,68.44,0.684,0.585,0.489
202523,2010,623,349,274,482,199,283,81.09,0.811,0.774,0.726
202763,2010,659,461,198,338,95,243,52.71,0.527,0.513,0.48
203085,2010,334,158,176,137,57,80,50.63,0.506,0.41,0.324
203128,2010,295,157,138,160,65,95,60.51,0.605,0.542,0.471
203368,2010,703,380,323,460,189,271,71.32,0.713,0.654,0.585
203517,2010,3887,2325,1562,1243,396,847,36.43,0.364,0.32,0.254
203535,2010,483,265,218,429,191,238,89.81,0.898,0.888,0.876
203580,2010,256,123,133,78,28,50,40.65,0.406,0.305,0.211
203775,2010,375,196,179,167,68,99,50.51,0.505,0.445,0.38
203845,2010,387,191,196,199,85,114,59.69,0.597,0.514,0.434
204024,2010,3574,1944,1630,2368,969,1399,71.97,0.72,0.663,0.594
204185,2010,630,261,369,333,151,182,69.73,0.697,0.529,0.409
204194,2010,388,240,148,217,83,134,55.83,0.558,0.559,0.561
204617,2010,272,146,126,78,30,48,32.88,0.329,0.287,0.238
204796,2010,6651,3319,3332,3907,1657,2250,67.79,0.678,0.587,0.497
204857,2010,3949,2129,1820,1799,689,1110,52.14,0.521,0.456,0.379
206330,2010,145,68,77,36,17,19,27.94,0.279,0.248,0.221
206589,2010,617,332,285,436,180,256,77.11,0.771,0.707,0.632
206604,2010,2739,1586,1153,527,197,330,20.81,0.208,0.192,0.171
206622,2010,1042,554,488,641,298,343,61.91,0.619,0.615,0.611
206695,2010,2633,1330,1303,250,122,128,9.62,0.096,0.095,0.094
206914,2010,892,520,372,43,21,22,4.23,0.042,0.048,0.056
207209,2010,469,226,243,11,2,9,3.98,0.04,0.023,0.008
207306,2010,382,182,200,51,16,35,19.23,0.192,0.134,0.08
207324,2010,497,247,250,166,77,89,36.03,0.36,0.334,0.308
207388,2010,3403,1761,1642,1320,497,823,46.73,0.467,0.388,0.303
207500,2010,3669,1945,1724,1455,549,906,46.58,0.466,0.397,0.318
207722,2010,199,129,70,54,13,41,31.78,0.318,0.271,0.186
207847,2010,651,344,307,55,20,35,10.17,0.102,0.084,0.065
207865,2010,977,529,448,123,44,79,14.93,0.149,0.126,0.098
208822,2010,488,287,201,275,119,156,54.36,0.544,0.564,0.592
209056,2010,491,306,185,364,125,239,78.1,0.781,0.741,0.676
209065,2010,528,310,218,302,117,185,59.68,0.597,0.572,0.537
209542,2010,3480,1677,1803,1145,447,698,41.62,0.416,0.329,0.248
209551,2010,3911,2065,1846,1953,790,1163,56.32,0.563,0.499,0.428
209612,2010,474,231,243,229,109,120,51.95,0.52,0.483,0.449
209807,2010,1366,733,633,288,123,165,22.51,0.225,0.211,0.194
209922,2010,373,212,161,247,105,142,66.98,0.67,0.662,0.652
210146,2010,735,435,300,176,55,121,27.82,0.278,0.239,0.183
210401,2010,427,235,192,301,119,182,77.45,0.775,0.705,0.62
210429,2010,1039,636,403,204,45,159,25,0.25,0.196,0.112
210571,2010,485,255,230,230,90,140,54.9,0.549,0.474,0.391
210669,2010,594,332,262,415,173,242,72.89,0.729,0.699,0.66
210775,2010,388,268,120,142,39,103,38.43,0.384,0.366,0.325
211088,2010,552,397,155,317,75,242,60.96,0.61,0.574,0.484
211158,2010,2136,1263,873,808,251,557,44.1,0.441,0.378,0.288
211291,2010,929,491,438,782,355,427,86.97,0.87,0.842,0.811
211352,2010,339,222,117,174,47,127,57.21,0.572,0.513,0.402
211361,2010,1351,711,640,332,136,196,27.57,0.276,0.246,0.212
211431,2010,189,181,8,76,1,75,41.44,0.414,0.402,0.125
211440,2010,1484,619,865,1119,630,489,79,0.79,0.754,0.728
211468,2010,91,90,1,36,0,36,40,0.4,0.396,0
211556,2010,150,150,0,72,0,72,48,0.48,0.48,NA
211583,2010,219,125,94,82,31,51,40.8,0.408,0.374,0.33
211608,2010,471,258,213,25,5,20,7.75,0.078,0.053,0.023
211644,2010,1309,811,498,430,127,303,37.36,0.374,0.328,0.255
211981,2010,490,297,193,238,66,172,57.91,0.579,0.486,0.342
212009,2010,657,355,302,535,240,295,83.1,0.831,0.814,0.795
212054,2010,2696,1200,1496,735,275,460,38.33,0.383,0.273,0.184
212106,2010,1411,821,590,834,318,516,62.85,0.629,0.591,0.539
212115,2010,1144,658,486,422,137,285,43.31,0.433,0.369,0.282
212133,2010,449,302,147,195,67,128,42.38,0.424,0.434,0.456
212160,2010,1551,927,624,340,103,237,25.57,0.256,0.219,0.165
212197,2010,491,303,188,339,104,235,77.56,0.776,0.69,0.553
212577,2010,629,345,284,525,227,298,86.38,0.864,0.835,0.799
212601,2010,617,362,255,276,100,176,48.62,0.486,0.447,0.392
212832,2010,284,190,94,38,13,25,13.16,0.132,0.134,0.138
212911,2010,325,166,159,281,138,143,86.14,0.861,0.865,0.868
213020,2010,2984,1751,1233,1087,333,754,43.06,0.431,0.364,0.27
213251,2010,421,227,194,303,130,173,76.21,0.762,0.72,0.67
213321,2010,528,240,288,310,150,160,66.67,0.667,0.587,0.521
213349,2010,2009,1175,834,677,217,460,39.15,0.392,0.337,0.26
213358,2010,269,151,118,93,48,45,29.8,0.298,0.346,0.407
213367,2010,982,605,377,524,182,342,56.53,0.565,0.534,0.483
213385,2010,648,294,354,553,279,274,93.2,0.932,0.853,0.788
213507,2010,460,245,215,331,152,179,73.06,0.731,0.72,0.707
213543,2010,1208,516,692,932,495,437,84.69,0.847,0.772,0.715
213613,2010,1185,630,555,361,158,203,32.22,0.322,0.305,0.285
213668,2010,346,211,135,205,67,138,65.4,0.654,0.592,0.496
213783,2010,631,346,285,162,70,92,26.59,0.266,0.257,0.246
213826,2010,452,338,114,241,44,197,58.28,0.583,0.533,0.386
213996,2010,721,433,288,523,210,313,72.29,0.723,0.725,0.729
214041,2010,1315,728,587,494,193,301,41.35,0.414,0.376,0.329
214069,2010,375,265,110,255,62,193,72.83,0.728,0.68,0.564
214157,2010,373,216,157,245,96,149,68.98,0.69,0.657,0.611
214175,2010,603,341,262,485,199,286,83.87,0.839,0.804,0.76
214272,2010,547,350,197,166,48,118,33.71,0.337,0.303,0.244
214777,2010,7321,3542,3779,4942,2239,2703,76.31,0.763,0.675,0.592
215062,2010,2363,1213,1150,1999,917,1082,89.2,0.892,0.846,0.797
215743,2010,429,258,171,243,82,161,62.4,0.624,0.566,0.48
215798,2010,422,202,220,261,113,148,73.27,0.733,0.618,0.514
215929,2010,950,508,442,688,291,397,78.15,0.782,0.724,0.658
216010,2010,1706,888,818,693,275,418,47.07,0.471,0.406,0.336
216038,2010,1562,969,593,808,265,543,56.04,0.56,0.517,0.447
216287,2010,387,195,192,339,169,170,87.18,0.872,0.876,0.88
216339,2010,4305,2273,2032,1920,783,1137,50.02,0.5,0.446,0.385
216524,2010,441,236,205,323,144,179,75.85,0.758,0.732,0.702
216694,2010,401,229,172,213,77,136,59.39,0.594,0.531,0.448
216764,2010,2060,1295,765,946,263,683,52.74,0.527,0.459,0.344
216807,2010,402,248,154,274,99,175,70.56,0.706,0.682,0.643
216852,2010,718,371,347,298,116,182,49.06,0.491,0.415,0.334
216931,2010,499,249,250,240,106,134,53.82,0.538,0.481,0.424
217059,2010,1231,657,574,481,182,299,45.51,0.455,0.391,0.317
217156,2010,1495,784,711,1251,599,652,83.16,0.832,0.837,0.842
217402,2010,1102,633,469,888,383,505,79.78,0.798,0.806,0.817
217536,2010,592,423,169,380,96,284,67.14,0.671,0.642,0.568
217776,2010,153,80,73,77,40,37,46.25,0.462,0.503,0.548
217819,2010,2001,1329,672,1162,325,837,62.98,0.63,0.581,0.484
217882,2010,2977,1498,1479,1755,707,1048,69.96,0.7,0.59,0.478
217998,2010,144,81,63,85,34,51,62.96,0.63,0.59,0.54
218061,2010,737,479,258,130,40,90,18.79,0.188,0.176,0.155
218229,2010,685,476,209,195,44,151,31.72,0.317,0.285,0.211
218238,2010,275,129,146,52,19,33,25.58,0.256,0.189,0.13
218399,2010,319,173,146,19,6,13,7.51,0.075,0.06,0.041
218414,2010,288,110,178,82,41,41,37.27,0.373,0.285,0.23
218663,2010,4421,2431,1990,2400,911,1489,61.25,0.613,0.543,0.458
218724,2010,1996,1087,909,530,181,349,32.11,0.321,0.266,0.199
218733,2010,816,414,402,156,58,98,23.67,0.237,0.191,0.144
218742,2010,838,559,279,200,54,146,26.12,0.261,0.239,0.194
218973,2010,429,202,227,334,173,161,79.7,0.797,0.779,0.762
219000,2010,418,276,142,226,55,171,61.96,0.62,0.541,0.387
219046,2010,648,386,262,105,30,75,19.43,0.194,0.162,0.115
219082,2010,314,113,201,62,43,19,16.81,0.168,0.197,0.214
219198,2010,120,64,56,48,17,31,48.44,0.484,0.4,0.304
219259,2010,380,208,172,84,25,59,28.37,0.284,0.221,0.145
219356,2010,2157,1051,1106,613,270,343,32.64,0.326,0.284,0.244
219471,2010,1034,622,412,313,114,199,31.99,0.32,0.303,0.277
219602,2010,1478,903,575,252,88,164,18.16,0.182,0.171,0.153
219709,2010,1013,581,432,597,247,350,60.24,0.602,0.589,0.572
219718,2010,377,133,244,51,27,24,18.05,0.181,0.135,0.111
219949,2010,163,67,96,56,29,27,40.3,0.403,0.344,0.302
220075,2010,2052,1165,887,406,147,259,22.23,0.222,0.198,0.166
220215,2010,370,214,156,164,62,102,47.66,0.477,0.443,0.397
220613,2010,851,494,357,288,93,195,39.47,0.395,0.338,0.261
220631,2010,352,232,120,115,46,69,29.74,0.297,0.327,0.383
220710,2010,277,126,151,129,53,76,60.32,0.603,0.466,0.351
221351,2010,500,307,193,382,139,243,79.15,0.792,0.764,0.72
221519,2010,401,216,185,317,138,179,82.87,0.829,0.791,0.746
221731,2010,218,142,76,70,20,50,35.21,0.352,0.321,0.263
221847,2010,1898,846,1052,468,177,291,34.4,0.344,0.247,0.168
221892,2010,234,142,92,92,33,59,41.55,0.416,0.393,0.359
222178,2010,977,526,451,465,194,271,51.52,0.515,0.476,0.43
222983,2010,318,173,145,220,90,130,75.14,0.751,0.692,0.621
223232,2010,3254,1913,1341,1897,668,1229,64.24,0.642,0.583,0.498
224004,2010,235,157,78,54,11,43,27.39,0.274,0.23,0.141
224323,2010,375,207,168,223,89,134,64.73,0.647,0.595,0.53
225432,2010,824,453,371,11,3,8,1.77,0.018,0.013,0.008
225548,2010,318,149,169,88,32,56,37.58,0.376,0.277,0.189
225627,2010,871,571,300,257,70,187,32.75,0.328,0.295,0.233
226231,2010,425,169,256,152,85,67,39.64,0.396,0.358,0.332
226833,2010,742,380,362,141,39,102,26.84,0.268,0.19,0.108
227216,2010,3534,1908,1626,1009,345,664,34.8,0.348,0.286,0.212
227331,2010,299,219,80,77,18,59,26.94,0.269,0.258,0.225
227526,2010,1731,1046,685,154,43,111,10.61,0.106,0.089,0.063
227757,2010,944,453,491,783,376,407,89.85,0.898,0.829,0.766
227845,2010,770,505,265,403,122,281,55.64,0.556,0.523,0.46
227863,2010,191,127,64,63,14,49,38.58,0.386,0.33,0.219
228042,2010,253,150,103,106,40,66,44,0.44,0.419,0.388
228149,2010,585,358,227,249,85,164,45.81,0.458,0.426,0.374
228246,2010,1476,786,690,1008,429,579,73.66,0.737,0.683,0.622
228343,2010,383,224,159,252,98,154,68.75,0.688,0.658,0.616
228431,2010,2280,1473,807,556,128,428,29.06,0.291,0.244,0.159
228459,2010,4033,2403,1630,1091,306,785,32.67,0.327,0.271,0.188
228501,2010,322,146,176,42,17,25,17.12,0.171,0.13,0.097
228529,2010,1435,858,577,339,98,241,28.09,0.281,0.236,0.17
228705,2010,1287,539,748,196,70,126,23.38,0.234,0.152,0.094
228723,2010,8033,3862,4171,4175,1709,2466,63.85,0.639,0.52,0.41
228769,2010,2585,1319,1266,549,228,321,24.34,0.243,0.212,0.18
228778,2010,7232,3869,3363,3986,1608,2378,61.46,0.615,0.551,0.478
228787,2010,1346,544,802,680,362,318,58.46,0.585,0.505,0.451
228796,2010,2450,1262,1188,363,134,229,18.15,0.182,0.148,0.113
228875,2010,1824,1104,720,1141,397,744,67.39,0.674,0.626,0.551
228981,2010,338,159,179,102,39,63,39.62,0.396,0.302,0.218
229018,2010,341,180,161,71,29,42,23.33,0.233,0.208,0.18
229027,2010,4811,2243,2568,610,248,362,16.14,0.161,0.127,0.097
229115,2010,4759,2290,2469,1623,645,978,42.71,0.427,0.341,0.261
229780,2010,242,112,130,25,10,15,13.39,0.134,0.103,0.077
229814,2010,1227,637,590,336,102,234,36.73,0.367,0.274,0.173
230603,2010,1103,768,335,232,43,189,24.61,0.246,0.21,0.128
230728,2010,2941,1882,1059,548,113,435,23.11,0.231,0.186,0.107
230764,2010,2269,1217,1052,663,237,426,35,0.35,0.292,0.225
230782,2010,2041,1193,848,196,64,132,11.06,0.111,0.096,0.075
231059,2010,546,294,252,401,168,233,79.25,0.792,0.734,0.667
231174,2010,2452,1425,1027,1523,576,947,66.46,0.665,0.621,0.561
231420,2010,264,98,166,89,36,53,54.08,0.541,0.337,0.217
231554,2010,112,58,54,28,8,20,34.48,0.345,0.25,0.148
231624,2010,1396,791,605,1180,483,697,88.12,0.881,0.845,0.798
231712,2010,1150,673,477,723,250,473,70.28,0.703,0.629,0.524
232025,2010,248,124,124,84,34,50,40.32,0.403,0.339,0.274
232043,2010,206,122,84,96,32,64,52.46,0.525,0.466,0.381
232089,2010,565,243,322,106,49,57,23.46,0.235,0.188,0.152
232186,2010,2577,1324,1253,1198,462,736,55.59,0.556,0.465,0.369
232265,2010,978,605,373,351,87,264,43.64,0.436,0.359,0.233
232423,2010,3995,2482,1513,2599,838,1761,70.95,0.71,0.651,0.554
232557,2010,3438,1874,1564,1005,410,595,31.75,0.318,0.292,0.262
232566,2010,970,667,303,454,93,361,54.12,0.541,0.468,0.307
232609,2010,571,328,243,275,89,186,56.71,0.567,0.482,0.366
232681,2010,950,612,338,586,179,407,66.5,0.665,0.617,0.53
232706,2010,415,295,120,151,36,115,38.98,0.39,0.364,0.3
232937,2010,902,528,374,185,67,118,22.35,0.224,0.205,0.179
232982,2010,2579,1280,1299,666,252,414,32.34,0.323,0.258,0.194
233277,2010,1836,1068,768,783,259,524,49.06,0.491,0.426,0.337
233374,2010,816,452,364,685,286,399,88.27,0.883,0.839,0.786
233426,2010,564,323,241,321,115,206,63.78,0.638,0.569,0.477
233541,2010,414,228,186,164,57,107,46.93,0.469,0.396,0.306
233897,2010,399,197,202,92,33,59,29.95,0.3,0.231,0.163
233921,2010,5193,2158,3035,3130,1587,1543,71.5,0.715,0.603,0.523
234030,2010,3533,2086,1447,1256,445,811,38.88,0.389,0.356,0.308
234085,2010,440,51,389,64,27,37,72.55,0.726,0.145,0.069
234155,2010,1282,802,480,307,64,243,30.3,0.303,0.239,0.133
234164,2010,460,260,200,76,26,50,19.23,0.192,0.165,0.13
235097,2010,1524,887,637,324,109,215,24.24,0.242,0.213,0.171
235167,2010,612,332,280,265,118,147,44.28,0.443,0.433,0.421
236230,2010,687,415,272,398,141,257,61.93,0.619,0.579,0.518
236328,2010,625,355,270,436,168,268,75.49,0.755,0.698,0.622
236577,2010,726,501,225,405,120,285,56.89,0.569,0.558,0.533
236595,2010,1037,660,377,667,232,435,65.91,0.659,0.643,0.615
236896,2010,305,151,154,72,35,37,24.5,0.245,0.236,0.227
236939,2010,3241,1634,1607,1327,525,802,49.08,0.491,0.409,0.327
236948,2010,5460,2917,2543,3525,1504,2021,69.28,0.693,0.646,0.591
237011,2010,2722,1614,1108,1077,345,732,45.35,0.454,0.396,0.311
237057,2010,415,237,178,345,141,204,86.08,0.861,0.831,0.792
237066,2010,683,403,280,430,161,269,66.75,0.667,0.63,0.575
237215,2010,289,181,108,22,13,9,4.97,0.05,0.076,0.12
237330,2010,568,288,280,105,37,68,23.61,0.236,0.185,0.132
237358,2010,253,149,104,64,29,35,23.49,0.235,0.253,0.279
237367,2010,766,393,373,103,49,54,13.74,0.137,0.134,0.131
237792,2010,759,436,323,191,59,132,30.28,0.303,0.252,0.183
237899,2010,270,128,142,26,9,17,13.28,0.133,0.096,0.063
237932,2010,526,285,241,103,31,72,25.26,0.253,0.196,0.129
237969,2010,371,196,175,141,43,98,50,0.5,0.38,0.246
238032,2010,5006,2290,2716,1619,755,864,37.73,0.377,0.323,0.278
238333,2010,333,191,142,212,89,123,64.4,0.644,0.637,0.627
238430,2010,213,128,85,37,14,23,17.97,0.18,0.174,0.165
238458,2010,751,502,249,386,115,271,53.98,0.54,0.514,0.462
238476,2010,730,384,346,398,164,234,60.94,0.609,0.545,0.474
238616,2010,537,317,220,198,71,127,40.06,0.401,0.369,0.323
238661,2010,324,243,81,130,36,94,38.68,0.387,0.401,0.444
239080,2010,309,219,90,92,12,80,36.53,0.365,0.298,0.133
239105,2010,1929,1015,914,1161,504,657,64.73,0.647,0.602,0.551
239628,2010,289,162,127,167,66,101,62.35,0.624,0.578,0.52
239716,2010,603,367,236,408,144,264,71.93,0.719,0.677,0.61
240107,2010,340,242,98,103,21,82,33.88,0.339,0.303,0.214
240189,2010,2033,973,1060,590,267,323,33.2,0.332,0.29,0.252
240277,2010,894,572,322,214,46,168,29.37,0.294,0.239,0.143
240329,2010,1836,1093,743,660,209,451,41.26,0.413,0.359,0.281
240338,2010,246,136,110,108,32,76,55.88,0.559,0.439,0.291
240365,2010,1817,1039,778,328,116,212,20.4,0.204,0.181,0.149
240374,2010,711,355,356,40,14,26,7.32,0.073,0.056,0.039
240417,2010,1571,756,815,324,124,200,26.46,0.265,0.206,0.152
240426,2010,369,197,172,80,27,53,26.9,0.269,0.217,0.157
240444,2010,5920,3108,2812,3337,1328,2009,64.64,0.646,0.564,0.472
240453,2010,3731,1876,1855,506,225,281,14.98,0.15,0.136,0.121
240462,2010,1534,508,1026,297,170,127,25,0.25,0.194,0.166
240471,2010,1230,758,472,360,112,248,32.72,0.327,0.293,0.237
240480,2010,1644,881,763,499,213,286,32.46,0.325,0.304,0.279
240727,2010,1451,711,740,386,144,242,34.04,0.34,0.266,0.195
243443,2010,933,541,392,63,19,44,8.13,0.081,0.068,0.048
243780,2010,6454,2706,3748,3133,1579,1554,57.43,0.574,0.485,0.421
